STATE/UT,YEAR,CRIME HEAD,Male 16-18 years,Female 16-18 years,Total 16-18 years,Male 18-30 years,Female 18-30 years,Total 18-30 years,Male 30-50 years,Female 30-50 years,Total 30-50 years,Male Above 50 years,Female Above 50 years,Total Above 50 years,Total Male,Total Female,Grand Total
ANDHRA PRADESH,2001,MURDER,1,0,1,688,21,709,1221,29,1250,249,10,259,2159,60,2219
ANDHRA PRADESH,2001,ATTEMPT TO COMMIT MURDER,0,0,0,38,0,38,71,0,71,12,0,12,121,0,121
ANDHRA PRADESH,2001,C.H. NOT AMOUNTING TO MURDER,0,0,0,78,1,79,121,3,124,23,0,23,222,4,226
ANDHRA PRADESH,2001,RAPE,0,0,0,97,0,97,64,0,64,5,0,5,166,0,166
ANDHRA PRADESH,2001,KIDNAPPING AND ABDUCTION,0,0,0,9,0,9,5,2,7,0,1,1,14,3,17
ANDHRA PRADESH,2001,DACOITY,1,0,1,85,0,85,90,0,90,14,0,14,190,0,190
ANDHRA PRADESH,2001,PREP. AND ASSEMBLY FOR DACOITY,0,0,0,11,0,11,5,0,5,0,0,0,16,0,16
ANDHRA PRADESH,2001,ROBBERY,0,0,0,40,0,40,22,0,22,3,0,3,65,0,65
ANDHRA PRADESH,2001,BURGLARY,1,0,1,25,0,25,9,0,9,3,0,3,38,0,38
ANDHRA PRADESH,2001,THEFTS,1,0,1,185,0,185,80,0,80,18,0,18,284,0,284
ANDHRA PRADESH,2001,EXTORTION,0,0,0,1,0,1,0,0,0,0,0,0,1,0,1
ANDHRA PRADESH,2001,RIOTS,0,0,0,0,0,0,6,0,6,4,0,4,10,0,10
ANDHRA PRADESH,2001,ARSON,0,0,0,2,0,2,2,0,2,0,0,0,4,0,4
ANDHRA PRADESH,2001,CRIMINAL BREACH OF TRUST,0,0,0,1,0,1,5,0,5,1,0,1,7,0,7
ANDHRA PRADESH,2001,CHEATING,0,0,0,16,0,16,6,0,6,1,1,2,23,1,24
ANDHRA PRADESH,2001,COUNTER FEITING,0,0,0,0,0,0,0,0,0,0,0,0,0,0,0
ANDHRA PRADESH,2001,DOWRY DEATHS,0,0,0,23,0,23,13,1,14,0,9,9,36,10,46
ANDHRA PRADESH,2001,MOLESTATION,0,0,0,7,0,7,16,0,16,0,0,0,23,0,23
ANDHRA PRADESH,2001,EVE-TEASING,0,0,0,2,0,2,0,0,0,0,0,0,2,0,2
ANDHRA PRADESH,2001,CRUELTY BY HUSBAND OR RELATIVE OF HUSBAND,0,0,0,13,0,13,9,0,9,3,0,3,25,0,25
ANDHRA PRADESH,2001,OTHER IPC CRIMES,1,0,1,184,4,188,154,4,158,8,1,9,347,9,356
ANDHRA PRADESH,2001,TOTAL IPC,5,0,5,1505,26,1531,1899,39,1938,344,22,366,3753,87,3840
ANDHRA PRADESH,2002,MURDER,0,0,0,897,27,924,1269,38,1307,229,18,247,2395,83,2478
ANDHRA PRADESH,2002,ATTEMPT TO COMMIT MURDER,0,0,0,40,0,40,41,1,42,8,0,8,89,1,90
ANDHRA PRADESH,2002,C.H. NOT AMOUNTING TO MURDER,0,0,0,103,1,104,135,1,136,33,4,37,271,6,277
ANDHRA PRADESH,2002,RAPE,0,0,0,99,0,99,64,0,64,23,0,23,186,0,186
ANDHRA PRADESH,2002,KIDNAPPING AND ABDUCTION,0,0,0,24,0,24,7,2,9,2,1,3,33,3,36
ANDHRA PRADESH,2002,DACOITY,0,0,0,88,0,88,85,1,86,10,0,10,183,1,184
ANDHRA PRADESH,2002,PREP. AND ASSEMBLY FOR DACOITY,0,0,0,7,0,7,7,1,8,2,0,2,16,1,17
ANDHRA PRADESH,2002,ROBBERY,0,0,0,73,0,73,53,0,53,3,0,3,129,0,129
ANDHRA PRADESH,2002,BURGLARY,1,0,1,46,0,46,32,0,32,13,0,13,92,0,92
ANDHRA PRADESH,2002,THEFTS,2,0,2,231,2,233,117,1,118,17,0,17,367,3,370
ANDHRA PRADESH,2002,EXTORTION,0,0,0,24,0,24,9,0,9,0,0,0,33,0,33
ANDHRA PRADESH,2002,RIOTS,0,0,0,4,1,5,0,2,2,0,0,0,4,3,7
ANDHRA PRADESH,2002,ARSON,0,0,0,0,0,0,3,0,3,0,0,0,3,0,3
ANDHRA PRADESH,2002,CRIMINAL BREACH OF TRUST,0,0,0,0,0,0,3,0,3,1,0,1,4,0,4
ANDHRA PRADESH,2002,CHEATING,0,0,0,11,1,12,17,1,18,12,0,12,40,2,42
ANDHRA PRADESH,2002,COUNTER FEITING,0,0,0,0,0,0,4,0,4,1,0,1,5,0,5
ANDHRA PRADESH,2002,DOWRY DEATHS,0,0,0,19,1,20,19,2,21,6,3,9,44,6,50
ANDHRA PRADESH,2002,MOLESTATION,0,0,0,19,0,19,41,0,41,2,0,2,62,0,62
ANDHRA PRADESH,2002,EVE-TEASING,0,0,0,1,0,1,0,0,0,0,0,0,1,0,1
ANDHRA PRADESH,2002,CRUELTY BY HUSBAND OR RELATIVE OF HUSBAND,0,0,0,43,2,45,40,2,42,6,5,11,89,9,98
ANDHRA PRADESH,2002,OTHER IPC CRIMES,0,0,0,130,0,130,126,3,129,14,1,15,270,4,274
ANDHRA PRADESH,2002,TOTAL IPC,3,0,3,1859,35,1894,2072,55,2127,382,32,414,4316,122,4438
ANDHRA PRADESH,2003,MURDER,0,0,0,902,28,930,1272,38,1310,285,19,304,2459,85,2544
ANDHRA PRADESH,2003,ATTEMPT TO COMMIT MURDER,0,0,0,42,1,43,44,2,46,9,0,9,95,3,98
ANDHRA PRADESH,2003,C.H. NOT AMOUNTING TO MURDER,0,0,0,105,0,105,144,1,145,34,5,39,283,6,289
ANDHRA PRADESH,2003,RAPE,0,0,0,82,0,82,65,0,65,44,0,44,191,0,191
ANDHRA PRADESH,2003,KIDNAPPING AND ABDUCTION,0,0,0,26,1,27,8,0,8,3,0,3,37,1,38
ANDHRA PRADESH,2003,DACOITY,0,0,0,75,0,75,102,0,102,13,0,13,190,0,190
ANDHRA PRADESH,2003,PREP. AND ASSEMBLY FOR DACOITY,0,0,0,9,0,9,18,0,18,2,0,2,29,0,29
ANDHRA PRADESH,2003,ROBBERY,0,0,0,78,0,78,57,0,57,26,0,26,161,0,161
ANDHRA PRADESH,2003,BURGLARY,0,0,0,48,0,48,34,0,34,25,0,25,107,0,107
ANDHRA PRADESH,2003,THEFTS,0,0,0,222,12,234,120,3,123,16,0,16,358,15,373
ANDHRA PRADESH,2003,EXTORTION,0,0,0,23,0,23,18,0,18,2,0,2,43,0,43
ANDHRA PRADESH,2003,RIOTS,0,0,0,14,2,16,2,2,4,0,0,0,16,4,20
ANDHRA PRADESH,2003,ARSON,0,0,0,0,0,0,3,0,3,1,0,1,4,0,4
ANDHRA PRADESH,2003,CRIMINAL BREACH OF TRUST,0,0,0,0,0,0,2,0,2,2,1,3,4,1,5
ANDHRA PRADESH,2003,CHEATING,0,0,0,12,1,13,28,2,30,9,2,11,49,5,54
ANDHRA PRADESH,2003,COUNTER FEITING,0,0,0,0,0,0,5,0,5,2,0,2,7,0,7
ANDHRA PRADESH,2003,DOWRY DEATHS,0,0,0,21,2,23,21,1,22,5,4,9,47,7,54
ANDHRA PRADESH,2003,MOLESTATION,0,0,0,20,0,20,18,2,20,5,0,5,43,2,45
ANDHRA PRADESH,2003,EVE-TEASING,0,0,0,2,0,2,0,0,0,0,0,0,2,0,2
ANDHRA PRADESH,2003,CRUELTY BY HUSBAND OR RELATIVE OF HUSBAND,0,0,0,24,3,27,46,2,48,7,8,15,77,13,90
ANDHRA PRADESH,2003,OTHER IPC CRIMES,0,0,0,93,3,96,129,1,130,36,2,38,258,6,264
ANDHRA PRADESH,2003,TOTAL IPC,0,0,0,1798,53,1851,2136,54,2190,526,41,567,4460,148,4608
ANDHRA PRADESH,2004,MURDER,0,0,0,953,25,978,1453,64,1517,181,30,211,2587,119,2706
ANDHRA PRADESH,2004,ATTEMPT TO COMMIT MURDER,0,0,0,43,0,43,73,0,73,26,0,26,142,0,142
ANDHRA PRADESH,2004,C.H. NOT AMOUNTING TO MURDER,0,0,0,33,0,33,74,3,77,24,0,24,131,3,134
ANDHRA PRADESH,2004,RAPE,0,0,0,89,1,90,89,0,89,21,0,21,199,1,200
ANDHRA PRADESH,2004,KIDNAPPING AND ABDUCTION,0,0,0,21,2,23,21,4,25,1,0,1,43,6,49
ANDHRA PRADESH,2004,DACOITY,0,0,0,75,0,75,71,0,71,16,0,16,162,0,162
ANDHRA PRADESH,2004,PREP. AND ASSEMBLY FOR DACOITY,0,0,0,9,0,9,3,0,3,1,0,1,13,0,13
ANDHRA PRADESH,2004,ROBBERY,0,0,0,33,0,33,38,0,38,12,0,12,83,0,83
ANDHRA PRADESH,2004,BURGLARY,0,0,0,32,0,32,14,0,14,4,0,4,50,0,50
ANDHRA PRADESH,2004,THEFTS,0,0,0,143,5,148,119,2,121,25,0,25,287,7,294
ANDHRA PRADESH,2004,EXTORTION,0,0,0,2,0,2,1,0,1,0,0,0,3,0,3
ANDHRA PRADESH,2004,RIOTS,0,0,0,7,0,7,3,0,3,0,1,1,10,1,11
ANDHRA PRADESH,2004,ARSON,0,0,0,3,0,3,1,0,1,1,0,1,5,0,5
ANDHRA PRADESH,2004,CRIMINAL BREACH OF TRUST,0,0,0,0,0,0,2,0,2,0,0,0,2,0,2
ANDHRA PRADESH,2004,CHEATING,0,0,0,8,0,8,20,4,24,4,0,4,32,4,36
ANDHRA PRADESH,2004,COUNTER FEITING,0,0,0,4,0,4,3,1,4,0,0,0,7,1,8
ANDHRA PRADESH,2004,DOWRY DEATHS,0,0,0,23,4,27,42,1,43,6,8,14,71,13,84
ANDHRA PRADESH,2004,MOLESTATION,0,0,0,33,0,33,46,0,46,5,0,5,84,0,84
ANDHRA PRADESH,2004,EVE-TEASING,0,0,0,1,0,1,1,0,1,0,0,0,2,0,2
ANDHRA PRADESH,2004,CRUELTY BY HUSBAND OR RELATIVE OF HUSBAND,0,0,0,36,0,36,37,0,37,7,0,7,80,0,80
ANDHRA PRADESH,2004,OTHER IPC CRIMES,0,0,0,55,1,56,60,7,67,14,1,15,129,9,138
ANDHRA PRADESH,2004,TOTAL IPC,0,0,0,1603,38,1641,2171,86,2257,348,40,388,4122,164,4286
ANDHRA PRADESH,2005,MURDER,0,0,0,817,8,825,1796,66,1862,252,18,270,2865,92,2957
ANDHRA PRADESH,2005,ATTEMPT TO COMMIT MURDER,0,0,0,61,0,61,114,3,117,22,0,22,197,3,200
ANDHRA PRADESH,2005,C.H. NOT AMOUNTING TO MURDER,0,0,0,30,0,30,58,0,58,9,0,9,97,0,97
ANDHRA PRADESH,2005,RAPE,0,0,0,71,1,72,82,4,86,7,0,7,160,5,165
ANDHRA PRADESH,2005,KIDNAPPING AND ABDUCTION,0,0,0,16,0,16,18,1,19,1,0,1,35,1,36
ANDHRA PRADESH,2005,DACOITY,0,0,0,53,0,53,63,0,63,12,0,12,128,0,128
ANDHRA PRADESH,2005,PREP. AND ASSEMBLY FOR DACOITY,0,0,0,4,0,4,4,0,4,0,0,0,8,0,8
ANDHRA PRADESH,2005,ROBBERY,0,0,0,59,0,59,41,0,41,4,0,4,104,0,104
ANDHRA PRADESH,2005,BURGLARY,2,0,2,38,0,38,16,0,16,2,0,2,58,0,58
ANDHRA PRADESH,2005,THEFTS,0,0,0,223,10,233,126,5,131,10,0,10,359,15,374
ANDHRA PRADESH,2005,EXTORTION,0,0,0,3,0,3,2,0,2,0,0,0,5,0,5
ANDHRA PRADESH,2005,RIOTS,0,0,0,0,0,0,1,0,1,0,0,0,1,0,1
ANDHRA PRADESH,2005,ARSON,0,0,0,0,0,0,2,0,2,0,0,0,2,0,2
ANDHRA PRADESH,2005,CRIMINAL BREACH OF TRUST,0,0,0,1,0,1,1,0,1,0,0,0,2,0,2
ANDHRA PRADESH,2005,CHEATING,0,0,0,6,0,6,16,3,19,3,0,3,25,3,28
ANDHRA PRADESH,2005,COUNTER FEITING,0,0,0,0,0,0,0,0,0,0,0,0,0,0,0
ANDHRA PRADESH,2005,DOWRY DEATHS,0,0,0,19,2,21,35,3,38,9,10,19,63,15,78
ANDHRA PRADESH,2005,MOLESTATION,0,0,0,26,0,26,39,24,63,6,2,8,71,26,97
ANDHRA PRADESH,2005,EVE-TEASING,0,0,0,1,0,1,0,0,0,0,0,0,1,0,1
ANDHRA PRADESH,2005,CRUELTY BY HUSBAND OR RELATIVE OF HUSBAND,0,0,0,27,0,27,50,0,50,7,1,8,84,1,85
ANDHRA PRADESH,2005,OTHER IPC CRIMES,0,0,0,85,1,86,77,5,82,11,1,12,173,7,180
ANDHRA PRADESH,2005,TOTAL IPC,2,0,2,1540,22,1562,2541,114,2655,355,32,387,4438,168,4606
ANDHRA PRADESH,2006,MURDER,0,0,0,809,39,848,1875,36,1911,333,12,345,3017,87,3104
ANDHRA PRADESH,2006,ATTEMPT TO COMMIT MURDER,0,0,0,31,8,39,52,0,52,13,0,13,96,8,104
ANDHRA PRADESH,2006,C.H. NOT AMOUNTING TO MURDER,0,0,0,34,0,34,92,4,96,11,0,11,137,4,141
ANDHRA PRADESH,2006,RAPE,0,0,0,55,0,55,80,0,80,25,1,26,160,1,161
ANDHRA PRADESH,2006,KIDNAPPING AND ABDUCTION,0,0,0,17,3,20,24,2,26,0,0,0,41,5,46
ANDHRA PRADESH,2006,DACOITY,0,0,0,47,1,48,56,1,57,7,1,8,110,3,113
ANDHRA PRADESH,2006,PREP. AND ASSEMBLY FOR DACOITY,0,0,0,4,0,4,4,2,6,0,0,0,8,2,10
ANDHRA PRADESH,2006,ROBBERY,0,0,0,29,0,29,27,0,27,5,0,5,61,0,61
ANDHRA PRADESH,2006,BURGLARY,0,0,0,38,0,38,24,0,24,0,0,0,62,0,62
ANDHRA PRADESH,2006,THEFTS,0,0,0,207,2,209,143,4,147,12,1,13,362,7,369
ANDHRA PRADESH,2006,EXTORTION,0,0,0,0,0,0,0,0,0,0,0,0,0,0,0
ANDHRA PRADESH,2006,RIOTS,0,0,0,1,0,1,5,0,5,1,0,1,7,0,7
ANDHRA PRADESH,2006,ARSON,0,0,0,0,0,0,3,0,3,0,0,0,3,0,3
ANDHRA PRADESH,2006,CRIMINAL BREACH OF TRUST,0,0,0,0,0,0,1,0,1,0,0,0,1,0,1
ANDHRA PRADESH,2006,CHEATING,0,0,0,5,0,5,11,2,13,7,0,7,23,2,25
ANDHRA PRADESH,2006,COUNTER FEITING,0,0,0,3,0,3,3,0,3,0,0,0,6,0,6
ANDHRA PRADESH,2006,DOWRY DEATHS,0,0,0,28,3,31,55,13,68,13,8,21,96,24,120
ANDHRA PRADESH,2006,MOLESTATION,0,0,0,36,0,36,41,0,41,2,0,2,79,0,79
ANDHRA PRADESH,2006,EVE-TEASING,0,0,0,0,0,0,1,0,1,0,0,0,1,0,1
ANDHRA PRADESH,2006,CRUELTY BY HUSBAND OR RELATIVE OF HUSBAND,0,0,0,43,0,43,83,29,112,3,7,10,129,36,165
ANDHRA PRADESH,2006,OTHER IPC CRIMES,0,0,0,88,4,92,145,1,146,23,0,23,256,5,261
ANDHRA PRADESH,2006,TOTAL IPC,0,0,0,1475,60,1535,2725,94,2819,455,30,485,4655,184,4839
ANDHRA PRADESH,2007,MURDER,0,0,0,1046,41,1087,1715,81,1796,356,30,386,3117,152,3269
ANDHRA PRADESH,2007,ATTEMPT TO COMMIT MURDER,0,0,0,48,2,50,69,5,74,13,2,15,130,9,139
ANDHRA PRADESH,2007,C.H. NOT AMOUNTING TO MURDER,0,0,0,51,1,52,92,2,94,19,1,20,162,4,166
ANDHRA PRADESH,2007,RAPE,0,0,0,96,1,97,93,0,93,27,0,27,216,1,217
ANDHRA PRADESH,2007,KIDNAPPING AND ABDUCTION,0,0,0,19,0,19,26,0,26,0,7,7,45,7,52
ANDHRA PRADESH,2007,DACOITY,0,0,0,67,0,67,59,2,61,10,1,11,136,3,139
ANDHRA PRADESH,2007,PREP. AND ASSEMBLY FOR DACOITY,0,0,0,1,1,2,5,1,6,0,2,2,6,4,10
ANDHRA PRADESH,2007,ROBBERY,0,0,0,43,0,43,35,4,39,7,0,7,85,4,89
ANDHRA PRADESH,2007,BURGLARY,0,0,0,27,0,27,16,0,16,8,0,8,51,0,51
ANDHRA PRADESH,2007,THEFTS,0,0,0,206,2,208,178,5,183,26,1,27,410,8,418
ANDHRA PRADESH,2007,EXTORTION,0,0,0,7,0,7,5,0,5,0,0,0,12,0,12
ANDHRA PRADESH,2007,RIOTS,0,0,0,0,0,0,3,3,6,0,0,0,3,3,6
ANDHRA PRADESH,2007,ARSON,0,0,0,1,0,1,4,0,4,1,0,1,6,0,6
ANDHRA PRADESH,2007,CRIMINAL BREACH OF TRUST,0,0,0,1,0,1,0,0,0,4,0,4,5,0,5
ANDHRA PRADESH,2007,CHEATING,0,0,0,10,0,10,11,4,15,5,0,5,26,4,30
ANDHRA PRADESH,2007,COUNTER FEITING,0,0,0,6,1,7,5,0,5,1,0,1,12,1,13
ANDHRA PRADESH,2007,DOWRY DEATHS,0,0,0,34,8,42,51,5,56,8,0,8,93,13,106
ANDHRA PRADESH,2007,MOLESTATION,0,0,0,28,0,28,28,0,28,11,0,11,67,0,67
ANDHRA PRADESH,2007,EVE-TEASING,0,0,0,1,0,1,0,0,0,0,0,0,1,0,1
ANDHRA PRADESH,2007,CRUELTY BY HUSBAND OR RELATIVE OF HUSBAND,0,0,0,37,0,37,83,2,85,8,0,8,128,2,130
ANDHRA PRADESH,2007,OTHER IPC CRIMES,0,0,0,83,4,87,97,0,97,30,0,30,210,4,214
ANDHRA PRADESH,2007,TOTAL IPC,0,0,0,1812,61,1873,2575,114,2689,534,44,578,4921,219,5140
ANDHRA PRADESH,2008,MURDER,0,0,0,912,25,937,1854,89,1943,414,24,438,3180,138,3318
ANDHRA PRADESH,2008,ATTEMPT TO COMMIT MURDER,0,0,0,50,2,52,57,1,58,10,0,10,117,3,120
ANDHRA PRADESH,2008,C.H. NOT AMOUNTING TO MURDER,0,0,0,50,1,51,45,6,51,6,3,9,101,10,111
ANDHRA PRADESH,2008,RAPE,0,0,0,82,0,82,70,0,70,18,1,19,170,1,171
ANDHRA PRADESH,2008,KIDNAPPING AND ABDUCTION,0,0,0,15,1,16,11,4,15,0,1,1,26,6,32
ANDHRA PRADESH,2008,DACOITY,0,0,0,74,0,74,37,0,37,9,0,9,120,0,120
ANDHRA PRADESH,2008,PREP. AND ASSEMBLY FOR DACOITY,0,0,0,2,0,2,6,0,6,0,0,0,8,0,8
ANDHRA PRADESH,2008,ROBBERY,0,0,0,30,1,31,49,1,50,13,0,13,92,2,94
ANDHRA PRADESH,2008,BURGLARY,0,0,0,18,0,18,24,0,24,5,0,5,47,0,47
ANDHRA PRADESH,2008,THEFTS,0,0,0,188,3,191,176,5,181,8,0,8,372,8,380
ANDHRA PRADESH,2008,EXTORTION,0,0,0,4,0,4,5,1,6,0,0,0,9,1,10
ANDHRA PRADESH,2008,RIOTS,0,0,0,0,0,0,0,0,0,0,0,0,0,0,0
ANDHRA PRADESH,2008,ARSON,0,0,0,2,0,2,0,0,0,0,0,0,2,0,2
ANDHRA PRADESH,2008,CRIMINAL BREACH OF TRUST,0,0,0,3,0,3,0,0,0,0,0,0,3,0,3
ANDHRA PRADESH,2008,CHEATING,0,0,0,14,0,14,19,0,19,3,0,3,36,0,36
ANDHRA PRADESH,2008,COUNTER FEITING,0,0,0,4,0,4,6,1,7,0,0,0,10,1,11
ANDHRA PRADESH,2008,DOWRY DEATHS,0,0,0,37,1,38,39,19,58,8,0,8,84,20,104
ANDHRA PRADESH,2008,MOLESTATION,0,0,0,18,2,20,17,0,17,2,0,2,37,2,39
ANDHRA PRADESH,2008,EVE-TEASING,0,0,0,2,0,2,0,0,0,1,0,1,3,0,3
ANDHRA PRADESH,2008,CRUELTY BY HUSBAND OR RELATIVE OF HUSBAND,0,0,0,38,0,38,53,3,56,0,2,2,91,5,96
ANDHRA PRADESH,2008,OTHER IPC CRIMES,0,0,0,53,0,53,71,6,77,20,1,21,144,7,151
ANDHRA PRADESH,2008,TOTAL IPC,0,0,0,1596,36,1632,2539,136,2675,517,32,549,4652,204,4856
ANDHRA PRADESH,2009,MURDER,0,0,0,785,52,837,1415,55,1470,199,18,217,2399,125,2524
ANDHRA PRADESH,2009,ATTEMPT TO COMMIT MURDER,0,0,0,61,2,63,91,0,91,6,0,6,158,2,160
ANDHRA PRADESH,2009,C.H. NOT AMOUNTING TO MURDER,0,0,0,49,5,54,43,3,46,3,1,4,95,9,104
ANDHRA PRADESH,2009,RAPE,0,0,0,58,2,60,84,1,85,11,0,11,153,3,156
ANDHRA PRADESH,2009,KIDNAPPING AND ABDUCTION,0,0,0,38,0,38,27,5,32,1,2,3,66,7,73
ANDHRA PRADESH,2009,DACOITY,0,0,0,55,3,58,67,1,68,2,0,2,124,4,128
ANDHRA PRADESH,2009,PREP. AND ASSEMBLY FOR DACOITY,0,0,0,1,0,1,8,0,8,0,0,0,9,0,9
ANDHRA PRADESH,2009,ROBBERY,0,0,0,53,3,56,53,0,53,7,0,7,113,3,116
ANDHRA PRADESH,2009,BURGLARY,0,0,0,21,0,21,15,0,15,4,0,4,40,0,40
ANDHRA PRADESH,2009,THEFTS,0,0,0,217,4,221,158,4,162,9,0,9,384,8,392
ANDHRA PRADESH,2009,EXTORTION,0,0,0,7,0,7,6,0,6,1,0,1,14,0,14
ANDHRA PRADESH,2009,RIOTS,0,0,0,8,0,8,5,0,5,1,0,1,14,0,14
ANDHRA PRADESH,2009,ARSON,0,0,0,2,0,2,4,0,4,1,0,1,7,0,7
ANDHRA PRADESH,2009,CRIMINAL BREACH OF TRUST,0,0,0,0,0,0,4,0,4,2,0,2,6,0,6
ANDHRA PRADESH,2009,CHEATING,0,0,0,14,0,14,13,0,13,7,1,8,34,1,35
ANDHRA PRADESH,2009,COUNTER FEITING,0,0,0,32,0,32,21,0,21,1,0,1,54,0,54
ANDHRA PRADESH,2009,DOWRY DEATHS,0,0,0,24,2,26,51,8,59,11,0,11,86,10,96
ANDHRA PRADESH,2009,MOLESTATION,0,0,0,19,0,19,14,0,14,5,0,5,38,0,38
ANDHRA PRADESH,2009,EVE-TEASING,0,0,0,4,0,4,3,0,3,0,0,0,7,0,7
ANDHRA PRADESH,2009,CRUELTY BY HUSBAND OR RELATIVE OF HUSBAND,0,0,0,40,2,42,70,3,73,4,2,6,114,7,121
ANDHRA PRADESH,2009,OTHER IPC CRIMES,0,0,0,61,0,61,40,8,48,19,1,20,120,9,129
ANDHRA PRADESH,2009,TOTAL IPC,0,0,0,1549,75,1624,2192,88,2280,294,25,319,4035,188,4223
ANDHRA PRADESH,2010,MURDER,0,0,0,939,40,979,1565,68,1633,270,40,310,2774,148,2922
ANDHRA PRADESH,2010,ATTEMPT TO COMMIT MURDER,0,0,0,86,2,88,48,1,49,11,0,11,145,3,148
ANDHRA PRADESH,2010,C.H. NOT AMOUNTING TO MURDER,0,0,0,40,2,42,67,4,71,17,1,18,124,7,131
ANDHRA PRADESH,2010,RAPE,0,0,0,68,1,69,54,1,55,5,0,5,127,2,129
ANDHRA PRADESH,2010,KIDNAPPING AND ABDUCTION,0,0,0,59,0,59,22,1,23,3,0,3,84,1,85
ANDHRA PRADESH,2010,DACOITY,0,0,0,56,2,58,42,4,46,3,0,3,101,6,107
ANDHRA PRADESH,2010,PREP. AND ASSEMBLY FOR DACOITY,0,0,0,18,0,18,6,0,6,3,0,3,27,0,27
ANDHRA PRADESH,2010,ROBBERY,0,0,0,40,0,40,21,0,21,0,0,0,61,0,61
ANDHRA PRADESH,2010,BURGLARY,0,0,0,42,0,42,23,1,24,5,0,5,70,1,71
ANDHRA PRADESH,2010,THEFTS,0,0,0,177,9,186,110,9,119,7,0,7,294,18,312
ANDHRA PRADESH,2010,EXTORTION,0,0,0,5,0,5,0,0,0,0,0,0,5,0,5
ANDHRA PRADESH,2010,RIOTS,0,0,0,4,0,4,8,0,8,2,0,2,14,0,14
ANDHRA PRADESH,2010,ARSON,0,0,0,1,0,1,0,0,0,0,0,0,1,0,1
ANDHRA PRADESH,2010,CRIMINAL BREACH OF TRUST,0,0,0,2,0,2,1,0,1,0,0,0,3,0,3
ANDHRA PRADESH,2010,CHEATING,0,0,0,18,0,18,7,3,10,2,1,3,27,4,31
ANDHRA PRADESH,2010,COUNTER FEITING,0,0,0,6,0,6,11,0,11,0,0,0,17,0,17
ANDHRA PRADESH,2010,DOWRY DEATHS,0,0,0,20,0,20,16,6,22,2,12,14,38,18,56
ANDHRA PRADESH,2010,MOLESTATION,0,0,0,27,0,27,20,2,22,2,0,2,49,2,51
ANDHRA PRADESH,2010,EVE-TEASING,0,0,0,4,0,4,5,0,5,0,0,0,9,0,9
ANDHRA PRADESH,2010,CRUELTY BY HUSBAND OR RELATIVE OF HUSBAND,0,0,0,50,1,51,58,0,58,3,1,4,111,2,113
ANDHRA PRADESH,2010,OTHER IPC CRIMES,0,0,0,90,1,91,111,6,117,22,0,22,223,7,230
ANDHRA PRADESH,2010,TOTAL IPC,0,0,0,1752,58,1810,2195,106,2301,357,55,412,4304,219,4523
ANDHRA PRADESH,2011,MURDER,0,0,0,833,19,852,1575,105,1680,428,39,467,2836,163,2999
ANDHRA PRADESH,2011,ATTEMPT TO COMMIT MURDER,0,0,0,57,0,57,51,9,60,19,8,27,127,17,144
ANDHRA PRADESH,2011,C.H. NOT AMOUNTING TO MURDER,0,0,0,32,3,35,59,4,63,14,3,17,105,10,115
ANDHRA PRADESH,2011,RAPE,0,0,0,45,0,45,43,2,45,16,0,16,104,2,106
ANDHRA PRADESH,2011,KIDNAPPING AND ABDUCTION,0,0,0,17,1,18,13,4,17,1,0,1,31,5,36
ANDHRA PRADESH,2011,DACOITY,0,0,0,41,3,44,45,2,47,8,0,8,94,5,99
ANDHRA PRADESH,2011,PREP. AND ASSEMBLY FOR DACOITY,0,0,0,4,1,5,2,0,2,0,0,0,6,1,7
ANDHRA PRADESH,2011,ROBBERY,0,0,0,34,1,35,17,0,17,10,0,10,61,1,62
ANDHRA PRADESH,2011,BURGLARY,0,0,0,26,0,26,12,0,12,9,0,9,47,0,47
ANDHRA PRADESH,2011,THEFTS,0,0,0,230,8,238,162,6,168,42,0,42,434,14,448
ANDHRA PRADESH,2011,EXTORTION,0,0,0,4,0,4,6,0,6,4,0,4,14,0,14
ANDHRA PRADESH,2011,RIOTS,0,0,0,0,0,0,1,0,1,0,0,0,1,0,1
ANDHRA PRADESH,2011,ARSON,0,0,0,0,0,0,0,0,0,0,0,0,0,0,0
ANDHRA PRADESH,2011,CRIMINAL BREACH OF TRUST,0,0,0,4,0,4,0,0,0,0,0,0,4,0,4
ANDHRA PRADESH,2011,CHEATING,0,0,0,15,1,16,16,1,17,7,1,8,38,3,41
ANDHRA PRADESH,2011,COUNTER FEITING,0,0,0,1,0,1,2,0,2,0,0,0,3,0,3
ANDHRA PRADESH,2011,DOWRY DEATHS,0,0,0,13,0,13,32,10,42,12,15,27,57,25,82
ANDHRA PRADESH,2011,MOLESTATION,0,0,0,7,0,7,4,0,4,1,0,1,12,0,12
ANDHRA PRADESH,2011,EVE-TEASING,0,0,0,1,0,1,2,0,2,0,0,0,3,0,3
ANDHRA PRADESH,2011,CRUELTY BY HUSBAND OR RELATIVE OF HUSBAND,0,0,0,28,1,29,27,0,27,14,0,14,69,1,70
ANDHRA PRADESH,2011,OTHER IPC CRIMES,0,0,0,31,2,33,87,1,88,23,0,23,141,3,144
ANDHRA PRADESH,2011,TOTAL IPC,0,0,0,1423,40,1463,2156,144,2300,608,66,674,4187,250,4437
ANDHRA PRADESH,2012,MURDER,0,0,0,851,28,879,1662,99,1761,423,0,423,2936,127,3063
ANDHRA PRADESH,2012,ATTEMPT TO COMMIT MURDER,0,0,0,28,0,28,38,2,40,11,0,11,77,2,79
ANDHRA PRADESH,2012,C.H. NOT AMOUNTING TO MURDER,0,0,0,42,0,42,67,10,77,11,0,11,120,10,130
ANDHRA PRADESH,2012,RAPE,0,0,0,76,0,76,73,2,75,19,0,19,168,2,170
ANDHRA PRADESH,2012,KIDNAPPING AND ABDUCTION,0,0,0,16,0,16,16,3,19,5,0,5,37,3,40
ANDHRA PRADESH,2012,DACOITY,0,0,0,50,2,52,37,1,38,2,0,2,89,3,92
ANDHRA PRADESH,2012,PREP. AND ASSEMBLY FOR DACOITY,0,0,0,1,0,1,0,1,1,0,0,0,1,1,2
ANDHRA PRADESH,2012,ROBBERY,0,0,0,29,0,29,20,3,23,6,0,6,55,3,58
ANDHRA PRADESH,2012,BURGLARY,0,0,0,36,0,36,8,0,8,3,52,55,47,52,99
ANDHRA PRADESH,2012,THEFTS,0,0,0,173,1,174,84,8,92,19,0,19,276,9,285
ANDHRA PRADESH,2012,EXTORTION,0,0,0,12,0,12,6,0,6,0,0,0,18,0,18
ANDHRA PRADESH,2012,RIOTS,0,0,0,0,0,0,0,0,0,0,0,0,0,0,0
ANDHRA PRADESH,2012,ARSON,0,0,0,0,0,0,0,0,0,0,0,0,0,0,0
ANDHRA PRADESH,2012,CRIMINAL BREACH OF TRUST,0,0,0,6,0,6,6,2,8,2,0,2,14,2,16
ANDHRA PRADESH,2012,CHEATING,0,0,0,12,0,12,11,2,13,3,0,3,26,2,28
ANDHRA PRADESH,2012,COUNTER FEITING,0,0,0,3,0,3,8,0,8,2,0,2,13,0,13
ANDHRA PRADESH,2012,DOWRY DEATHS,0,0,0,29,0,29,35,16,51,7,3,10,71,19,90
ANDHRA PRADESH,2012,MOLESTATION,0,0,0,5,0,5,20,1,21,5,0,5,30,1,31
ANDHRA PRADESH,2012,EVE-TEASING,0,0,0,4,0,4,2,0,2,0,0,0,6,0,6
ANDHRA PRADESH,2012,CRUELTY BY HUSBAND OR RELATIVE OF HUSBAND,0,0,0,24,0,24,23,3,26,5,0,5,52,3,55
ANDHRA PRADESH,2012,OTHER IPC CRIMES,0,0,0,43,0,43,72,0,72,18,0,18,133,0,133
ANDHRA PRADESH,2012,TOTAL IPC,0,0,0,1440,31,1471,2188,153,2341,541,55,596,4169,239,4408
ARUNACHAL PRADESH,2009,MURDER,0,0,0,0,0,0,0,0,0,0,0,0,0,0,0
ARUNACHAL PRADESH,2009,ATTEMPT TO COMMIT MURDER,0,0,0,0,0,0,0,0,0,0,0,0,0,0,0
ARUNACHAL PRADESH,2009,C.H. NOT AMOUNTING TO MURDER,0,0,0,0,0,0,0,0,0,0,0,0,0,0,0
ARUNACHAL PRADESH,2009,RAPE,0,0,0,1,0,1,0,0,0,1,0,1,2,0,2
ARUNACHAL PRADESH,2009,KIDNAPPING AND ABDUCTION,0,0,0,0,0,0,0,0,0,0,0,0,0,0,0
ARUNACHAL PRADESH,2009,DACOITY,0,0,0,0,0,0,0,0,0,0,0,0,0,0,0
ARUNACHAL PRADESH,2009,PREP. AND ASSEMBLY FOR DACOITY,0,0,0,0,0,0,0,0,0,0,0,0,0,0,0
ARUNACHAL PRADESH,2009,ROBBERY,0,0,0,0,0,0,0,0,0,0,0,0,0,0,0
ARUNACHAL PRADESH,2009,BURGLARY,0,0,0,0,0,0,0,0,0,0,0,0,0,0,0
ARUNACHAL PRADESH,2009,THEFTS,0,0,0,0,0,0,0,0,0,0,0,0,0,0,0
ARUNACHAL PRADESH,2009,EXTORTION,0,0,0,0,0,0,0,0,0,0,0,0,0,0,0
ARUNACHAL PRADESH,2009,RIOTS,0,0,0,0,0,0,0,0,0,0,0,0,0,0,0
ARUNACHAL PRADESH,2009,ARSON,0,0,0,0,0,0,0,0,0,0,0,0,0,0,0
ARUNACHAL PRADESH,2009,CRIMINAL BREACH OF TRUST,0,0,0,0,0,0,0,0,0,0,0,0,0,0,0
ARUNACHAL PRADESH,2009,CHEATING,0,0,0,0,0,0,0,0,0,0,0,0,0,0,0
ARUNACHAL PRADESH,2009,COUNTER FEITING,0,0,0,0,0,0,0,0,0,0,0,0,0,0,0
ARUNACHAL PRADESH,2009,DOWRY DEATHS,0,0,0,0,0,0,0,0,0,0,0,0,0,0,0
ARUNACHAL PRADESH,2009,MOLESTATION,0,0,0,0,0,0,0,0,0,0,0,0,0,0,0
ARUNACHAL PRADESH,2009,EVE-TEASING,0,0,0,0,0,0,0,0,0,0,0,0,0,0,0
ARUNACHAL PRADESH,2009,CRUELTY BY HUSBAND OR RELATIVE OF HUSBAND,0,0,0,0,0,0,0,0,0,0,0,0,0,0,0
ARUNACHAL PRADESH,2009,OTHER IPC CRIMES,0,0,0,0,0,0,0,0,0,0,0,0,0,0,0
ARUNACHAL PRADESH,2009,TOTAL IPC,0,0,0,1,0,1,0,0,0,1,0,1,2,0,2
ARUNACHAL PRADESH,2010,MURDER,0,0,0,0,0,0,0,0,0,0,0,0,0,0,0
ARUNACHAL PRADESH,2010,ATTEMPT TO COMMIT MURDER,0,0,0,0,0,0,0,0,0,0,0,0,0,0,0
ARUNACHAL PRADESH,2010,C.H. NOT AMOUNTING TO MURDER,0,0,0,0,0,0,0,0,0,0,0,0,0,0,0
ARUNACHAL PRADESH,2010,RAPE,0,0,0,0,0,0,0,0,0,1,0,1,1,0,1
ARUNACHAL PRADESH,2010,KIDNAPPING AND ABDUCTION,0,0,0,0,0,0,0,0,0,0,0,0,0,0,0
ARUNACHAL PRADESH,2010,DACOITY,0,0,0,0,0,0,0,0,0,0,0,0,0,0,0
ARUNACHAL PRADESH,2010,PREP. AND ASSEMBLY FOR DACOITY,0,0,0,0,0,0,0,0,0,0,0,0,0,0,0
ARUNACHAL PRADESH,2010,ROBBERY,0,0,0,0,0,0,0,0,0,0,0,0,0,0,0
ARUNACHAL PRADESH,2010,BURGLARY,0,0,0,2,0,2,0,0,0,0,0,0,2,0,2
ARUNACHAL PRADESH,2010,THEFTS,0,0,0,1,0,1,0,0,0,0,0,0,1,0,1
ARUNACHAL PRADESH,2010,EXTORTION,0,0,0,0,0,0,0,0,0,0,0,0,0,0,0
ARUNACHAL PRADESH,2010,RIOTS,0,0,0,0,0,0,0,0,0,0,0,0,0,0,0
ARUNACHAL PRADESH,2010,ARSON,0,0,0,0,0,0,0,0,0,0,0,0,0,0,0
ARUNACHAL PRADESH,2010,CRIMINAL BREACH OF TRUST,0,0,0,0,0,0,0,0,0,0,0,0,0,0,0
ARUNACHAL PRADESH,2010,CHEATING,0,0,0,0,0,0,0,0,0,0,0,0,0,0,0
ARUNACHAL PRADESH,2010,COUNTER FEITING,0,0,0,0,0,0,0,0,0,0,0,0,0,0,0
ARUNACHAL PRADESH,2010,DOWRY DEATHS,0,0,0,0,0,0,0,0,0,0,0,0,0,0,0
ARUNACHAL PRADESH,2010,MOLESTATION,0,0,0,0,0,0,0,0,0,0,0,0,0,0,0
ARUNACHAL PRADESH,2010,EVE-TEASING,0,0,0,0,0,0,0,0,0,0,0,0,0,0,0
ARUNACHAL PRADESH,2010,CRUELTY BY HUSBAND OR RELATIVE OF HUSBAND,0,0,0,0,0,0,0,0,0,0,0,0,0,0,0
ARUNACHAL PRADESH,2010,OTHER IPC CRIMES,0,0,0,0,0,0,0,0,0,0,0,0,0,0,0
ARUNACHAL PRADESH,2010,TOTAL IPC,0,0,0,3,0,3,0,0,0,1,0,1,4,0,4
ARUNACHAL PRADESH,2011,MURDER,0,0,0,0,0,0,1,0,1,0,0,0,1,0,1
ARUNACHAL PRADESH,2011,ATTEMPT TO COMMIT MURDER,0,0,0,0,0,0,0,0,0,0,0,0,0,0,0
ARUNACHAL PRADESH,2011,C.H. NOT AMOUNTING TO MURDER,0,0,0,0,0,0,0,0,0,0,0,0,0,0,0
ARUNACHAL PRADESH,2011,RAPE,0,0,0,1,0,1,1,0,1,1,0,1,3,0,3
ARUNACHAL PRADESH,2011,KIDNAPPING AND ABDUCTION,0,0,0,0,0,0,0,0,0,0,0,0,0,0,0
ARUNACHAL PRADESH,2011,DACOITY,0,0,0,0,0,0,0,0,0,0,0,0,0,0,0
ARUNACHAL PRADESH,2011,PREP. AND ASSEMBLY FOR DACOITY,0,0,0,0,0,0,0,0,0,0,0,0,0,0,0
ARUNACHAL PRADESH,2011,ROBBERY,0,0,0,0,0,0,0,0,0,0,0,0,0,0,0
ARUNACHAL PRADESH,2011,BURGLARY,0,0,0,0,0,0,0,0,0,0,0,0,0,0,0
ARUNACHAL PRADESH,2011,THEFTS,0,0,0,1,0,1,0,0,0,0,0,0,1,0,1
ARUNACHAL PRADESH,2011,EXTORTION,0,0,0,0,0,0,0,0,0,0,0,0,0,0,0
ARUNACHAL PRADESH,2011,RIOTS,0,0,0,0,0,0,0,0,0,0,0,0,0,0,0
ARUNACHAL PRADESH,2011,ARSON,0,0,0,0,0,0,0,0,0,0,0,0,0,0,0
ARUNACHAL PRADESH,2011,CRIMINAL BREACH OF TRUST,0,0,0,0,0,0,0,0,0,0,0,0,0,0,0
ARUNACHAL PRADESH,2011,CHEATING,0,0,0,0,0,0,0,0,0,0,0,0,0,0,0
ARUNACHAL PRADESH,2011,COUNTER FEITING,0,0,0,0,0,0,0,0,0,0,0,0,0,0,0
ARUNACHAL PRADESH,2011,DOWRY DEATHS,0,0,0,0,0,0,0,0,0,0,0,0,0,0,0
ARUNACHAL PRADESH,2011,MOLESTATION,0,0,0,0,0,0,0,0,0,0,0,0,0,0,0
ARUNACHAL PRADESH,2011,EVE-TEASING,0,0,0,0,0,0,0,0,0,0,0,0,0,0,0
ARUNACHAL PRADESH,2011,CRUELTY BY HUSBAND OR RELATIVE OF HUSBAND,0,0,0,0,0,0,0,0,0,0,0,0,0,0,0
ARUNACHAL PRADESH,2011,OTHER IPC CRIMES,0,0,0,0,0,0,0,0,0,0,0,0,0,0,0
ARUNACHAL PRADESH,2011,TOTAL IPC,0,0,0,2,0,2,2,0,2,1,0,1,5,0,5
ARUNACHAL PRADESH,2012,MURDER,0,0,0,0,0,0,0,0,0,0,0,0,0,0,0
ARUNACHAL PRADESH,2012,ATTEMPT TO COMMIT MURDER,0,0,0,0,0,0,0,0,0,0,0,0,0,0,0
ARUNACHAL PRADESH,2012,C.H. NOT AMOUNTING TO MURDER,0,0,0,0,0,0,0,0,0,0,0,0,0,0,0
ARUNACHAL PRADESH,2012,RAPE,0,0,0,3,0,3,1,0,1,0,0,0,4,0,4
ARUNACHAL PRADESH,2012,KIDNAPPING AND ABDUCTION,0,0,0,0,0,0,0,0,0,0,0,0,0,0,0
ARUNACHAL PRADESH,2012,DACOITY,0,0,0,0,0,0,0,0,0,0,0,0,0,0,0
ARUNACHAL PRADESH,2012,PREP. AND ASSEMBLY FOR DACOITY,0,0,0,0,0,0,0,0,0,0,0,0,0,0,0
ARUNACHAL PRADESH,2012,ROBBERY,0,0,0,0,0,0,0,0,0,0,0,0,0,0,0
ARUNACHAL PRADESH,2012,BURGLARY,0,0,0,0,0,0,0,0,0,0,0,0,0,0,0
ARUNACHAL PRADESH,2012,THEFTS,0,0,0,0,0,0,0,0,0,0,0,0,0,0,0
ARUNACHAL PRADESH,2012,EXTORTION,0,0,0,0,0,0,0,0,0,0,0,0,0,0,0
ARUNACHAL PRADESH,2012,RIOTS,0,0,0,0,0,0,0,0,0,0,0,0,0,0,0
ARUNACHAL PRADESH,2012,ARSON,0,0,0,0,0,0,0,0,0,0,0,0,0,0,0
ARUNACHAL PRADESH,2012,CRIMINAL BREACH OF TRUST,0,0,0,0,0,0,0,0,0,0,0,0,0,0,0
ARUNACHAL PRADESH,2012,CHEATING,0,0,0,0,0,0,0,0,0,0,0,0,0,0,0
ARUNACHAL PRADESH,2012,COUNTER FEITING,0,0,0,0,0,0,0,0,0,0,0,0,0,0,0
ARUNACHAL PRADESH,2012,DOWRY DEATHS,0,0,0,0,0,0,0,0,0,0,0,0,0,0,0
ARUNACHAL PRADESH,2012,MOLESTATION,0,0,0,0,0,0,0,0,0,0,0,0,0,0,0
ARUNACHAL PRADESH,2012,EVE-TEASING,0,0,0,0,0,0,0,0,0,0,0,0,0,0,0
ARUNACHAL PRADESH,2012,CRUELTY BY HUSBAND OR RELATIVE OF HUSBAND,0,0,0,0,0,0,0,0,0,0,0,0,0,0,0
ARUNACHAL PRADESH,2012,OTHER IPC CRIMES,0,0,0,0,0,0,0,0,0,0,0,0,0,0,0
ARUNACHAL PRADESH,2012,TOTAL IPC,0,0,0,3,0,3,1,0,1,0,0,0,4,0,4
ASSAM,2001,MURDER,6,0,6,271,10,281,1108,23,1131,207,0,207,1592,33,1625
ASSAM,2001,ATTEMPT TO COMMIT MURDER,1,0,1,25,2,27,14,0,14,3,0,3,43,2,45
ASSAM,2001,C.H. NOT AMOUNTING TO MURDER,0,0,0,50,1,51,114,2,116,12,0,12,176,3,179
ASSAM,2001,RAPE,1,0,1,62,0,62,71,0,71,5,0,5,139,0,139
ASSAM,2001,KIDNAPPING AND ABDUCTION,0,0,0,7,1,8,14,0,14,0,0,0,21,1,22
ASSAM,2001,DACOITY,0,0,0,16,0,16,22,2,24,5,0,5,43,2,45
ASSAM,2001,PREP. AND ASSEMBLY FOR DACOITY,0,0,0,1,0,1,2,0,2,0,0,0,3,0,3
ASSAM,2001,ROBBERY,0,0,0,9,2,11,12,0,12,0,0,0,21,2,23
ASSAM,2001,BURGLARY,0,0,0,10,0,10,10,0,10,0,0,0,20,0,20
ASSAM,2001,THEFTS,1,0,1,32,0,32,57,1,58,2,0,2,92,1,93
ASSAM,2001,EXTORTION,0,0,0,3,0,3,6,0,6,0,0,0,9,0,9
ASSAM,2001,RIOTS,0,0,0,2,0,2,6,0,6,0,0,0,8,0,8
ASSAM,2001,ARSON,0,0,0,1,0,1,0,0,0,0,0,0,1,0,1
ASSAM,2001,CRIMINAL BREACH OF TRUST,0,0,0,2,0,2,2,0,2,1,0,1,5,0,5
ASSAM,2001,CHEATING,0,0,0,1,0,1,4,0,4,0,0,0,5,0,5
ASSAM,2001,COUNTER FEITING,0,0,0,0,0,0,1,0,1,0,0,0,1,0,1
ASSAM,2001,DOWRY DEATHS,0,0,0,2,0,2,4,0,4,1,0,1,7,0,7
ASSAM,2001,MOLESTATION,0,0,0,0,0,0,0,0,0,0,0,0,0,0,0
ASSAM,2001,EVE-TEASING,0,0,0,0,0,0,0,0,0,0,0,0,0,0,0
ASSAM,2001,CRUELTY BY HUSBAND OR RELATIVE OF HUSBAND,0,0,0,5,0,5,2,0,2,1,0,1,8,0,8
ASSAM,2001,OTHER IPC CRIMES,0,0,0,33,0,33,52,1,53,11,0,11,96,1,97
ASSAM,2001,TOTAL IPC,9,0,9,532,16,548,1501,29,1530,248,0,248,2290,45,2335
ASSAM,2002,MURDER,0,0,0,488,5,493,1046,34,1080,179,1,180,1713,40,1753
ASSAM,2002,ATTEMPT TO COMMIT MURDER,3,0,3,44,2,46,29,3,32,7,0,7,83,5,88
ASSAM,2002,C.H. NOT AMOUNTING TO MURDER,3,0,3,80,0,80,93,6,99,19,0,19,195,6,201
ASSAM,2002,RAPE,2,0,2,77,0,77,92,0,92,5,0,5,176,0,176
ASSAM,2002,KIDNAPPING AND ABDUCTION,0,0,0,14,0,14,24,0,24,2,0,2,40,0,40
ASSAM,2002,DACOITY,0,0,0,27,0,27,51,0,51,9,0,9,87,0,87
ASSAM,2002,PREP. AND ASSEMBLY FOR DACOITY,0,0,0,0,0,0,3,0,3,0,0,0,3,0,3
ASSAM,2002,ROBBERY,0,0,0,11,0,11,14,0,14,2,0,2,27,0,27
ASSAM,2002,BURGLARY,5,0,5,7,0,7,7,0,7,2,0,2,21,0,21
ASSAM,2002,THEFTS,14,0,14,42,0,42,62,0,62,5,0,5,123,0,123
ASSAM,2002,EXTORTION,0,0,0,4,0,4,23,1,24,7,0,7,34,1,35
ASSAM,2002,RIOTS,0,0,0,3,0,3,4,0,4,0,0,0,7,0,7
ASSAM,2002,ARSON,0,0,0,3,0,3,10,0,10,0,0,0,13,0,13
ASSAM,2002,CRIMINAL BREACH OF TRUST,0,0,0,0,0,0,0,0,0,0,0,0,0,0,0
ASSAM,2002,CHEATING,0,0,0,2,0,2,3,0,3,0,0,0,5,0,5
ASSAM,2002,COUNTER FEITING,0,0,0,0,0,0,2,0,2,0,0,0,2,0,2
ASSAM,2002,DOWRY DEATHS,0,0,0,7,0,7,13,0,13,8,1,9,28,1,29
ASSAM,2002,MOLESTATION,0,0,0,2,0,2,0,0,0,0,0,0,2,0,2
ASSAM,2002,EVE-TEASING,0,0,0,0,0,0,0,0,0,0,0,0,0,0,0
ASSAM,2002,CRUELTY BY HUSBAND OR RELATIVE OF HUSBAND,0,0,0,1,0,1,18,0,18,0,0,0,19,0,19
ASSAM,2002,OTHER IPC CRIMES,0,0,0,14,0,14,21,0,21,3,0,3,38,0,38
ASSAM,2002,TOTAL IPC,27,0,27,826,7,833,1515,44,1559,248,2,250,2616,53,2669
ASSAM,2003,MURDER,0,0,0,456,6,462,870,39,909,238,3,241,1564,48,1612
ASSAM,2003,ATTEMPT TO COMMIT MURDER,7,0,7,65,2,67,206,3,209,42,2,44,320,7,327
ASSAM,2003,C.H. NOT AMOUNTING TO MURDER,1,0,1,63,1,64,120,4,124,27,1,28,211,6,217
ASSAM,2003,RAPE,2,0,2,73,0,73,139,0,139,8,0,8,222,0,222
ASSAM,2003,KIDNAPPING AND ABDUCTION,0,0,0,29,0,29,35,0,35,0,0,0,64,0,64
ASSAM,2003,DACOITY,0,0,0,30,0,30,76,0,76,6,0,6,112,0,112
ASSAM,2003,PREP. AND ASSEMBLY FOR DACOITY,0,0,0,10,0,10,2,0,2,2,0,2,14,0,14
ASSAM,2003,ROBBERY,2,0,2,23,0,23,27,0,27,0,0,0,52,0,52
ASSAM,2003,BURGLARY,0,0,0,0,0,0,6,0,6,0,0,0,6,0,6
ASSAM,2003,THEFTS,5,0,5,56,0,56,139,0,139,5,0,5,205,0,205
ASSAM,2003,EXTORTION,0,0,0,1,0,1,17,0,17,0,0,0,18,0,18
ASSAM,2003,RIOTS,0,0,0,10,0,10,0,0,0,3,0,3,13,0,13
ASSAM,2003,ARSON,0,0,0,1,0,1,22,0,22,0,0,0,23,0,23
ASSAM,2003,CRIMINAL BREACH OF TRUST,0,0,0,0,0,0,0,0,0,0,0,0,0,0,0
ASSAM,2003,CHEATING,0,0,0,0,0,0,0,0,0,0,0,0,0,0,0
ASSAM,2003,COUNTER FEITING,0,0,0,1,0,1,1,0,1,0,0,0,2,0,2
ASSAM,2003,DOWRY DEATHS,0,0,0,4,2,6,17,5,22,0,0,0,21,7,28
ASSAM,2003,MOLESTATION,0,0,0,0,0,0,1,0,1,0,0,0,1,0,1
ASSAM,2003,EVE-TEASING,0,0,0,0,0,0,0,0,0,0,0,0,0,0,0
ASSAM,2003,CRUELTY BY HUSBAND OR RELATIVE OF HUSBAND,0,0,0,17,1,18,35,1,36,12,0,12,64,2,66
ASSAM,2003,OTHER IPC CRIMES,0,0,0,16,0,16,28,0,28,9,0,9,53,0,53
ASSAM,2003,TOTAL IPC,17,0,17,855,12,867,1741,52,1793,352,6,358,2965,70,3035
ASSAM,2004,MURDER,0,0,0,460,11,471,749,37,786,476,5,481,1685,53,1738
ASSAM,2004,ATTEMPT TO COMMIT MURDER,0,0,0,43,0,43,144,2,146,35,0,35,222,2,224
ASSAM,2004,C.H. NOT AMOUNTING TO MURDER,0,0,0,51,0,51,127,5,132,36,0,36,214,5,219
ASSAM,2004,RAPE,1,0,1,105,0,105,172,0,172,20,0,20,298,0,298
ASSAM,2004,KIDNAPPING AND ABDUCTION,0,0,0,13,0,13,51,4,55,0,0,0,64,4,68
ASSAM,2004,DACOITY,0,0,0,33,0,33,48,1,49,14,0,14,95,1,96
ASSAM,2004,PREP. AND ASSEMBLY FOR DACOITY,0,0,0,0,0,0,14,0,14,0,0,0,14,0,14
ASSAM,2004,ROBBERY,0,0,0,9,0,9,14,0,14,1,0,1,24,0,24
ASSAM,2004,BURGLARY,0,0,0,5,0,5,14,0,14,2,0,2,21,0,21
ASSAM,2004,THEFTS,4,0,4,45,0,45,108,0,108,17,0,17,174,0,174
ASSAM,2004,EXTORTION,0,0,0,4,0,4,15,0,15,0,0,0,19,0,19
ASSAM,2004,RIOTS,0,0,0,0,0,0,0,0,0,0,0,0,0,0,0
ASSAM,2004,ARSON,0,0,0,2,0,2,7,0,7,4,0,4,13,0,13
ASSAM,2004,CRIMINAL BREACH OF TRUST,0,0,0,0,0,0,0,0,0,0,0,0,0,0,0
ASSAM,2004,CHEATING,0,0,0,3,0,3,12,0,12,4,0,4,19,0,19
ASSAM,2004,COUNTER FEITING,0,0,0,28,2,30,66,5,71,45,0,45,139,7,146
ASSAM,2004,DOWRY DEATHS,0,0,0,8,0,8,6,0,6,4,1,5,18,1,19
ASSAM,2004,MOLESTATION,0,0,0,0,0,0,1,0,1,0,0,0,1,0,1
ASSAM,2004,EVE-TEASING,0,0,0,0,0,0,0,0,0,0,0,0,0,0,0
ASSAM,2004,CRUELTY BY HUSBAND OR RELATIVE OF HUSBAND,0,0,0,2,0,2,1,0,1,0,0,0,3,0,3
ASSAM,2004,OTHER IPC CRIMES,0,0,0,16,0,16,33,0,33,6,0,6,55,0,55
ASSAM,2004,TOTAL IPC,5,0,5,827,13,840,1582,54,1636,664,6,670,3078,73,3151
ASSAM,2005,MURDER,4,0,4,502,15,517,1128,30,1158,406,6,412,2040,51,2091
ASSAM,2005,MURDER,0,0,0,0,0,0,0,0,0,0,0,0,0,0,0
ASSAM,2005,MURDER,0,0,0,0,0,0,0,0,0,0,0,0,0,0,0
ASSAM,2005,ATTEMPT TO COMMIT MURDER,3,0,3,56,1,57,76,2,78,16,0,16,151,3,154
ASSAM,2005,C.H. NOT AMOUNTING TO MURDER,0,0,0,57,4,61,131,7,138,27,0,27,215,11,226
ASSAM,2005,RAPE,1,0,1,128,0,128,169,0,169,17,2,19,315,2,317
ASSAM,2005,KIDNAPPING AND ABDUCTION,0,0,0,25,1,26,46,2,48,9,0,9,80,3,83
ASSAM,2005,DACOITY,0,0,0,28,0,28,59,0,59,16,0,16,103,0,103
ASSAM,2005,PREP. AND ASSEMBLY FOR DACOITY,0,0,0,0,0,0,5,0,5,2,0,2,7,0,7
ASSAM,2005,ROBBERY,0,0,0,11,0,11,8,0,8,0,0,0,19,0,19
ASSAM,2005,BURGLARY,0,0,0,6,0,6,28,0,28,1,0,1,35,0,35
ASSAM,2005,THEFTS,0,0,0,69,0,69,87,1,88,12,0,12,168,1,169
ASSAM,2005,EXTORTION,0,0,0,1,0,1,8,0,8,0,0,0,9,0,9
ASSAM,2005,RIOTS,0,0,0,5,0,5,11,1,12,0,0,0,16,1,17
ASSAM,2005,ARSON,0,0,0,10,0,10,4,0,4,0,0,0,14,0,14
ASSAM,2005,CRIMINAL BREACH OF TRUST,0,0,0,0,0,0,3,0,3,0,0,0,3,0,3
ASSAM,2005,CHEATING,0,0,0,3,0,3,3,0,3,0,0,0,6,0,6
ASSAM,2005,COUNTER FEITING,0,0,0,0,0,0,2,1,3,0,0,0,2,1,3
ASSAM,2005,DOWRY DEATHS,0,0,0,2,0,2,11,1,12,0,0,0,13,1,14
ASSAM,2005,MOLESTATION,0,0,0,1,0,1,1,0,1,0,0,0,2,0,2
ASSAM,2005,EVE-TEASING,0,0,0,0,0,0,0,0,0,0,0,0,0,0,0
ASSAM,2005,CRUELTY BY HUSBAND OR RELATIVE OF HUSBAND,0,0,0,6,0,6,6,0,6,4,0,4,16,0,16
ASSAM,2005,OTHER IPC CRIMES,0,0,0,10,0,10,15,0,15,0,0,0,25,0,25
ASSAM,2005,TOTAL IPC,8,0,8,920,21,941,1801,45,1846,510,8,518,3239,74,3313
ASSAM,2006,MURDER,0,0,0,553,21,574,1102,27,1129,320,6,326,1975,54,2029
ASSAM,2006,ATTEMPT TO COMMIT MURDER,0,0,0,52,9,61,75,0,75,42,0,42,169,9,178
ASSAM,2006,C.H. NOT AMOUNTING TO MURDER,0,0,0,127,2,129,92,7,99,22,1,23,241,10,251
ASSAM,2006,RAPE,0,0,0,157,0,157,173,0,173,13,0,13,343,0,343
ASSAM,2006,KIDNAPPING AND ABDUCTION,0,0,0,34,0,34,47,3,50,0,0,0,81,3,84
ASSAM,2006,DACOITY,0,0,0,53,0,53,62,0,62,10,0,10,125,0,125
ASSAM,2006,PREP. AND ASSEMBLY FOR DACOITY,0,0,0,0,0,0,1,0,1,0,0,0,1,0,1
ASSAM,2006,ROBBERY,0,0,0,15,0,15,15,0,15,4,0,4,34,0,34
ASSAM,2006,BURGLARY,0,0,0,7,1,8,7,1,8,2,0,2,16,2,18
ASSAM,2006,THEFTS,0,0,0,46,1,47,72,0,72,4,0,4,122,1,123
ASSAM,2006,EXTORTION,0,0,0,3,0,3,0,0,0,0,0,0,3,0,3
ASSAM,2006,RIOTS,0,0,0,1,0,1,3,0,3,5,0,5,9,0,9
ASSAM,2006,ARSON,0,0,0,11,0,11,9,0,9,3,0,3,23,0,23
ASSAM,2006,CRIMINAL BREACH OF TRUST,0,0,0,0,0,0,3,0,3,1,0,1,4,0,4
ASSAM,2006,CHEATING,0,0,0,5,0,5,9,0,9,0,0,0,14,0,14
ASSAM,2006,COUNTER FEITING,0,0,0,0,0,0,0,0,0,0,0,0,0,0,0
ASSAM,2006,DOWRY DEATHS,0,0,0,12,0,12,8,0,8,6,0,6,26,0,26
ASSAM,2006,MOLESTATION,0,0,0,1,0,1,0,0,0,0,0,0,1,0,1
ASSAM,2006,EVE-TEASING,0,0,0,0,0,0,0,0,0,0,0,0,0,0,0
ASSAM,2006,CRUELTY BY HUSBAND OR RELATIVE OF HUSBAND,0,0,0,12,0,12,7,0,7,0,0,0,19,0,19
ASSAM,2006,OTHER IPC CRIMES,0,0,0,54,1,55,83,2,85,13,0,13,150,3,153
ASSAM,2006,TOTAL IPC,0,0,0,1143,35,1178,1768,40,1808,445,7,452,3356,82,3438
ASSAM,2007,MURDER,0,0,0,640,19,659,1264,38,1302,303,14,317,2207,71,2278
ASSAM,2007,ATTEMPT TO COMMIT MURDER,0,0,0,70,5,75,85,1,86,20,0,20,175,6,181
ASSAM,2007,C.H. NOT AMOUNTING TO MURDER,0,0,0,67,0,67,137,6,143,34,0,34,238,6,244
ASSAM,2007,RAPE,0,0,0,171,1,172,153,0,153,35,0,35,359,1,360
ASSAM,2007,KIDNAPPING AND ABDUCTION,0,0,0,37,2,39,29,1,30,3,0,3,69,3,72
ASSAM,2007,DACOITY,0,0,0,29,0,29,37,0,37,15,0,15,81,0,81
ASSAM,2007,PREP. AND ASSEMBLY FOR DACOITY,0,0,0,0,0,0,1,0,1,0,0,0,1,0,1
ASSAM,2007,ROBBERY,0,0,0,7,0,7,10,0,10,4,0,4,21,0,21
ASSAM,2007,BURGLARY,0,0,0,3,0,3,3,0,3,0,0,0,6,0,6
ASSAM,2007,THEFTS,0,0,0,26,0,26,29,0,29,8,0,8,63,0,63
ASSAM,2007,EXTORTION,0,0,0,2,0,2,10,0,10,2,0,2,14,0,14
ASSAM,2007,RIOTS,0,0,0,0,0,0,2,0,2,1,0,1,3,0,3
ASSAM,2007,ARSON,0,0,0,4,0,4,12,0,12,2,0,2,18,0,18
ASSAM,2007,CRIMINAL BREACH OF TRUST,0,0,0,5,0,5,2,0,2,0,0,0,7,0,7
ASSAM,2007,CHEATING,0,0,0,3,0,3,8,0,8,2,0,2,13,0,13
ASSAM,2007,COUNTER FEITING,0,0,0,10,0,10,3,0,3,0,0,0,13,0,13
ASSAM,2007,DOWRY DEATHS,0,0,0,2,0,2,24,4,28,3,0,3,29,4,33
ASSAM,2007,MOLESTATION,0,0,0,0,0,0,1,0,1,0,0,0,1,0,1
ASSAM,2007,EVE-TEASING,0,0,0,0,0,0,0,0,0,0,0,0,0,0,0
ASSAM,2007,CRUELTY BY HUSBAND OR RELATIVE OF HUSBAND,0,0,0,14,1,15,16,1,17,1,1,2,31,3,34
ASSAM,2007,OTHER IPC CRIMES,0,0,0,8,0,8,33,0,33,4,0,4,45,0,45
ASSAM,2007,TOTAL IPC,0,0,0,1098,28,1126,1859,51,1910,437,15,452,3394,94,3488
ASSAM,2008,MURDER,0,0,0,648,15,663,1135,27,1162,290,20,310,2073,62,2135
ASSAM,2008,ATTEMPT TO COMMIT MURDER,0,0,0,48,4,52,87,2,89,27,2,29,162,8,170
ASSAM,2008,C.H. NOT AMOUNTING TO MURDER,0,0,0,62,2,64,120,1,121,31,0,31,213,3,216
ASSAM,2008,RAPE,0,0,0,136,1,137,194,0,194,41,0,41,371,1,372
ASSAM,2008,KIDNAPPING AND ABDUCTION,0,0,0,51,3,54,30,1,31,5,2,7,86,6,92
ASSAM,2008,DACOITY,0,0,0,12,2,14,31,0,31,9,0,9,52,2,54
ASSAM,2008,PREP. AND ASSEMBLY FOR DACOITY,0,0,0,0,0,0,0,0,0,0,0,0,0,0,0
ASSAM,2008,ROBBERY,0,0,0,14,2,16,10,0,10,7,0,7,31,2,33
ASSAM,2008,BURGLARY,0,0,0,7,0,7,7,0,7,0,0,0,14,0,14
ASSAM,2008,THEFTS,0,0,0,34,0,34,43,0,43,13,0,13,90,0,90
ASSAM,2008,EXTORTION,0,0,0,3,0,3,10,0,10,4,0,4,17,0,17
ASSAM,2008,RIOTS,0,0,0,6,0,6,1,0,1,0,0,0,7,0,7
ASSAM,2008,ARSON,0,0,0,8,0,8,10,0,10,3,0,3,21,0,21
ASSAM,2008,CRIMINAL BREACH OF TRUST,0,0,0,4,0,4,3,0,3,0,0,0,7,0,7
ASSAM,2008,CHEATING,0,0,0,4,0,4,10,0,10,3,0,3,17,0,17
ASSAM,2008,COUNTER FEITING,0,0,0,12,0,12,9,0,9,0,0,0,21,0,21
ASSAM,2008,DOWRY DEATHS,0,0,0,2,0,2,24,0,24,4,1,5,30,1,31
ASSAM,2008,MOLESTATION,0,0,0,0,0,0,3,0,3,0,0,0,3,0,3
ASSAM,2008,EVE-TEASING,0,0,0,0,0,0,1,0,1,0,0,0,1,0,1
ASSAM,2008,CRUELTY BY HUSBAND OR RELATIVE OF HUSBAND,0,0,0,16,2,18,20,1,21,2,0,2,38,3,41
ASSAM,2008,OTHER IPC CRIMES,0,0,0,10,1,11,30,3,33,7,0,7,47,4,51
ASSAM,2008,TOTAL IPC,0,0,0,1077,32,1109,1778,35,1813,446,25,471,3301,92,3393
ASSAM,2009,MURDER,0,0,0,497,18,515,1035,30,1065,386,12,398,1918,60,1978
ASSAM,2009,ATTEMPT TO COMMIT MURDER,0,0,0,62,2,64,89,6,95,56,1,57,207,9,216
ASSAM,2009,C.H. NOT AMOUNTING TO MURDER,0,0,0,57,2,59,110,8,118,26,1,27,193,11,204
ASSAM,2009,RAPE,0,0,0,150,0,150,169,0,169,28,0,28,347,0,347
ASSAM,2009,KIDNAPPING AND ABDUCTION,0,0,0,32,2,34,50,1,51,0,0,0,82,3,85
ASSAM,2009,DACOITY,0,0,0,11,0,11,38,0,38,7,0,7,56,0,56
ASSAM,2009,PREP. AND ASSEMBLY FOR DACOITY,0,0,0,0,0,0,1,0,1,0,0,0,1,0,1
ASSAM,2009,ROBBERY,0,0,0,17,0,17,18,0,18,0,0,0,35,0,35
ASSAM,2009,BURGLARY,0,0,0,4,0,4,10,0,10,0,0,0,14,0,14
ASSAM,2009,THEFTS,0,0,0,31,0,31,57,2,59,1,0,1,89,2,91
ASSAM,2009,EXTORTION,0,0,0,5,0,5,11,0,11,2,0,2,18,0,18
ASSAM,2009,RIOTS,0,0,0,5,0,5,3,0,3,0,0,0,8,0,8
ASSAM,2009,ARSON,0,0,0,9,0,9,13,0,13,3,0,3,25,0,25
ASSAM,2009,CRIMINAL BREACH OF TRUST,0,0,0,4,0,4,3,0,3,0,0,0,7,0,7
ASSAM,2009,CHEATING,0,0,0,5,0,5,2,0,2,0,0,0,7,0,7
ASSAM,2009,COUNTER FEITING,0,0,0,8,0,8,6,0,6,0,0,0,14,0,14
ASSAM,2009,DOWRY DEATHS,0,0,0,3,0,3,17,0,17,10,0,10,30,0,30
ASSAM,2009,MOLESTATION,0,0,0,0,0,0,2,0,2,0,0,0,2,0,2
ASSAM,2009,EVE-TEASING,0,0,0,0,0,0,0,0,0,0,0,0,0,0,0
ASSAM,2009,CRUELTY BY HUSBAND OR RELATIVE OF HUSBAND,0,0,0,10,0,10,23,0,23,0,0,0,33,0,33
ASSAM,2009,OTHER IPC CRIMES,0,0,0,0,0,0,0,0,0,0,0,0,0,0,0
ASSAM,2009,TOTAL IPC,0,0,0,910,24,934,1657,47,1704,519,14,533,3086,85,3171
ASSAM,2010,MURDER,0,0,0,494,16,510,1065,42,1107,396,8,404,1955,66,2021
ASSAM,2010,ATTEMPT TO COMMIT MURDER,0,0,0,43,3,46,93,6,99,61,0,61,197,9,206
ASSAM,2010,C.H. NOT AMOUNTING TO MURDER,0,0,0,65,2,67,106,9,115,26,0,26,197,11,208
ASSAM,2010,RAPE,0,0,0,70,0,70,165,1,166,30,0,30,265,1,266
ASSAM,2010,KIDNAPPING AND ABDUCTION,0,0,0,26,2,28,45,0,45,0,0,0,71,2,73
ASSAM,2010,DACOITY,0,0,0,18,0,18,32,0,32,5,0,5,55,0,55
ASSAM,2010,PREP. AND ASSEMBLY FOR DACOITY,0,0,0,2,0,2,0,0,0,1,0,1,3,0,3
ASSAM,2010,ROBBERY,0,0,0,14,0,14,16,0,16,0,0,0,30,0,30
ASSAM,2010,BURGLARY,0,0,0,3,0,3,8,0,8,0,1,1,11,1,12
ASSAM,2010,THEFTS,0,0,0,23,0,23,71,1,72,12,0,12,106,1,107
ASSAM,2010,EXTORTION,0,0,0,3,0,3,4,0,4,1,0,1,8,0,8
ASSAM,2010,RIOTS,0,0,0,6,0,6,3,0,3,0,0,0,9,0,9
ASSAM,2010,ARSON,0,0,0,7,0,7,12,0,12,2,0,2,21,0,21
ASSAM,2010,CRIMINAL BREACH OF TRUST,0,0,0,2,0,2,1,0,1,0,0,0,3,0,3
ASSAM,2010,CHEATING,0,0,0,4,0,4,2,0,2,0,0,0,6,0,6
ASSAM,2010,COUNTER FEITING,0,0,0,7,0,7,5,0,5,0,0,0,12,0,12
ASSAM,2010,DOWRY DEATHS,0,0,0,3,0,3,20,0,20,3,2,5,26,2,28
ASSAM,2010,MOLESTATION,0,0,0,0,0,0,2,0,2,0,0,0,2,0,2
ASSAM,2010,EVE-TEASING,0,0,0,0,0,0,0,0,0,0,0,0,0,0,0
ASSAM,2010,CRUELTY BY HUSBAND OR RELATIVE OF HUSBAND,0,0,0,6,0,6,17,0,17,1,0,1,24,0,24
ASSAM,2010,OTHER IPC CRIMES,0,0,0,11,0,11,19,3,22,4,0,4,34,3,37
ASSAM,2010,TOTAL IPC,0,0,0,807,23,830,1686,62,1748,542,11,553,3035,96,3131
ASSAM,2011,MURDER,0,0,0,482,17,499,984,34,1018,385,6,391,1851,57,1908
ASSAM,2011,ATTEMPT TO COMMIT MURDER,0,0,0,40,2,42,110,7,117,57,0,57,207,9,216
ASSAM,2011,C.H. NOT AMOUNTING TO MURDER,0,0,0,50,2,52,99,8,107,25,0,25,174,10,184
ASSAM,2011,RAPE,0,0,0,82,0,82,155,2,157,20,0,20,257,2,259
ASSAM,2011,KIDNAPPING AND ABDUCTION,0,0,0,23,1,24,37,0,37,2,2,4,62,3,65
ASSAM,2011,DACOITY,0,0,0,15,0,15,33,0,33,6,1,7,54,1,55
ASSAM,2011,PREP. AND ASSEMBLY FOR DACOITY,0,0,0,1,0,1,0,0,0,2,0,2,3,0,3
ASSAM,2011,ROBBERY,0,0,0,12,0,12,17,1,18,0,0,0,29,1,30
ASSAM,2011,BURGLARY,0,0,0,2,0,2,9,0,9,0,0,0,11,0,11
ASSAM,2011,THEFTS,0,0,0,24,0,24,69,1,70,13,1,14,106,2,108
ASSAM,2011,EXTORTION,0,0,0,2,0,2,5,0,5,2,0,2,9,0,9
ASSAM,2011,RIOTS,0,0,0,8,0,8,3,0,3,0,0,0,11,0,11
ASSAM,2011,ARSON,0,0,0,6,0,6,10,0,10,2,0,2,18,0,18
ASSAM,2011,CRIMINAL BREACH OF TRUST,0,0,0,1,0,1,1,0,1,0,0,0,2,0,2
ASSAM,2011,CHEATING,0,0,0,2,0,2,1,0,1,0,0,0,3,0,3
ASSAM,2011,COUNTER FEITING,0,0,0,9,0,9,4,0,4,0,0,0,13,0,13
ASSAM,2011,DOWRY DEATHS,0,0,0,2,0,2,21,0,21,2,0,2,25,0,25
ASSAM,2011,MOLESTATION,0,0,0,0,0,0,2,0,2,0,0,0,2,0,2
ASSAM,2011,EVE-TEASING,0,0,0,0,0,0,0,0,0,0,0,0,0,0,0
ASSAM,2011,CRUELTY BY HUSBAND OR RELATIVE OF HUSBAND,0,0,0,5,0,5,18,0,18,1,0,1,24,0,24
ASSAM,2011,OTHER IPC CRIMES,0,0,0,10,0,10,20,4,24,3,0,3,33,4,37
ASSAM,2011,TOTAL IPC,0,0,0,776,22,798,1598,57,1655,520,10,530,2894,89,2983
ASSAM,2012,MURDER,0,0,0,484,17,501,986,35,1021,375,7,382,1845,59,1904
ASSAM,2012,ATTEMPT TO COMMIT MURDER,0,0,0,42,2,44,110,7,117,57,0,57,209,9,218
ASSAM,2012,C.H. NOT AMOUNTING TO MURDER,0,0,0,48,2,50,98,7,105,25,0,25,171,9,180
ASSAM,2012,RAPE,0,0,0,84,0,84,155,2,157,20,0,20,259,2,261
ASSAM,2012,KIDNAPPING AND ABDUCTION,0,0,0,23,1,24,37,0,37,2,2,4,62,3,65
ASSAM,2012,DACOITY,0,0,0,16,0,16,34,0,34,6,1,7,56,1,57
ASSAM,2012,PREP. AND ASSEMBLY FOR DACOITY,0,0,0,1,0,1,0,0,0,2,0,2,3,0,3
ASSAM,2012,ROBBERY,0,0,0,13,0,13,16,1,17,0,0,0,29,1,30
ASSAM,2012,BURGLARY,0,0,0,2,0,2,9,0,9,0,0,0,11,0,11
ASSAM,2012,THEFTS,0,0,0,25,0,25,70,1,71,13,1,14,108,2,110
ASSAM,2012,EXTORTION,0,0,0,2,0,2,5,0,5,2,0,2,9,0,9
ASSAM,2012,RIOTS,0,0,0,9,0,9,2,0,2,0,0,0,11,0,11
ASSAM,2012,ARSON,0,0,0,5,0,5,11,0,11,2,0,2,18,0,18
ASSAM,2012,CRIMINAL BREACH OF TRUST,0,0,0,1,0,1,1,0,1,0,0,0,2,0,2
ASSAM,2012,CHEATING,0,0,0,2,0,2,1,0,1,0,0,0,3,0,3
ASSAM,2012,COUNTER FEITING,0,0,0,9,0,9,4,0,4,0,0,0,13,0,13
ASSAM,2012,DOWRY DEATHS,0,0,0,2,0,2,22,0,22,2,0,2,26,0,26
ASSAM,2012,MOLESTATION,0,0,0,0,0,0,2,0,2,0,0,0,2,0,2
ASSAM,2012,EVE-TEASING,0,0,0,0,0,0,0,0,0,0,0,0,0,0,0
ASSAM,2012,CRUELTY BY HUSBAND OR RELATIVE OF HUSBAND,0,0,0,6,0,6,18,0,18,1,0,1,25,0,25
ASSAM,2012,OTHER IPC CRIMES,0,0,0,11,0,11,21,4,25,3,0,3,35,4,39
ASSAM,2012,TOTAL IPC,0,0,0,785,22,807,1602,57,1659,510,11,521,2897,90,2987
BIHAR,2001,MURDER,1,0,1,385,4,389,1468,10,1478,935,24,959,2789,38,2827
BIHAR,2001,ATTEMPT TO COMMIT MURDER,0,0,0,132,1,133,230,3,233,156,0,156,518,4,522
BIHAR,2001,C.H. NOT AMOUNTING TO MURDER,0,0,0,15,2,17,65,0,65,25,0,25,105,2,107
BIHAR,2001,RAPE,2,0,2,44,0,44,75,0,75,26,0,26,147,0,147
BIHAR,2001,KIDNAPPING AND ABDUCTION,0,0,0,75,0,75,65,0,65,31,0,31,171,0,171
BIHAR,2001,DACOITY,0,0,0,58,0,58,91,0,91,51,0,51,200,0,200
BIHAR,2001,PREP. AND ASSEMBLY FOR DACOITY,0,0,0,5,0,5,18,0,18,12,0,12,35,0,35
BIHAR,2001,ROBBERY,4,0,4,60,0,60,35,0,35,25,0,25,124,0,124
BIHAR,2001,BURGLARY,0,0,0,21,0,21,5,6,11,10,0,10,36,6,42
BIHAR,2001,THEFTS,4,0,4,45,0,45,31,0,31,14,0,14,94,0,94
BIHAR,2001,EXTORTION,0,0,0,0,0,0,0,0,0,0,0,0,0,0,0
BIHAR,2001,RIOTS,0,0,0,0,0,0,0,0,0,0,0,0,0,0,0
BIHAR,2001,ARSON,0,0,0,0,0,0,0,0,0,0,0,0,0,0,0
BIHAR,2001,CRIMINAL BREACH OF TRUST,0,0,0,0,0,0,0,0,0,0,0,0,0,0,0
BIHAR,2001,CHEATING,0,0,0,35,0,35,18,0,18,17,0,17,70,0,70
BIHAR,2001,COUNTER FEITING,0,0,0,0,0,0,0,0,0,0,0,0,0,0,0
BIHAR,2001,DOWRY DEATHS,0,0,0,0,0,0,0,0,0,0,0,0,0,0,0
BIHAR,2001,MOLESTATION,0,0,0,0,0,0,0,0,0,0,0,0,0,0,0
BIHAR,2001,EVE-TEASING,0,0,0,0,0,0,0,0,0,0,0,0,0,0,0
BIHAR,2001,CRUELTY BY HUSBAND OR RELATIVE OF HUSBAND,0,0,0,0,0,0,0,0,0,0,0,0,0,0,0
BIHAR,2001,OTHER IPC CRIMES,0,0,0,9,0,9,5,0,5,11,0,11,25,0,25
BIHAR,2001,TOTAL IPC,11,0,11,884,7,891,2106,19,2125,1313,24,1337,4314,50,4364
BIHAR,2002,MURDER,4,0,4,387,9,396,1529,35,1564,1105,7,1112,3025,51,3076
BIHAR,2002,ATTEMPT TO COMMIT MURDER,0,0,0,113,0,113,75,1,76,33,0,33,221,1,222
BIHAR,2002,C.H. NOT AMOUNTING TO MURDER,2,0,2,32,0,32,54,8,62,36,1,37,124,9,133
BIHAR,2002,RAPE,0,0,0,75,0,75,33,0,33,10,0,10,118,0,118
BIHAR,2002,KIDNAPPING AND ABDUCTION,0,0,0,28,0,28,67,1,68,21,0,21,116,1,117
BIHAR,2002,DACOITY,0,0,0,59,0,59,173,3,176,41,0,41,273,3,276
BIHAR,2002,PREP. AND ASSEMBLY FOR DACOITY,0,0,0,7,0,7,7,0,7,0,0,0,14,0,14
BIHAR,2002,ROBBERY,2,0,2,21,0,21,28,0,28,0,0,0,51,0,51
BIHAR,2002,BURGLARY,0,0,0,7,0,7,1,0,1,4,0,4,12,0,12
BIHAR,2002,THEFTS,4,0,4,54,2,56,62,1,63,7,0,7,127,3,130
BIHAR,2002,EXTORTION,0,0,0,0,0,0,2,0,2,1,0,1,3,0,3
BIHAR,2002,RIOTS,10,0,10,18,0,18,12,0,12,4,0,4,44,0,44
BIHAR,2002,ARSON,0,0,0,2,0,2,1,0,1,0,0,0,3,0,3
BIHAR,2002,CRIMINAL BREACH OF TRUST,0,0,0,0,0,0,0,0,0,1,0,1,1,0,1
BIHAR,2002,CHEATING,0,0,0,0,0,0,5,0,5,1,0,1,6,0,6
BIHAR,2002,COUNTER FEITING,0,0,0,0,0,0,15,0,15,0,0,0,15,0,15
BIHAR,2002,DOWRY DEATHS,0,0,0,55,11,66,65,4,69,33,3,36,153,18,171
BIHAR,2002,MOLESTATION,0,0,0,1,0,1,1,0,1,0,0,0,2,0,2
BIHAR,2002,EVE-TEASING,0,0,0,0,0,0,0,0,0,0,0,0,0,0,0
BIHAR,2002,CRUELTY BY HUSBAND OR RELATIVE OF HUSBAND,2,0,2,4,0,4,6,2,8,6,0,6,18,2,20
BIHAR,2002,OTHER IPC CRIMES,0,0,0,1,0,1,36,4,40,0,1,1,37,5,42
BIHAR,2002,TOTAL IPC,24,0,24,864,22,886,2172,59,2231,1303,12,1315,4363,93,4456
BIHAR,2003,MURDER,0,0,0,329,6,335,1851,29,1880,850,22,872,3030,57,3087
BIHAR,2003,ATTEMPT TO COMMIT MURDER,0,0,0,96,0,96,137,1,138,62,0,62,295,1,296
BIHAR,2003,C.H. NOT AMOUNTING TO MURDER,0,0,0,24,0,24,57,0,57,38,1,39,119,1,120
BIHAR,2003,RAPE,0,0,0,77,0,77,75,0,75,22,0,22,174,0,174
BIHAR,2003,KIDNAPPING AND ABDUCTION,0,0,0,23,0,23,61,3,64,34,0,34,118,3,121
BIHAR,2003,DACOITY,0,0,0,69,0,69,139,0,139,53,0,53,261,0,261
BIHAR,2003,PREP. AND ASSEMBLY FOR DACOITY,0,0,0,8,0,8,19,0,19,9,0,9,36,0,36
BIHAR,2003,ROBBERY,0,0,0,14,0,14,32,0,32,0,0,0,46,0,46
BIHAR,2003,BURGLARY,0,0,0,4,0,4,19,0,19,6,0,6,29,0,29
BIHAR,2003,THEFTS,0,0,0,59,0,59,73,0,73,12,0,12,144,0,144
BIHAR,2003,EXTORTION,0,0,0,2,0,2,3,0,3,0,0,0,5,0,5
BIHAR,2003,RIOTS,0,0,0,0,0,0,0,0,0,0,0,0,0,0,0
BIHAR,2003,ARSON,0,0,0,1,0,1,3,0,3,0,0,0,4,0,4
BIHAR,2003,CRIMINAL BREACH OF TRUST,0,0,0,0,0,0,0,0,0,1,0,1,1,0,1
BIHAR,2003,CHEATING,0,0,0,1,0,1,2,0,2,0,0,0,3,0,3
BIHAR,2003,COUNTER FEITING,0,0,0,0,0,0,3,0,3,2,0,2,5,0,5
BIHAR,2003,DOWRY DEATHS,0,0,0,64,8,72,97,14,111,52,6,58,213,28,241
BIHAR,2003,MOLESTATION,0,0,0,0,0,0,1,5,6,1,0,1,2,5,7
BIHAR,2003,EVE-TEASING,0,0,0,0,0,0,0,0,0,0,0,0,0,0,0
BIHAR,2003,CRUELTY BY HUSBAND OR RELATIVE OF HUSBAND,0,0,0,0,0,0,7,0,7,0,0,0,7,0,7
BIHAR,2003,OTHER IPC CRIMES,0,0,0,9,0,9,12,0,12,5,0,5,26,0,26
BIHAR,2003,TOTAL IPC,0,0,0,780,14,794,2591,52,2643,1147,29,1176,4518,95,4613
BIHAR,2004,MURDER,0,0,0,431,14,445,2087,40,2127,1017,27,1044,3535,81,3616
BIHAR,2004,ATTEMPT TO COMMIT MURDER,0,0,0,118,0,118,162,3,165,59,0,59,339,3,342
BIHAR,2004,C.H. NOT AMOUNTING TO MURDER,0,0,0,19,0,19,76,4,80,15,1,16,110,5,115
BIHAR,2004,RAPE,0,0,0,69,0,69,71,0,71,19,0,19,159,0,159
BIHAR,2004,KIDNAPPING AND ABDUCTION,0,0,0,44,1,45,94,1,95,31,1,32,169,3,172
BIHAR,2004,DACOITY,0,0,0,68,0,68,115,0,115,43,0,43,226,0,226
BIHAR,2004,PREP. AND ASSEMBLY FOR DACOITY,0,0,0,6,0,6,17,0,17,6,0,6,29,0,29
BIHAR,2004,ROBBERY,0,0,0,19,0,19,18,0,18,3,0,3,40,0,40
BIHAR,2004,BURGLARY,0,0,0,15,0,15,19,0,19,5,0,5,39,0,39
BIHAR,2004,THEFTS,0,0,0,77,0,77,108,1,109,22,0,22,207,1,208
BIHAR,2004,EXTORTION,0,0,0,0,0,0,6,0,6,2,0,2,8,0,8
BIHAR,2004,RIOTS,0,0,0,6,0,6,2,0,2,0,0,0,8,0,8
BIHAR,2004,ARSON,0,0,0,0,0,0,3,0,3,0,0,0,3,0,3
BIHAR,2004,CRIMINAL BREACH OF TRUST,0,0,0,0,0,0,0,0,0,1,0,1,1,0,1
BIHAR,2004,CHEATING,0,0,0,1,0,1,4,0,4,2,0,2,7,0,7
BIHAR,2004,COUNTER FEITING,0,0,0,10,0,10,10,0,10,4,0,4,24,0,24
BIHAR,2004,DOWRY DEATHS,0,0,0,50,2,52,77,11,88,46,9,55,173,22,195
BIHAR,2004,MOLESTATION,0,0,0,0,0,0,2,0,2,0,0,0,2,0,2
BIHAR,2004,EVE-TEASING,0,0,0,0,0,0,0,0,0,0,0,0,0,0,0
BIHAR,2004,CRUELTY BY HUSBAND OR RELATIVE OF HUSBAND,0,0,0,16,0,16,10,2,12,6,0,6,32,2,34
BIHAR,2004,OTHER IPC CRIMES,0,0,0,3,0,3,11,0,11,0,0,0,14,0,14
BIHAR,2004,TOTAL IPC,0,0,0,952,17,969,2892,62,2954,1281,38,1319,5125,117,5242
BIHAR,2005,MURDER,0,0,0,704,10,714,1858,25,1883,945,5,950,3507,40,3547
BIHAR,2005,ATTEMPT TO COMMIT MURDER,0,0,0,106,1,107,226,3,229,92,0,92,424,4,428
BIHAR,2005,C.H. NOT AMOUNTING TO MURDER,0,0,0,39,5,44,84,3,87,17,0,17,140,8,148
BIHAR,2005,RAPE,0,0,0,71,1,72,75,0,75,15,0,15,161,1,162
BIHAR,2005,KIDNAPPING AND ABDUCTION,0,0,0,91,5,96,101,4,105,29,0,29,221,9,230
BIHAR,2005,DACOITY,0,0,0,68,0,68,123,0,123,41,0,41,232,0,232
BIHAR,2005,PREP. AND ASSEMBLY FOR DACOITY,0,0,0,13,0,13,18,0,18,5,0,5,36,0,36
BIHAR,2005,ROBBERY,0,0,0,64,0,64,58,0,58,14,0,14,136,0,136
BIHAR,2005,BURGLARY,0,0,0,2,0,2,9,0,9,9,0,9,20,0,20
BIHAR,2005,THEFTS,0,0,0,99,0,99,12,0,12,35,0,35,146,0,146
BIHAR,2005,EXTORTION,0,0,0,4,0,4,9,0,9,2,0,2,15,0,15
BIHAR,2005,RIOTS,0,0,0,8,0,8,5,0,5,5,0,5,18,0,18
BIHAR,2005,ARSON,0,0,0,1,0,1,3,0,3,0,0,0,4,0,4
BIHAR,2005,CRIMINAL BREACH OF TRUST,0,0,0,0,0,0,0,0,0,0,0,0,0,0,0
BIHAR,2005,CHEATING,0,0,0,7,0,7,14,0,14,1,0,1,22,0,22
BIHAR,2005,COUNTER FEITING,0,0,0,3,0,3,10,0,10,0,0,0,13,0,13
BIHAR,2005,DOWRY DEATHS,0,0,0,26,10,36,84,20,104,43,12,55,153,42,195
BIHAR,2005,MOLESTATION,0,0,0,3,0,3,6,0,6,2,0,2,11,0,11
BIHAR,2005,EVE-TEASING,0,0,0,0,0,0,0,0,0,0,0,0,0,0,0
BIHAR,2005,CRUELTY BY HUSBAND OR RELATIVE OF HUSBAND,0,0,0,3,0,3,5,0,5,5,0,5,13,0,13
BIHAR,2005,OTHER IPC CRIMES,0,0,0,2,0,2,8,0,8,3,0,3,13,0,13
BIHAR,2005,TOTAL IPC,0,0,0,1314,32,1346,2708,55,2763,1263,17,1280,5285,104,5389
BIHAR,2006,MURDER,0,0,0,2518,30,2548,593,27,620,257,8,265,3368,65,3433
BIHAR,2006,ATTEMPT TO COMMIT MURDER,0,0,0,339,4,343,197,5,202,18,0,18,554,9,563
BIHAR,2006,C.H. NOT AMOUNTING TO MURDER,0,0,0,94,4,98,70,0,70,13,0,13,177,4,181
BIHAR,2006,RAPE,0,0,0,112,0,112,82,0,82,12,0,12,206,0,206
BIHAR,2006,KIDNAPPING AND ABDUCTION,0,0,0,125,1,126,82,13,95,21,0,21,228,14,242
BIHAR,2006,DACOITY,0,0,0,150,0,150,77,4,81,22,0,22,249,4,253
BIHAR,2006,PREP. AND ASSEMBLY FOR DACOITY,0,0,0,34,0,34,9,0,9,4,0,4,47,0,47
BIHAR,2006,ROBBERY,0,0,0,95,0,95,46,0,46,19,0,19,160,0,160
BIHAR,2006,BURGLARY,0,0,0,23,0,23,18,2,20,5,0,5,46,2,48
BIHAR,2006,THEFTS,0,0,0,125,1,126,25,1,26,5,0,5,155,2,157
BIHAR,2006,EXTORTION,0,0,0,14,0,14,8,0,8,6,0,6,28,0,28
BIHAR,2006,RIOTS,0,0,0,22,0,22,16,0,16,3,0,3,41,0,41
BIHAR,2006,ARSON,0,0,0,18,0,18,10,0,10,3,0,3,31,0,31
BIHAR,2006,CRIMINAL BREACH OF TRUST,0,0,0,17,0,17,7,0,7,0,0,0,24,0,24
BIHAR,2006,CHEATING,0,0,0,21,1,22,11,0,11,6,0,6,38,1,39
BIHAR,2006,COUNTER FEITING,0,0,0,15,1,16,5,2,7,0,0,0,20,3,23
BIHAR,2006,DOWRY DEATHS,0,0,0,113,11,124,44,22,66,23,2,25,180,35,215
BIHAR,2006,MOLESTATION,0,0,0,25,0,25,7,0,7,8,0,8,40,0,40
BIHAR,2006,EVE-TEASING,0,0,0,12,0,12,10,0,10,7,0,7,29,0,29
BIHAR,2006,CRUELTY BY HUSBAND OR RELATIVE OF HUSBAND,0,0,0,29,0,29,23,0,23,9,0,9,61,0,61
BIHAR,2006,OTHER IPC CRIMES,0,0,0,21,0,21,1,0,1,10,0,10,32,0,32
BIHAR,2006,TOTAL IPC,0,0,0,3922,53,3975,1341,76,1417,451,10,461,5714,139,5853
BIHAR,2007,MURDER,0,0,0,956,32,988,1657,10,1667,427,8,435,3040,50,3090
BIHAR,2007,ATTEMPT TO COMMIT MURDER,0,0,0,340,6,346,296,5,301,78,2,80,714,13,727
BIHAR,2007,C.H. NOT AMOUNTING TO MURDER,0,0,0,60,3,63,78,0,78,23,0,23,161,3,164
BIHAR,2007,RAPE,0,0,0,72,0,72,85,0,85,15,0,15,172,0,172
BIHAR,2007,KIDNAPPING AND ABDUCTION,0,0,0,105,1,106,102,13,115,30,2,32,237,16,253
BIHAR,2007,DACOITY,0,0,0,146,0,146,91,4,95,23,0,23,260,4,264
BIHAR,2007,PREP. AND ASSEMBLY FOR DACOITY,0,0,0,34,0,34,9,0,9,1,0,1,44,0,44
BIHAR,2007,ROBBERY,0,0,0,95,0,95,66,0,66,21,0,21,182,0,182
BIHAR,2007,BURGLARY,0,0,0,20,0,20,18,2,20,3,0,3,41,2,43
BIHAR,2007,THEFTS,0,0,0,90,1,91,26,1,27,7,0,7,123,2,125
BIHAR,2007,EXTORTION,0,0,0,14,0,14,12,0,12,8,0,8,34,0,34
BIHAR,2007,RIOTS,0,0,0,17,0,17,17,0,17,4,0,4,38,0,38
BIHAR,2007,ARSON,0,0,0,15,0,15,16,0,16,6,0,6,37,0,37
BIHAR,2007,CRIMINAL BREACH OF TRUST,0,0,0,14,0,14,10,0,10,1,0,1,25,0,25
BIHAR,2007,CHEATING,0,0,0,12,1,13,11,1,12,4,0,4,27,2,29
BIHAR,2007,COUNTER FEITING,0,0,0,10,1,11,3,1,4,0,0,0,13,2,15
BIHAR,2007,DOWRY DEATHS,0,0,0,53,10,63,60,8,68,12,2,14,125,20,145
BIHAR,2007,MOLESTATION,0,0,0,12,0,12,6,0,6,6,0,6,24,0,24
BIHAR,2007,EVE-TEASING,0,0,0,6,0,6,4,0,4,0,0,0,10,0,10
BIHAR,2007,CRUELTY BY HUSBAND OR RELATIVE OF HUSBAND,0,0,0,25,1,26,19,1,20,8,1,9,52,3,55
BIHAR,2007,OTHER IPC CRIMES,0,0,0,11,0,11,0,0,0,0,0,0,11,0,11
BIHAR,2007,TOTAL IPC,0,0,0,2107,56,2163,2586,46,2632,677,15,692,5370,117,5487
BIHAR,2008,MURDER,0,0,0,936,24,960,1674,11,1685,601,14,615,3211,49,3260
BIHAR,2008,ATTEMPT TO COMMIT MURDER,0,0,0,195,4,199,186,3,189,56,0,56,437,7,444
BIHAR,2008,C.H. NOT AMOUNTING TO MURDER,0,0,0,64,2,66,70,0,70,23,0,23,157,2,159
BIHAR,2008,RAPE,0,0,0,56,0,56,82,0,82,16,0,16,154,0,154
BIHAR,2008,KIDNAPPING AND ABDUCTION,0,0,0,95,1,96,82,8,90,43,0,43,220,9,229
BIHAR,2008,DACOITY,0,0,0,98,0,98,87,3,90,32,0,32,217,3,220
BIHAR,2008,PREP. AND ASSEMBLY FOR DACOITY,0,0,0,34,0,34,9,0,9,4,0,4,47,0,47
BIHAR,2008,ROBBERY,0,0,0,80,0,80,56,0,56,31,0,31,167,0,167
BIHAR,2008,BURGLARY,0,0,0,19,0,19,18,2,20,5,0,5,42,2,44
BIHAR,2008,THEFTS,0,0,0,85,1,86,25,1,26,5,0,5,115,2,117
BIHAR,2008,EXTORTION,0,0,0,11,0,11,8,0,8,7,0,7,26,0,26
BIHAR,2008,RIOTS,0,0,0,15,0,15,16,0,16,3,0,3,34,0,34
BIHAR,2008,ARSON,0,0,0,18,0,18,10,0,10,5,0,5,33,0,33
BIHAR,2008,CRIMINAL BREACH OF TRUST,0,0,0,14,0,14,7,0,7,0,0,0,21,0,21
BIHAR,2008,CHEATING,0,0,0,16,1,17,11,0,11,8,0,8,35,1,36
BIHAR,2008,COUNTER FEITING,0,0,0,15,1,16,5,2,7,0,0,0,20,3,23
BIHAR,2008,DOWRY DEATHS,0,0,0,51,11,62,46,8,54,24,8,32,121,27,148
BIHAR,2008,MOLESTATION,0,0,0,0,0,0,7,0,7,8,0,8,15,0,15
BIHAR,2008,EVE-TEASING,0,0,0,6,0,6,10,0,10,9,0,9,25,0,25
BIHAR,2008,CRUELTY BY HUSBAND OR RELATIVE OF HUSBAND,0,0,0,10,0,10,23,0,23,10,0,10,43,0,43
BIHAR,2008,OTHER IPC CRIMES,0,0,0,11,0,11,12,0,12,11,0,11,34,0,34
BIHAR,2008,TOTAL IPC,0,0,0,1829,45,1874,2444,38,2482,901,22,923,5174,105,5279
BIHAR,2009,MURDER,0,0,0,902,19,921,1562,10,1572,542,8,550,3006,37,3043
BIHAR,2009,ATTEMPT TO COMMIT MURDER,0,0,0,184,4,188,161,4,165,44,0,44,389,8,397
BIHAR,2009,C.H. NOT AMOUNTING TO MURDER,0,0,0,58,1,59,61,0,61,18,0,18,137,1,138
BIHAR,2009,RAPE,0,0,0,51,0,51,70,0,70,15,0,15,136,0,136
BIHAR,2009,KIDNAPPING AND ABDUCTION,0,0,0,89,1,90,78,7,85,37,0,37,204,8,212
BIHAR,2009,DACOITY,0,0,0,91,0,91,86,2,88,23,0,23,200,2,202
BIHAR,2009,PREP. AND ASSEMBLY FOR DACOITY,0,0,0,34,0,34,10,0,10,4,0,4,48,0,48
BIHAR,2009,ROBBERY,0,0,0,74,0,74,52,0,52,28,0,28,154,0,154
BIHAR,2009,BURGLARY,0,0,0,18,0,18,17,2,19,5,0,5,40,2,42
BIHAR,2009,THEFTS,0,0,0,81,1,82,25,1,26,5,0,5,111,2,113
BIHAR,2009,EXTORTION,0,0,0,11,0,11,8,0,8,6,0,6,25,0,25
BIHAR,2009,RIOTS,0,0,0,14,0,14,15,0,15,3,0,3,32,0,32
BIHAR,2009,ARSON,0,0,0,19,0,19,9,0,9,4,0,4,32,0,32
BIHAR,2009,CRIMINAL BREACH OF TRUST,0,0,0,14,0,14,8,0,8,0,0,0,22,0,22
BIHAR,2009,CHEATING,0,0,0,15,0,15,12,0,12,7,0,7,34,0,34
BIHAR,2009,COUNTER FEITING,0,0,0,13,1,14,5,1,6,0,0,0,18,2,20
BIHAR,2009,DOWRY DEATHS,0,0,0,49,8,57,47,8,55,21,6,27,117,22,139
BIHAR,2009,MOLESTATION,0,0,0,0,0,0,9,0,9,7,0,7,16,0,16
BIHAR,2009,EVE-TEASING,0,0,0,6,0,6,11,0,11,9,0,9,26,0,26
BIHAR,2009,CRUELTY BY HUSBAND OR RELATIVE OF HUSBAND,0,0,0,11,0,11,21,0,21,8,0,8,40,0,40
BIHAR,2009,OTHER IPC CRIMES,0,0,0,10,0,10,11,0,11,10,0,10,31,0,31
BIHAR,2009,TOTAL IPC,0,0,0,1744,35,1779,2278,35,2313,796,14,810,4818,84,4902
BIHAR,2010,MURDER,0,0,0,841,18,859,1512,11,1523,543,8,551,2896,37,2933
BIHAR,2010,ATTEMPT TO COMMIT MURDER,0,0,0,163,6,169,147,5,152,44,1,45,354,12,366
BIHAR,2010,C.H. NOT AMOUNTING TO MURDER,0,0,0,47,1,48,57,0,57,18,0,18,122,1,123
BIHAR,2010,RAPE,0,0,0,45,0,45,68,0,68,15,0,15,128,0,128
BIHAR,2010,KIDNAPPING AND ABDUCTION,0,0,0,72,1,73,73,8,81,39,0,39,184,9,193
BIHAR,2010,DACOITY,0,0,0,84,0,84,81,2,83,24,0,24,189,2,191
BIHAR,2010,PREP. AND ASSEMBLY FOR DACOITY,0,0,0,33,0,33,11,0,11,4,0,4,48,0,48
BIHAR,2010,ROBBERY,0,0,0,69,0,69,48,0,48,29,0,29,146,0,146
BIHAR,2010,BURGLARY,0,0,0,18,0,18,17,3,20,5,0,5,40,3,43
BIHAR,2010,THEFTS,0,0,0,77,2,79,23,2,25,6,0,6,106,4,110
BIHAR,2010,EXTORTION,0,0,0,10,0,10,9,0,9,7,0,7,26,0,26
BIHAR,2010,RIOTS,0,0,0,13,0,13,14,0,14,3,0,3,30,0,30
BIHAR,2010,ARSON,0,0,0,17,0,17,7,0,7,5,0,5,29,0,29
BIHAR,2010,CRIMINAL BREACH OF TRUST,0,0,0,14,0,14,9,0,9,0,0,0,23,0,23
BIHAR,2010,CHEATING,0,0,0,12,0,12,11,0,11,6,0,6,29,0,29
BIHAR,2010,COUNTER FEITING,0,0,0,12,1,13,5,1,6,0,0,0,17,2,19
BIHAR,2010,DOWRY DEATHS,0,0,0,45,8,53,45,10,55,20,7,27,110,25,135
BIHAR,2010,MOLESTATION,0,0,0,0,0,0,9,0,9,7,0,7,16,0,16
BIHAR,2010,EVE-TEASING,0,0,0,6,0,6,9,0,9,8,0,8,23,0,23
BIHAR,2010,CRUELTY BY HUSBAND OR RELATIVE OF HUSBAND,0,0,0,11,0,11,20,0,20,8,0,8,39,0,39
BIHAR,2010,OTHER IPC CRIMES,0,0,0,9,0,9,9,0,9,10,0,10,28,0,28
BIHAR,2010,TOTAL IPC,0,0,0,1598,37,1635,2184,42,2226,801,16,817,4583,95,4678
BIHAR,2011,MURDER,0,0,0,658,8,666,1124,26,1150,783,4,787,2565,38,2603
BIHAR,2011,ATTEMPT TO COMMIT MURDER,0,0,0,89,0,89,153,9,162,54,2,56,296,11,307
BIHAR,2011,C.H. NOT AMOUNTING TO MURDER,0,0,0,17,1,18,57,4,61,25,0,25,99,5,104
BIHAR,2011,RAPE,0,0,0,65,0,65,68,0,68,8,0,8,141,0,141
BIHAR,2011,KIDNAPPING AND ABDUCTION,0,0,0,80,1,81,90,2,92,18,0,18,188,3,191
BIHAR,2011,DACOITY,0,0,0,54,0,54,95,0,95,26,0,26,175,0,175
BIHAR,2011,PREP. AND ASSEMBLY FOR DACOITY,0,0,0,8,0,8,9,0,9,4,1,5,21,1,22
BIHAR,2011,ROBBERY,0,0,0,44,0,44,32,0,32,4,0,4,80,0,80
BIHAR,2011,BURGLARY,0,0,0,14,0,14,4,0,4,0,0,0,18,0,18
BIHAR,2011,THEFTS,0,0,0,73,0,73,62,1,63,17,0,17,152,1,153
BIHAR,2011,EXTORTION,0,0,0,4,0,4,6,0,6,2,0,2,12,0,12
BIHAR,2011,RIOTS,0,0,0,0,0,0,10,0,10,5,0,5,15,0,15
BIHAR,2011,ARSON,0,0,0,4,0,4,17,0,17,6,0,6,27,0,27
BIHAR,2011,CRIMINAL BREACH OF TRUST,0,0,0,1,0,1,3,0,3,1,0,1,5,0,5
BIHAR,2011,CHEATING,0,0,0,4,0,4,3,0,3,2,0,2,9,0,9
BIHAR,2011,COUNTER FEITING,0,0,0,0,0,0,0,0,0,0,0,0,0,0,0
BIHAR,2011,DOWRY DEATHS,0,0,0,64,4,68,86,9,95,42,8,50,192,21,213
BIHAR,2011,MOLESTATION,0,0,0,0,0,0,0,0,0,0,0,0,0,0,0
BIHAR,2011,EVE-TEASING,0,0,0,1,0,1,2,0,2,0,0,0,3,0,3
BIHAR,2011,CRUELTY BY HUSBAND OR RELATIVE OF HUSBAND,0,0,0,7,0,7,14,0,14,2,0,2,23,0,23
BIHAR,2011,OTHER IPC CRIMES,0,0,0,5,0,5,16,0,16,0,0,0,21,0,21
BIHAR,2011,TOTAL IPC,0,0,0,1192,14,1206,1851,51,1902,999,15,1014,4042,80,4122
BIHAR,2012,MURDER,0,0,0,428,7,435,1105,32,1137,568,7,575,2101,46,2147
BIHAR,2012,ATTEMPT TO COMMIT MURDER,0,0,0,67,0,67,117,7,124,35,1,36,219,8,227
BIHAR,2012,C.H. NOT AMOUNTING TO MURDER,0,0,0,17,1,18,48,7,55,13,1,14,78,9,87
BIHAR,2012,RAPE,0,0,0,54,0,54,81,0,81,12,0,12,147,0,147
BIHAR,2012,KIDNAPPING AND ABDUCTION,0,0,0,66,0,66,105,6,111,61,0,61,232,6,238
BIHAR,2012,DACOITY,0,0,0,47,0,47,75,0,75,24,0,24,146,0,146
BIHAR,2012,PREP. AND ASSEMBLY FOR DACOITY,0,0,0,20,0,20,13,0,13,10,0,10,43,0,43
BIHAR,2012,ROBBERY,0,0,0,34,0,34,39,0,39,9,0,9,82,0,82
BIHAR,2012,BURGLARY,0,0,0,1,0,1,2,0,2,0,0,0,3,0,3
BIHAR,2012,THEFTS,0,0,0,64,0,64,78,0,78,13,0,13,155,0,155
BIHAR,2012,EXTORTION,0,0,0,4,0,4,10,0,10,4,0,4,18,0,18
BIHAR,2012,RIOTS,0,0,0,0,0,0,0,0,0,0,0,0,0,0,0
BIHAR,2012,ARSON,0,0,0,1,0,1,9,0,9,3,0,3,13,0,13
BIHAR,2012,CRIMINAL BREACH OF TRUST,0,0,0,1,0,1,3,0,3,0,0,0,4,0,4
BIHAR,2012,CHEATING,0,0,0,1,0,1,5,0,5,0,0,0,6,0,6
BIHAR,2012,COUNTER FEITING,0,0,0,0,0,0,3,0,3,0,0,0,3,0,3
BIHAR,2012,DOWRY DEATHS,0,0,0,71,3,74,137,8,145,48,11,59,256,22,278
BIHAR,2012,MOLESTATION,0,0,0,0,0,0,0,0,0,0,0,0,0,0,0
BIHAR,2012,EVE-TEASING,0,0,0,0,0,0,0,0,0,0,0,0,0,0,0
BIHAR,2012,CRUELTY BY HUSBAND OR RELATIVE OF HUSBAND,0,0,0,3,0,3,4,0,4,2,0,2,9,0,9
BIHAR,2012,OTHER IPC CRIMES,0,0,0,9,0,9,5,0,5,2,0,2,16,0,16
BIHAR,2012,TOTAL IPC,0,0,0,888,11,899,1839,60,1899,804,20,824,3531,91,3622
CHHATTISGARH,2012,MURDER,0,0,0,1485,56,1541,1701,95,1796,668,25,693,3854,176,4030
CHHATTISGARH,2012,ATTEMPT TO COMMIT MURDER,0,0,0,118,1,119,59,0,59,18,1,19,195,2,197
CHHATTISGARH,2012,C.H. NOT AMOUNTING TO MURDER,0,0,0,60,7,67,53,4,57,19,0,19,132,11,143
CHHATTISGARH,2012,RAPE,0,0,0,211,0,211,146,3,149,28,0,28,385,3,388
CHHATTISGARH,2012,KIDNAPPING AND ABDUCTION,0,0,0,33,0,33,10,0,10,1,0,1,44,0,44
CHHATTISGARH,2012,DACOITY,0,0,0,47,0,47,38,0,38,6,0,6,91,0,91
CHHATTISGARH,2012,PREP. AND ASSEMBLY FOR DACOITY,0,0,0,0,0,0,0,0,0,0,0,0,0,0,0
CHHATTISGARH,2012,ROBBERY,0,0,0,38,0,38,35,0,35,0,0,0,73,0,73
CHHATTISGARH,2012,BURGLARY,0,0,0,15,0,15,12,0,12,3,0,3,30,0,30
CHHATTISGARH,2012,THEFTS,0,0,0,97,0,97,42,0,42,21,0,21,160,0,160
CHHATTISGARH,2012,EXTORTION,0,0,0,2,0,2,0,0,0,0,0,0,2,0,2
CHHATTISGARH,2012,RIOTS,0,0,0,2,0,2,1,0,1,0,0,0,3,0,3
CHHATTISGARH,2012,ARSON,0,0,0,5,0,5,5,0,5,2,0,2,12,0,12
CHHATTISGARH,2012,CRIMINAL BREACH OF TRUST,0,0,0,0,0,0,2,0,2,0,0,0,2,0,2
CHHATTISGARH,2012,CHEATING,0,0,0,2,0,2,13,0,13,6,0,6,21,0,21
CHHATTISGARH,2012,COUNTER FEITING,0,0,0,11,0,11,10,0,10,1,0,1,22,0,22
CHHATTISGARH,2012,DOWRY DEATHS,0,0,0,63,5,68,31,14,45,10,6,16,104,25,129
CHHATTISGARH,2012,MOLESTATION,0,0,0,12,0,12,6,0,6,0,0,0,18,0,18
CHHATTISGARH,2012,EVE-TEASING,0,0,0,0,0,0,0,0,0,0,0,0,0,0,0
CHHATTISGARH,2012,CRUELTY BY HUSBAND OR RELATIVE OF HUSBAND,0,0,0,1,0,1,6,1,7,0,0,0,7,1,8
CHHATTISGARH,2012,OTHER IPC CRIMES,0,0,0,69,0,69,48,1,49,20,0,20,137,1,138
CHHATTISGARH,2012,TOTAL IPC,0,0,0,2271,69,2340,2218,118,2336,803,32,835,5292,219,5511
CHHATTISGARH,2001,MURDER,6,0,6,1267,47,1314,1303,66,1369,447,25,472,3023,138,3161
CHHATTISGARH,2001,ATTEMPT TO COMMIT MURDER,0,0,0,82,1,83,81,1,82,24,0,24,187,2,189
CHHATTISGARH,2001,C.H. NOT AMOUNTING TO MURDER,3,0,3,31,2,33,45,2,47,4,3,7,83,7,90
CHHATTISGARH,2001,RAPE,7,0,7,156,1,157,148,2,150,33,0,33,344,3,347
CHHATTISGARH,2001,KIDNAPPING AND ABDUCTION,0,0,0,21,0,21,4,0,4,0,0,0,25,0,25
CHHATTISGARH,2001,DACOITY,0,0,0,34,0,34,36,0,36,4,0,4,74,0,74
CHHATTISGARH,2001,PREP. AND ASSEMBLY FOR DACOITY,0,0,0,0,0,0,0,0,0,0,0,0,0,0,0
CHHATTISGARH,2001,ROBBERY,0,0,0,13,0,13,7,0,7,0,0,0,20,0,20
CHHATTISGARH,2001,BURGLARY,0,0,0,17,0,17,23,1,24,0,0,0,40,1,41
CHHATTISGARH,2001,THEFTS,5,0,5,113,1,114,95,1,96,0,0,0,213,2,215
CHHATTISGARH,2001,EXTORTION,0,0,0,0,0,0,0,0,0,0,0,0,0,0,0
CHHATTISGARH,2001,RIOTS,0,0,0,0,0,0,0,0,0,0,0,0,0,0,0
CHHATTISGARH,2001,ARSON,0,0,0,8,0,8,2,0,2,0,0,0,10,0,10
CHHATTISGARH,2001,CRIMINAL BREACH OF TRUST,0,0,0,1,0,1,3,0,3,0,0,0,4,0,4
CHHATTISGARH,2001,CHEATING,0,0,0,1,0,1,3,0,3,0,0,0,4,0,4
CHHATTISGARH,2001,COUNTER FEITING,0,0,0,0,0,0,0,0,0,0,0,0,0,0,0
CHHATTISGARH,2001,DOWRY DEATHS,0,0,0,14,1,15,11,1,12,4,2,6,29,4,33
CHHATTISGARH,2001,MOLESTATION,0,0,0,6,0,6,1,0,1,0,0,0,7,0,7
CHHATTISGARH,2001,EVE-TEASING,0,0,0,0,0,0,0,0,0,0,0,0,0,0,0
CHHATTISGARH,2001,CRUELTY BY HUSBAND OR RELATIVE OF HUSBAND,0,0,0,4,0,4,5,1,6,3,1,4,12,2,14
CHHATTISGARH,2001,OTHER IPC CRIMES,2,0,2,62,2,64,53,4,57,0,0,0,117,6,123
CHHATTISGARH,2001,TOTAL IPC,23,0,23,1830,55,1885,1820,79,1899,519,31,550,4192,165,4357
CHHATTISGARH,2002,MURDER,11,0,11,1437,20,1457,1622,120,1742,234,14,248,3304,154,3458
CHHATTISGARH,2002,ATTEMPT TO COMMIT MURDER,9,0,9,81,1,82,39,1,40,11,0,11,140,2,142
CHHATTISGARH,2002,C.H. NOT AMOUNTING TO MURDER,0,0,0,47,2,49,69,3,72,9,6,15,125,11,136
CHHATTISGARH,2002,RAPE,28,0,28,137,0,137,159,1,160,15,0,15,339,1,340
CHHATTISGARH,2002,KIDNAPPING AND ABDUCTION,0,0,0,25,0,25,14,0,14,7,0,7,46,0,46
CHHATTISGARH,2002,DACOITY,2,0,2,42,0,42,27,0,27,3,0,3,74,0,74
CHHATTISGARH,2002,PREP. AND ASSEMBLY FOR DACOITY,0,0,0,0,0,0,0,0,0,0,0,0,0,0,0
CHHATTISGARH,2002,ROBBERY,0,0,0,23,0,23,19,0,19,6,0,6,48,0,48
CHHATTISGARH,2002,BURGLARY,5,0,5,14,0,14,9,0,9,1,0,1,29,0,29
CHHATTISGARH,2002,THEFTS,17,1,18,103,2,105,77,0,77,15,1,16,212,4,216
CHHATTISGARH,2002,EXTORTION,0,0,0,2,0,2,0,0,0,1,0,1,3,0,3
CHHATTISGARH,2002,RIOTS,0,0,0,4,0,4,1,0,1,2,0,2,7,0,7
CHHATTISGARH,2002,ARSON,0,0,0,5,0,5,4,0,4,1,0,1,10,0,10
CHHATTISGARH,2002,CRIMINAL BREACH OF TRUST,0,0,0,10,0,10,3,0,3,2,0,2,15,0,15
CHHATTISGARH,2002,CHEATING,0,0,0,5,0,5,5,0,5,2,0,2,12,0,12
CHHATTISGARH,2002,COUNTER FEITING,0,0,0,1,0,1,1,0,1,0,0,0,2,0,2
CHHATTISGARH,2002,DOWRY DEATHS,0,0,0,15,1,16,12,4,16,7,0,7,34,5,39
CHHATTISGARH,2002,MOLESTATION,0,0,0,3,0,3,2,0,2,0,0,0,5,0,5
CHHATTISGARH,2002,EVE-TEASING,0,0,0,1,0,1,1,0,1,0,0,0,2,0,2
CHHATTISGARH,2002,CRUELTY BY HUSBAND OR RELATIVE OF HUSBAND,0,0,0,5,0,5,15,0,15,8,0,8,28,0,28
CHHATTISGARH,2002,OTHER IPC CRIMES,4,0,4,45,0,45,44,2,46,17,0,17,110,2,112
CHHATTISGARH,2002,TOTAL IPC,76,1,77,2005,26,2031,2123,131,2254,341,21,362,4545,179,4724
CHHATTISGARH,2003,MURDER,7,0,7,1010,56,1066,1691,84,1775,250,22,272,2958,162,3120
CHHATTISGARH,2003,ATTEMPT TO COMMIT MURDER,1,0,1,77,2,79,46,0,46,6,0,6,130,2,132
CHHATTISGARH,2003,C.H. NOT AMOUNTING TO MURDER,1,0,1,24,0,24,54,2,56,7,1,8,86,3,89
CHHATTISGARH,2003,RAPE,3,0,3,185,1,186,211,0,211,28,0,28,427,1,428
CHHATTISGARH,2003,KIDNAPPING AND ABDUCTION,0,0,0,2,0,2,0,0,0,0,0,0,2,0,2
CHHATTISGARH,2003,DACOITY,1,0,1,41,1,42,44,0,44,10,0,10,96,1,97
CHHATTISGARH,2003,PREP. AND ASSEMBLY FOR DACOITY,0,0,0,17,0,17,15,0,15,0,0,0,32,0,32
CHHATTISGARH,2003,ROBBERY,0,0,0,14,1,15,41,0,41,5,0,5,60,1,61
CHHATTISGARH,2003,BURGLARY,0,0,0,19,0,19,20,0,20,6,0,6,45,0,45
CHHATTISGARH,2003,THEFTS,8,0,8,78,0,78,79,0,79,18,0,18,183,0,183
CHHATTISGARH,2003,EXTORTION,0,0,0,0,0,0,0,0,0,0,0,0,0,0,0
CHHATTISGARH,2003,RIOTS,0,0,0,0,0,0,0,0,0,0,0,0,0,0,0
CHHATTISGARH,2003,ARSON,0,0,0,3,0,3,8,0,8,0,0,0,11,0,11
CHHATTISGARH,2003,CRIMINAL BREACH OF TRUST,0,0,0,0,0,0,1,0,1,0,0,0,1,0,1
CHHATTISGARH,2003,CHEATING,0,0,0,2,0,2,6,0,6,0,0,0,8,0,8
CHHATTISGARH,2003,COUNTER FEITING,0,0,0,0,0,0,0,0,0,2,0,2,2,0,2
CHHATTISGARH,2003,DOWRY DEATHS,0,0,0,20,3,23,32,2,34,9,1,10,61,6,67
CHHATTISGARH,2003,MOLESTATION,0,0,0,6,0,6,2,0,2,0,0,0,8,0,8
CHHATTISGARH,2003,EVE-TEASING,0,0,0,0,0,0,0,0,0,0,0,0,0,0,0
CHHATTISGARH,2003,CRUELTY BY HUSBAND OR RELATIVE OF HUSBAND,0,0,0,4,0,4,4,1,5,0,0,0,8,1,9
CHHATTISGARH,2003,OTHER IPC CRIMES,0,0,0,51,1,52,56,2,58,11,1,12,118,4,122
CHHATTISGARH,2003,TOTAL IPC,21,0,21,1553,65,1618,2310,91,2401,352,25,377,4236,181,4417
CHHATTISGARH,2004,MURDER,0,0,0,917,34,951,1726,82,1808,359,27,386,3002,143,3145
CHHATTISGARH,2004,ATTEMPT TO COMMIT MURDER,0,0,0,44,3,47,71,2,73,19,0,19,134,5,139
CHHATTISGARH,2004,C.H. NOT AMOUNTING TO MURDER,0,0,0,28,1,29,34,3,37,12,1,13,74,5,79
CHHATTISGARH,2004,RAPE,0,0,0,122,1,123,186,0,186,29,0,29,337,1,338
CHHATTISGARH,2004,KIDNAPPING AND ABDUCTION,0,0,0,10,8,18,28,0,28,8,0,8,46,8,54
CHHATTISGARH,2004,DACOITY,0,0,0,23,0,23,7,0,7,8,0,8,38,0,38
CHHATTISGARH,2004,PREP. AND ASSEMBLY FOR DACOITY,0,0,0,6,0,6,6,0,6,8,0,8,20,0,20
CHHATTISGARH,2004,ROBBERY,0,0,0,12,0,12,10,0,10,7,0,7,29,0,29
CHHATTISGARH,2004,BURGLARY,0,0,0,17,0,17,16,0,16,2,0,2,35,0,35
CHHATTISGARH,2004,THEFTS,0,0,0,39,0,39,29,0,29,2,0,2,70,0,70
CHHATTISGARH,2004,EXTORTION,0,0,0,0,0,0,0,0,0,0,0,0,0,0,0
CHHATTISGARH,2004,RIOTS,0,0,0,10,0,10,10,0,10,0,0,0,20,0,20
CHHATTISGARH,2004,ARSON,0,0,0,3,0,3,2,0,2,0,0,0,5,0,5
CHHATTISGARH,2004,CRIMINAL BREACH OF TRUST,0,0,0,0,0,0,16,0,16,1,0,1,17,0,17
CHHATTISGARH,2004,CHEATING,0,0,0,0,0,0,10,0,10,9,0,9,19,0,19
CHHATTISGARH,2004,COUNTER FEITING,0,0,0,2,0,2,0,0,0,6,0,6,8,0,8
CHHATTISGARH,2004,DOWRY DEATHS,0,0,0,0,0,0,18,3,21,1,0,1,19,3,22
CHHATTISGARH,2004,MOLESTATION,0,0,0,2,0,2,8,0,8,0,0,0,10,0,10
CHHATTISGARH,2004,EVE-TEASING,0,0,0,0,0,0,0,0,0,0,0,0,0,0,0
CHHATTISGARH,2004,CRUELTY BY HUSBAND OR RELATIVE OF HUSBAND,0,0,0,2,6,8,12,2,14,0,1,1,14,9,23
CHHATTISGARH,2004,OTHER IPC CRIMES,0,0,0,50,4,54,64,5,69,16,0,16,130,9,139
CHHATTISGARH,2004,TOTAL IPC,0,0,0,1287,57,1344,2253,97,2350,487,29,516,4027,183,4210
CHHATTISGARH,2005,MURDER,0,0,0,656,20,676,1651,69,1720,320,28,348,2627,117,2744
CHHATTISGARH,2005,ATTEMPT TO COMMIT MURDER,0,0,0,74,1,75,134,8,142,17,2,19,225,11,236
CHHATTISGARH,2005,C.H. NOT AMOUNTING TO MURDER,0,0,0,34,2,36,69,6,75,15,0,15,118,8,126
CHHATTISGARH,2005,RAPE,0,0,0,118,0,118,159,0,159,13,0,13,290,0,290
CHHATTISGARH,2005,KIDNAPPING AND ABDUCTION,0,0,0,31,0,31,23,0,23,0,0,0,54,0,54
CHHATTISGARH,2005,DACOITY,0,0,0,38,1,39,22,0,22,0,0,0,60,1,61
CHHATTISGARH,2005,PREP. AND ASSEMBLY FOR DACOITY,0,0,0,11,0,11,3,0,3,5,0,5,19,0,19
CHHATTISGARH,2005,ROBBERY,0,0,0,29,0,29,13,0,13,4,0,4,46,0,46
CHHATTISGARH,2005,BURGLARY,0,0,0,18,0,18,18,0,18,0,0,0,36,0,36
CHHATTISGARH,2005,THEFTS,0,0,0,43,2,45,16,0,16,1,0,1,60,2,62
CHHATTISGARH,2005,EXTORTION,0,0,0,3,0,3,11,0,11,0,0,0,14,0,14
CHHATTISGARH,2005,RIOTS,0,0,0,7,0,7,3,3,6,7,0,7,17,3,20
CHHATTISGARH,2005,ARSON,0,0,0,2,0,2,0,0,0,1,0,1,3,0,3
CHHATTISGARH,2005,CRIMINAL BREACH OF TRUST,0,0,0,3,0,3,5,0,5,3,0,3,11,0,11
CHHATTISGARH,2005,CHEATING,0,0,0,10,0,10,7,0,7,0,0,0,17,0,17
CHHATTISGARH,2005,COUNTER FEITING,0,0,0,4,0,4,0,0,0,0,0,0,4,0,4
CHHATTISGARH,2005,DOWRY DEATHS,0,0,0,16,1,17,23,9,32,2,0,2,41,10,51
CHHATTISGARH,2005,MOLESTATION,0,0,0,6,0,6,7,0,7,2,0,2,15,0,15
CHHATTISGARH,2005,EVE-TEASING,0,0,0,0,0,0,0,0,0,0,0,0,0,0,0
CHHATTISGARH,2005,CRUELTY BY HUSBAND OR RELATIVE OF HUSBAND,0,0,0,13,6,19,13,1,14,2,2,4,28,9,37
CHHATTISGARH,2005,OTHER IPC CRIMES,0,0,0,58,1,59,38,1,39,5,1,6,101,3,104
CHHATTISGARH,2005,TOTAL IPC,0,0,0,1174,34,1208,2215,97,2312,397,33,430,3786,164,3950
CHHATTISGARH,2006,MURDER,0,0,0,817,33,850,1837,81,1918,202,27,229,2856,141,2997
CHHATTISGARH,2006,ATTEMPT TO COMMIT MURDER,0,0,0,58,3,61,102,3,105,33,1,34,193,7,200
CHHATTISGARH,2006,C.H. NOT AMOUNTING TO MURDER,0,0,0,33,3,36,79,5,84,24,2,26,136,10,146
CHHATTISGARH,2006,RAPE,0,0,0,164,1,165,100,2,102,43,0,43,307,3,310
CHHATTISGARH,2006,KIDNAPPING AND ABDUCTION,0,0,0,11,0,11,20,0,20,11,0,11,42,0,42
CHHATTISGARH,2006,DACOITY,0,0,0,23,0,23,32,0,32,5,0,5,60,0,60
CHHATTISGARH,2006,PREP. AND ASSEMBLY FOR DACOITY,0,0,0,2,0,2,0,0,0,0,0,0,2,0,2
CHHATTISGARH,2006,ROBBERY,0,0,0,12,1,13,8,1,9,8,0,8,28,2,30
CHHATTISGARH,2006,BURGLARY,0,0,0,17,0,17,14,0,14,2,0,2,33,0,33
CHHATTISGARH,2006,THEFTS,0,0,0,42,0,42,38,1,39,7,0,7,87,1,88
CHHATTISGARH,2006,EXTORTION,0,0,0,1,0,1,0,0,0,0,0,0,1,0,1
CHHATTISGARH,2006,RIOTS,0,0,0,3,0,3,1,0,1,2,0,2,6,0,6
CHHATTISGARH,2006,ARSON,0,0,0,0,0,0,1,0,1,0,0,0,1,0,1
CHHATTISGARH,2006,CRIMINAL BREACH OF TRUST,0,0,0,1,0,1,0,0,0,0,0,0,1,0,1
CHHATTISGARH,2006,CHEATING,0,0,0,7,0,7,2,0,2,2,0,2,11,0,11
CHHATTISGARH,2006,COUNTER FEITING,0,0,0,0,0,0,1,0,1,0,0,0,1,0,1
CHHATTISGARH,2006,DOWRY DEATHS,0,0,0,22,0,22,32,5,37,4,1,5,58,6,64
CHHATTISGARH,2006,MOLESTATION,0,0,0,6,0,6,9,0,9,1,0,1,16,0,16
CHHATTISGARH,2006,EVE-TEASING,0,0,0,0,0,0,0,0,0,0,0,0,0,0,0
CHHATTISGARH,2006,CRUELTY BY HUSBAND OR RELATIVE OF HUSBAND,0,0,0,1,0,1,3,0,3,0,0,0,4,0,4
CHHATTISGARH,2006,OTHER IPC CRIMES,0,0,0,19,2,21,36,1,37,12,0,12,67,3,70
CHHATTISGARH,2006,TOTAL IPC,0,0,0,1239,43,1282,2315,99,2414,356,31,387,3910,173,4083
CHHATTISGARH,2007,MURDER,0,0,0,949,41,990,1744,77,1821,206,17,223,2899,135,3034
CHHATTISGARH,2007,ATTEMPT TO COMMIT MURDER,0,0,0,85,4,89,98,5,103,8,2,10,191,11,202
CHHATTISGARH,2007,C.H. NOT AMOUNTING TO MURDER,0,0,0,49,3,52,94,5,99,11,1,12,154,9,163
CHHATTISGARH,2007,RAPE,0,0,0,155,1,156,113,0,113,8,0,8,276,1,277
CHHATTISGARH,2007,KIDNAPPING AND ABDUCTION,0,0,0,19,0,19,41,0,41,1,0,1,61,0,61
CHHATTISGARH,2007,DACOITY,0,0,0,26,0,26,44,0,44,0,0,0,70,0,70
CHHATTISGARH,2007,PREP. AND ASSEMBLY FOR DACOITY,0,0,0,0,0,0,0,0,0,0,0,0,0,0,0
CHHATTISGARH,2007,ROBBERY,0,0,0,23,1,24,18,0,18,3,0,3,44,1,45
CHHATTISGARH,2007,BURGLARY,0,0,0,9,0,9,9,0,9,0,0,0,18,0,18
CHHATTISGARH,2007,THEFTS,0,0,0,52,0,52,81,1,82,30,0,30,163,1,164
CHHATTISGARH,2007,EXTORTION,0,0,0,0,0,0,0,0,0,0,0,0,0,0,0
CHHATTISGARH,2007,RIOTS,0,0,0,8,0,8,4,0,4,0,0,0,12,0,12
CHHATTISGARH,2007,ARSON,0,0,0,2,0,2,2,0,2,0,0,0,4,0,4
CHHATTISGARH,2007,CRIMINAL BREACH OF TRUST,0,0,0,0,0,0,1,0,1,0,0,0,1,0,1
CHHATTISGARH,2007,CHEATING,0,0,0,4,0,4,4,0,4,5,0,5,13,0,13
CHHATTISGARH,2007,COUNTER FEITING,0,0,0,11,0,11,0,0,0,0,0,0,11,0,11
CHHATTISGARH,2007,DOWRY DEATHS,0,0,0,27,5,32,24,0,24,20,9,29,71,14,85
CHHATTISGARH,2007,MOLESTATION,0,0,0,5,0,5,1,2,3,6,0,6,12,2,14
CHHATTISGARH,2007,EVE-TEASING,0,0,0,0,0,0,0,0,0,0,0,0,0,0,0
CHHATTISGARH,2007,CRUELTY BY HUSBAND OR RELATIVE OF HUSBAND,0,0,0,13,1,14,6,3,9,2,4,6,21,8,29
CHHATTISGARH,2007,OTHER IPC CRIMES,0,0,0,14,1,15,55,1,56,7,0,7,76,2,78
CHHATTISGARH,2007,TOTAL IPC,0,0,0,1451,57,1508,2339,94,2433,307,33,340,4097,184,4281
CHHATTISGARH,2008,MURDER,0,0,0,1018,36,1054,1528,75,1603,345,29,374,2891,140,3031
CHHATTISGARH,2008,ATTEMPT TO COMMIT MURDER,0,0,0,90,1,91,107,0,107,15,1,16,212,2,214
CHHATTISGARH,2008,C.H. NOT AMOUNTING TO MURDER,0,0,0,59,2,61,75,5,80,19,3,22,153,10,163
CHHATTISGARH,2008,RAPE,0,0,0,214,0,214,131,0,131,12,0,12,357,0,357
CHHATTISGARH,2008,KIDNAPPING AND ABDUCTION,0,0,0,17,1,18,13,1,14,0,0,0,30,2,32
CHHATTISGARH,2008,DACOITY,0,0,0,37,0,37,42,0,42,1,0,1,80,0,80
CHHATTISGARH,2008,PREP. AND ASSEMBLY FOR DACOITY,0,0,0,2,0,2,2,0,2,0,0,0,4,0,4
CHHATTISGARH,2008,ROBBERY,0,0,0,40,1,41,29,0,29,3,0,3,72,1,73
CHHATTISGARH,2008,BURGLARY,0,0,0,13,1,14,9,0,9,1,0,1,23,1,24
CHHATTISGARH,2008,THEFTS,0,0,0,74,1,75,33,0,33,0,0,0,107,1,108
CHHATTISGARH,2008,EXTORTION,0,0,0,12,0,12,15,0,15,2,0,2,29,0,29
CHHATTISGARH,2008,RIOTS,0,0,0,0,0,0,2,0,2,0,0,0,2,0,2
CHHATTISGARH,2008,ARSON,0,0,0,9,0,9,5,0,5,1,0,1,15,0,15
CHHATTISGARH,2008,CRIMINAL BREACH OF TRUST,0,0,0,0,0,0,3,0,3,1,0,1,4,0,4
CHHATTISGARH,2008,CHEATING,0,0,0,6,0,6,3,0,3,5,0,5,14,0,14
CHHATTISGARH,2008,COUNTER FEITING,0,0,0,24,0,24,27,0,27,0,0,0,51,0,51
CHHATTISGARH,2008,DOWRY DEATHS,0,0,0,34,4,38,43,7,50,8,3,11,85,14,99
CHHATTISGARH,2008,MOLESTATION,0,0,0,4,0,4,5,0,5,0,0,0,9,0,9
CHHATTISGARH,2008,EVE-TEASING,0,0,0,11,0,11,12,0,12,0,0,0,23,0,23
CHHATTISGARH,2008,CRUELTY BY HUSBAND OR RELATIVE OF HUSBAND,0,0,0,21,0,21,23,1,24,4,1,5,48,2,50
CHHATTISGARH,2008,OTHER IPC CRIMES,0,0,0,37,0,37,20,0,20,3,0,3,60,0,60
CHHATTISGARH,2008,TOTAL IPC,0,0,0,1722,47,1769,2127,89,2216,420,37,457,4269,173,4442
CHHATTISGARH,2009,MURDER,0,0,0,983,37,1020,1699,81,1780,456,29,485,3138,147,3285
CHHATTISGARH,2009,ATTEMPT TO COMMIT MURDER,0,0,0,106,1,107,98,4,102,22,2,24,226,7,233
CHHATTISGARH,2009,C.H. NOT AMOUNTING TO MURDER,0,0,0,67,4,71,57,7,64,13,2,15,137,13,150
CHHATTISGARH,2009,RAPE,0,0,0,148,1,149,147,0,147,29,0,29,324,1,325
CHHATTISGARH,2009,KIDNAPPING AND ABDUCTION,0,0,0,13,2,15,9,0,9,1,0,1,23,2,25
CHHATTISGARH,2009,DACOITY,0,0,0,35,0,35,41,0,41,4,0,4,80,0,80
CHHATTISGARH,2009,PREP. AND ASSEMBLY FOR DACOITY,0,0,0,7,0,7,2,0,2,0,0,0,9,0,9
CHHATTISGARH,2009,ROBBERY,0,0,0,13,0,13,17,0,17,0,0,0,30,0,30
CHHATTISGARH,2009,BURGLARY,0,0,0,22,0,22,11,0,11,0,0,0,33,0,33
CHHATTISGARH,2009,THEFTS,0,0,0,56,1,57,32,0,32,6,0,6,94,1,95
CHHATTISGARH,2009,EXTORTION,0,0,0,2,0,2,2,0,2,0,0,0,4,0,4
CHHATTISGARH,2009,RIOTS,0,0,0,0,0,0,0,0,0,0,0,0,0,0,0
CHHATTISGARH,2009,ARSON,0,0,0,1,0,1,3,0,3,0,0,0,4,0,4
CHHATTISGARH,2009,CRIMINAL BREACH OF TRUST,0,0,0,0,0,0,0,0,0,0,0,0,0,0,0
CHHATTISGARH,2009,CHEATING,0,0,0,1,0,1,3,1,4,0,0,0,4,1,5
CHHATTISGARH,2009,COUNTER FEITING,0,0,0,4,0,4,2,0,2,0,0,0,6,0,6
CHHATTISGARH,2009,DOWRY DEATHS,0,0,0,36,8,44,49,8,57,6,2,8,91,18,109
CHHATTISGARH,2009,MOLESTATION,0,0,0,9,0,9,26,0,26,0,0,0,35,0,35
CHHATTISGARH,2009,EVE-TEASING,0,0,0,0,0,0,2,0,2,0,0,0,2,0,2
CHHATTISGARH,2009,CRUELTY BY HUSBAND OR RELATIVE OF HUSBAND,0,0,0,22,1,23,17,4,21,0,3,3,39,8,47
CHHATTISGARH,2009,OTHER IPC CRIMES,0,0,0,13,0,13,43,0,43,6,1,7,62,1,63
CHHATTISGARH,2009,TOTAL IPC,0,0,0,1538,55,1593,2260,105,2365,543,39,582,4341,199,4540
CHHATTISGARH,2010,MURDER,0,0,0,1086,52,1138,1548,68,1616,541,24,565,3175,144,3319
CHHATTISGARH,2010,ATTEMPT TO COMMIT MURDER,0,0,0,85,3,88,96,1,97,55,1,56,236,5,241
CHHATTISGARH,2010,C.H. NOT AMOUNTING TO MURDER,0,0,0,54,4,58,34,0,34,25,1,26,113,5,118
CHHATTISGARH,2010,RAPE,0,0,0,230,1,231,193,0,193,51,0,51,474,1,475
CHHATTISGARH,2010,KIDNAPPING AND ABDUCTION,0,0,0,19,0,19,19,0,19,6,0,6,44,0,44
CHHATTISGARH,2010,DACOITY,0,0,0,55,0,55,72,0,72,4,0,4,131,0,131
CHHATTISGARH,2010,PREP. AND ASSEMBLY FOR DACOITY,0,0,0,7,0,7,7,0,7,0,0,0,14,0,14
CHHATTISGARH,2010,ROBBERY,0,0,0,20,0,20,22,0,22,1,0,1,43,0,43
CHHATTISGARH,2010,BURGLARY,0,0,0,20,0,20,16,0,16,12,0,12,48,0,48
CHHATTISGARH,2010,THEFTS,0,0,0,62,0,62,29,0,29,0,0,0,91,0,91
CHHATTISGARH,2010,EXTORTION,0,0,0,0,0,0,0,0,0,0,0,0,0,0,0
CHHATTISGARH,2010,RIOTS,0,0,0,0,0,0,0,0,0,0,0,0,0,0,0
CHHATTISGARH,2010,ARSON,0,0,0,2,0,2,6,0,6,3,0,3,11,0,11
CHHATTISGARH,2010,CRIMINAL BREACH OF TRUST,0,0,0,4,0,4,0,0,0,0,0,0,4,0,4
CHHATTISGARH,2010,CHEATING,0,0,0,5,0,5,14,0,14,2,0,2,21,0,21
CHHATTISGARH,2010,COUNTER FEITING,0,0,0,3,0,3,10,0,10,1,0,1,14,0,14
CHHATTISGARH,2010,DOWRY DEATHS,0,0,0,65,15,80,70,7,77,11,7,18,146,29,175
CHHATTISGARH,2010,MOLESTATION,0,0,0,5,0,5,7,0,7,0,0,0,12,0,12
CHHATTISGARH,2010,EVE-TEASING,0,0,0,0,0,0,0,0,0,0,0,0,0,0,0
CHHATTISGARH,2010,CRUELTY BY HUSBAND OR RELATIVE OF HUSBAND,0,0,0,4,1,5,14,0,14,6,0,6,24,1,25
CHHATTISGARH,2010,OTHER IPC CRIMES,0,0,0,52,3,55,49,1,50,15,0,15,116,4,120
CHHATTISGARH,2010,TOTAL IPC,0,0,0,1778,79,1857,2206,77,2283,733,33,766,4717,189,4906
CHHATTISGARH,2011,MURDER,0,0,0,1215,64,1279,1890,95,1985,659,20,679,3764,179,3943
CHHATTISGARH,2011,ATTEMPT TO COMMIT MURDER,0,0,0,77,0,77,74,0,74,38,2,40,189,2,191
CHHATTISGARH,2011,C.H. NOT AMOUNTING TO MURDER,0,0,0,65,4,69,54,3,57,31,1,32,150,8,158
CHHATTISGARH,2011,RAPE,0,0,0,231,0,231,158,0,158,44,0,44,433,0,433
CHHATTISGARH,2011,KIDNAPPING AND ABDUCTION,0,0,0,14,0,14,15,1,16,5,0,5,34,1,35
CHHATTISGARH,2011,DACOITY,0,0,0,37,0,37,22,0,22,2,0,2,61,0,61
CHHATTISGARH,2011,PREP. AND ASSEMBLY FOR DACOITY,0,0,0,1,0,1,4,0,4,2,0,2,7,0,7
CHHATTISGARH,2011,ROBBERY,0,0,0,21,0,21,24,0,24,2,0,2,47,0,47
CHHATTISGARH,2011,BURGLARY,0,0,0,12,0,12,11,0,11,10,0,10,33,0,33
CHHATTISGARH,2011,THEFTS,0,0,0,58,0,58,41,1,42,15,0,15,114,1,115
CHHATTISGARH,2011,EXTORTION,0,0,0,1,0,1,0,0,0,0,0,0,1,0,1
CHHATTISGARH,2011,RIOTS,0,0,0,0,0,0,0,0,0,0,0,0,0,0,0
CHHATTISGARH,2011,ARSON,0,0,0,9,0,9,5,0,5,2,0,2,16,0,16
CHHATTISGARH,2011,CRIMINAL BREACH OF TRUST,0,0,0,1,0,1,1,0,1,0,0,0,2,0,2
CHHATTISGARH,2011,CHEATING,0,0,0,0,0,0,4,0,4,1,0,1,5,0,5
CHHATTISGARH,2011,COUNTER FEITING,0,0,0,6,0,6,13,0,13,5,0,5,24,0,24
CHHATTISGARH,2011,DOWRY DEATHS,0,0,0,39,5,44,42,10,52,18,5,23,99,20,119
CHHATTISGARH,2011,MOLESTATION,0,0,0,9,0,9,8,0,8,4,0,4,21,0,21
CHHATTISGARH,2011,EVE-TEASING,0,0,0,0,0,0,0,0,0,0,0,0,0,0,0
CHHATTISGARH,2011,CRUELTY BY HUSBAND OR RELATIVE OF HUSBAND,0,0,0,3,1,4,6,1,7,7,0,7,16,2,18
CHHATTISGARH,2011,OTHER IPC CRIMES,0,0,0,42,1,43,51,3,54,13,0,13,106,4,110
CHHATTISGARH,2011,TOTAL IPC,0,0,0,1841,75,1916,2423,114,2537,858,28,886,5122,217,5339
GOA,2001,MURDER,0,0,0,17,0,17,23,2,25,1,0,1,41,2,43
GOA,2001,ATTEMPT TO COMMIT MURDER,0,0,0,0,0,0,0,0,0,0,0,0,0,0,0
GOA,2001,C.H. NOT AMOUNTING TO MURDER,0,0,0,16,0,16,3,1,4,0,0,0,19,1,20
GOA,2001,RAPE,0,0,0,12,0,12,2,0,2,0,0,0,14,0,14
GOA,2001,KIDNAPPING AND ABDUCTION,0,0,0,1,0,1,0,0,0,0,0,0,1,0,1
GOA,2001,DACOITY,0,0,0,2,0,2,1,0,1,0,0,0,3,0,3
GOA,2001,PREP. AND ASSEMBLY FOR DACOITY,0,0,0,0,0,0,0,0,0,0,0,0,0,0,0
GOA,2001,ROBBERY,0,0,0,0,0,0,0,0,0,0,0,0,0,0,0
GOA,2001,BURGLARY,0,0,0,0,0,0,0,0,0,0,0,0,0,0,0
GOA,2001,THEFTS,0,0,0,0,0,0,4,0,4,0,0,0,4,0,4
GOA,2001,EXTORTION,0,0,0,0,0,0,3,1,4,0,0,0,3,1,4
GOA,2001,RIOTS,0,0,0,0,0,0,0,0,0,0,0,0,0,0,0
GOA,2001,ARSON,0,0,0,0,0,0,0,0,0,0,0,0,0,0,0
GOA,2001,CRIMINAL BREACH OF TRUST,0,0,0,0,0,0,0,0,0,0,0,0,0,0,0
GOA,2001,CHEATING,0,0,0,0,0,0,2,0,2,1,0,1,3,0,3
GOA,2001,COUNTER FEITING,0,0,0,3,0,3,0,0,0,0,0,0,3,0,3
GOA,2001,DOWRY DEATHS,0,0,0,0,0,0,0,0,0,0,0,0,0,0,0
GOA,2001,MOLESTATION,0,0,0,0,0,0,2,0,2,0,0,0,2,0,2
GOA,2001,EVE-TEASING,0,0,0,0,0,0,1,0,1,4,0,4,5,0,5
GOA,2001,CRUELTY BY HUSBAND OR RELATIVE OF HUSBAND,0,0,0,0,0,0,0,0,0,3,0,3,3,0,3
GOA,2001,OTHER IPC CRIMES,0,0,0,0,0,0,3,0,3,0,0,0,3,0,3
GOA,2001,TOTAL IPC,0,0,0,51,0,51,44,4,48,9,0,9,104,4,108
GOA,2002,MURDER,0,0,0,26,0,26,17,4,21,10,0,10,53,4,57
GOA,2002,ATTEMPT TO COMMIT MURDER,0,0,0,0,0,0,2,0,2,0,0,0,2,0,2
GOA,2002,C.H. NOT AMOUNTING TO MURDER,0,0,0,4,0,4,20,0,20,0,0,0,24,0,24
GOA,2002,RAPE,0,0,0,0,0,0,11,0,11,0,0,0,11,0,11
GOA,2002,KIDNAPPING AND ABDUCTION,0,0,0,0,0,0,0,0,0,1,0,1,1,0,1
GOA,2002,DACOITY,0,0,0,0,0,0,9,0,9,0,0,0,9,0,9
GOA,2002,PREP. AND ASSEMBLY FOR DACOITY,0,0,0,0,0,0,0,0,0,0,0,0,0,0,0
GOA,2002,ROBBERY,0,0,0,0,0,0,0,0,0,0,0,0,0,0,0
GOA,2002,BURGLARY,0,0,0,0,0,0,0,0,0,0,0,0,0,0,0
GOA,2002,THEFTS,0,0,0,2,0,2,1,0,1,0,0,0,3,0,3
GOA,2002,EXTORTION,0,0,0,0,0,0,0,0,0,0,0,0,0,0,0
GOA,2002,RIOTS,0,0,0,0,0,0,0,0,0,0,0,0,0,0,0
GOA,2002,ARSON,0,0,0,0,0,0,0,0,0,0,0,0,0,0,0
GOA,2002,CRIMINAL BREACH OF TRUST,0,0,0,0,0,0,1,0,1,0,0,0,1,0,1
GOA,2002,CHEATING,0,0,0,1,0,1,1,0,1,0,0,0,2,0,2
GOA,2002,COUNTER FEITING,0,0,0,0,0,0,0,0,0,0,0,0,0,0,0
GOA,2002,DOWRY DEATHS,0,0,0,0,0,0,0,0,0,0,0,0,0,0,0
GOA,2002,MOLESTATION,0,0,0,0,0,0,0,0,0,0,0,0,0,0,0
GOA,2002,EVE-TEASING,0,0,0,0,0,0,0,0,0,0,0,0,0,0,0
GOA,2002,CRUELTY BY HUSBAND OR RELATIVE OF HUSBAND,0,0,0,0,0,0,0,0,0,0,0,0,0,0,0
GOA,2002,OTHER IPC CRIMES,0,0,0,0,0,0,0,0,0,0,0,0,0,0,0
GOA,2002,TOTAL IPC,0,0,0,33,0,33,62,4,66,11,0,11,106,4,110
GOA,2003,MURDER,0,0,0,21,0,21,16,2,18,14,0,14,51,2,53
GOA,2003,ATTEMPT TO COMMIT MURDER,0,0,0,0,0,0,1,0,1,0,0,0,1,0,1
GOA,2003,C.H. NOT AMOUNTING TO MURDER,0,0,0,1,0,1,0,0,0,0,0,0,1,0,1
GOA,2003,RAPE,0,0,0,6,0,6,4,0,4,1,0,1,11,0,11
GOA,2003,KIDNAPPING AND ABDUCTION,0,0,0,5,0,5,11,0,11,0,0,0,16,0,16
GOA,2003,DACOITY,0,0,0,5,0,5,7,0,7,0,0,0,12,0,12
GOA,2003,PREP. AND ASSEMBLY FOR DACOITY,0,0,0,0,0,0,0,0,0,0,0,0,0,0,0
GOA,2003,ROBBERY,0,0,0,0,0,0,1,0,1,0,0,0,1,0,1
GOA,2003,BURGLARY,0,0,0,0,0,0,0,0,0,0,0,0,0,0,0
GOA,2003,THEFTS,0,0,0,0,0,0,4,0,4,0,0,0,4,0,4
GOA,2003,EXTORTION,0,0,0,0,0,0,0,0,0,0,0,0,0,0,0
GOA,2003,RIOTS,0,0,0,0,0,0,0,0,0,0,0,0,0,0,0
GOA,2003,ARSON,0,0,0,0,0,0,1,0,1,0,0,0,1,0,1
GOA,2003,CRIMINAL BREACH OF TRUST,0,0,0,0,0,0,1,0,1,0,0,0,1,0,1
GOA,2003,CHEATING,0,0,0,0,0,0,0,0,0,0,0,0,0,0,0
GOA,2003,COUNTER FEITING,0,0,0,0,0,0,0,0,0,0,0,0,0,0,0
GOA,2003,DOWRY DEATHS,0,0,0,0,0,0,0,0,0,0,0,0,0,0,0
GOA,2003,MOLESTATION,0,0,0,0,0,0,0,0,0,0,0,0,0,0,0
GOA,2003,EVE-TEASING,0,0,0,0,0,0,0,0,0,0,0,0,0,0,0
GOA,2003,CRUELTY BY HUSBAND OR RELATIVE OF HUSBAND,0,0,0,0,0,0,0,0,0,0,0,0,0,0,0
GOA,2003,OTHER IPC CRIMES,0,0,0,4,1,5,5,0,5,0,0,0,9,1,10
GOA,2003,TOTAL IPC,0,0,0,42,1,43,51,2,53,15,0,15,108,3,111
GOA,2004,MURDER,0,0,0,16,0,16,7,2,9,6,0,6,29,2,31
GOA,2004,ATTEMPT TO COMMIT MURDER,0,0,0,4,0,4,1,0,1,1,0,1,6,0,6
GOA,2004,C.H. NOT AMOUNTING TO MURDER,0,0,0,17,0,17,0,0,0,0,0,0,17,0,17
GOA,2004,RAPE,0,0,0,8,0,8,8,0,8,0,0,0,16,0,16
GOA,2004,KIDNAPPING AND ABDUCTION,0,0,0,0,0,0,0,0,0,0,0,0,0,0,0
GOA,2004,DACOITY,0,0,0,7,0,7,5,0,5,0,0,0,12,0,12
GOA,2004,PREP. AND ASSEMBLY FOR DACOITY,0,0,0,0,0,0,0,0,0,0,0,0,0,0,0
GOA,2004,ROBBERY,0,0,0,0,0,0,1,0,1,0,0,0,1,0,1
GOA,2004,BURGLARY,0,0,0,0,0,0,4,0,4,1,0,1,5,0,5
GOA,2004,THEFTS,0,0,0,0,0,0,1,0,1,0,0,0,1,0,1
GOA,2004,EXTORTION,0,0,0,0,0,0,0,0,0,0,0,0,0,0,0
GOA,2004,RIOTS,0,0,0,0,0,0,0,0,0,0,0,0,0,0,0
GOA,2004,ARSON,0,0,0,0,0,0,0,0,0,0,0,0,0,0,0
GOA,2004,CRIMINAL BREACH OF TRUST,0,0,0,0,0,0,0,0,0,0,0,0,0,0,0
GOA,2004,CHEATING,0,0,0,0,0,0,0,0,0,0,0,0,0,0,0
GOA,2004,COUNTER FEITING,0,0,0,0,0,0,0,0,0,0,0,0,0,0,0
GOA,2004,DOWRY DEATHS,0,0,0,0,0,0,0,0,0,0,0,0,0,0,0
GOA,2004,MOLESTATION,0,0,0,0,0,0,0,0,0,0,0,0,0,0,0
GOA,2004,EVE-TEASING,0,0,0,0,0,0,0,0,0,0,0,0,0,0,0
GOA,2004,CRUELTY BY HUSBAND OR RELATIVE OF HUSBAND,0,0,0,0,0,0,0,0,0,0,0,0,0,0,0
GOA,2004,OTHER IPC CRIMES,0,0,0,15,0,15,9,0,9,0,0,0,24,0,24
GOA,2004,TOTAL IPC,0,0,0,67,0,67,36,2,38,8,0,8,111,2,113
GOA,2005,MURDER,0,0,0,4,0,4,38,2,40,7,0,7,49,2,51
GOA,2005,ATTEMPT TO COMMIT MURDER,0,0,0,2,0,2,1,0,1,0,0,0,3,0,3
GOA,2005,C.H. NOT AMOUNTING TO MURDER,0,0,0,3,0,3,8,0,8,0,0,0,11,0,11
GOA,2005,RAPE,0,0,0,4,0,4,14,0,14,0,0,0,18,0,18
GOA,2005,KIDNAPPING AND ABDUCTION,0,0,0,0,0,0,0,1,1,0,0,0,0,1,1
GOA,2005,DACOITY,0,0,0,0,0,0,5,0,5,0,0,0,5,0,5
GOA,2005,PREP. AND ASSEMBLY FOR DACOITY,0,0,0,0,0,0,0,0,0,0,0,0,0,0,0
GOA,2005,ROBBERY,0,0,0,0,0,0,1,0,1,0,0,0,1,0,1
GOA,2005,BURGLARY,0,0,0,0,0,0,0,0,0,0,0,0,0,0,0
GOA,2005,THEFTS,0,0,0,0,0,0,3,0,3,0,0,0,3,0,3
GOA,2005,EXTORTION,0,0,0,0,0,0,0,0,0,0,0,0,0,0,0
GOA,2005,RIOTS,0,0,0,0,0,0,0,0,0,0,0,0,0,0,0
GOA,2005,ARSON,0,0,0,0,0,0,0,0,0,0,0,0,0,0,0
GOA,2005,CRIMINAL BREACH OF TRUST,0,0,0,0,0,0,0,0,0,0,0,0,0,0,0
GOA,2005,CHEATING,0,0,0,0,0,0,0,0,0,0,0,0,0,0,0
GOA,2005,COUNTER FEITING,0,0,0,0,0,0,1,0,1,0,0,0,1,0,1
GOA,2005,DOWRY DEATHS,0,0,0,0,0,0,0,0,0,0,0,0,0,0,0
GOA,2005,MOLESTATION,0,0,0,0,0,0,0,0,0,0,0,0,0,0,0
GOA,2005,EVE-TEASING,0,0,0,0,0,0,0,0,0,0,0,0,0,0,0
GOA,2005,CRUELTY BY HUSBAND OR RELATIVE OF HUSBAND,0,0,0,0,0,0,0,0,0,0,0,0,0,0,0
GOA,2005,OTHER IPC CRIMES,0,0,0,0,0,0,2,0,2,2,0,2,4,0,4
GOA,2005,TOTAL IPC,0,0,0,13,0,13,73,3,76,9,0,9,95,3,98
GOA,2006,MURDER,0,0,0,20,0,20,28,1,29,7,1,8,55,2,57
GOA,2006,ATTEMPT TO COMMIT MURDER,0,0,0,0,0,0,7,0,7,0,0,0,7,0,7
GOA,2006,C.H. NOT AMOUNTING TO MURDER,0,0,0,2,0,2,4,0,4,0,0,0,6,0,6
GOA,2006,RAPE,0,0,0,12,0,12,4,0,4,0,0,0,16,0,16
GOA,2006,KIDNAPPING AND ABDUCTION,0,0,0,0,0,0,0,0,0,0,0,0,0,0,0
GOA,2006,DACOITY,0,0,0,2,0,2,2,0,2,0,0,0,4,0,4
GOA,2006,PREP. AND ASSEMBLY FOR DACOITY,0,0,0,0,0,0,0,0,0,0,0,0,0,0,0
GOA,2006,ROBBERY,0,0,0,0,0,0,0,0,0,0,0,0,0,0,0
GOA,2006,BURGLARY,0,0,0,2,0,2,1,0,1,0,0,0,3,0,3
GOA,2006,THEFTS,0,0,0,0,0,0,1,0,1,0,0,0,1,0,1
GOA,2006,EXTORTION,0,0,0,0,0,0,0,0,0,0,0,0,0,0,0
GOA,2006,RIOTS,0,0,0,0,0,0,0,0,0,0,0,0,0,0,0
GOA,2006,ARSON,0,0,0,1,0,1,2,0,2,0,0,0,3,0,3
GOA,2006,CRIMINAL BREACH OF TRUST,0,0,0,0,0,0,0,0,0,0,0,0,0,0,0
GOA,2006,CHEATING,0,0,0,0,0,0,0,0,0,0,0,0,0,0,0
GOA,2006,COUNTER FEITING,0,0,0,0,0,0,0,0,0,0,0,0,0,0,0
GOA,2006,DOWRY DEATHS,0,0,0,0,0,0,0,0,0,0,0,0,0,0,0
GOA,2006,MOLESTATION,0,0,0,0,0,0,0,0,0,0,0,0,0,0,0
GOA,2006,EVE-TEASING,0,0,0,0,0,0,0,0,0,0,0,0,0,0,0
GOA,2006,CRUELTY BY HUSBAND OR RELATIVE OF HUSBAND,0,0,0,0,0,0,0,0,0,0,0,0,0,0,0
GOA,2006,OTHER IPC CRIMES,0,0,0,9,0,9,7,0,7,0,0,0,16,0,16
GOA,2006,TOTAL IPC,0,0,0,48,0,48,56,1,57,7,1,8,111,2,113
GOA,2007,MURDER,0,0,0,18,0,18,22,1,23,6,0,6,46,1,47
GOA,2007,ATTEMPT TO COMMIT MURDER,0,0,0,2,0,2,9,0,9,9,0,9,20,0,20
GOA,2007,C.H. NOT AMOUNTING TO MURDER,0,0,0,3,1,4,8,0,8,5,0,5,16,1,17
GOA,2007,RAPE,0,0,0,1,0,1,6,0,6,4,0,4,11,0,11
GOA,2007,KIDNAPPING AND ABDUCTION,0,0,0,1,0,1,0,0,0,0,0,0,1,0,1
GOA,2007,DACOITY,0,0,0,3,0,3,4,0,4,0,0,0,7,0,7
GOA,2007,PREP. AND ASSEMBLY FOR DACOITY,0,0,0,1,0,1,1,0,1,0,0,0,2,0,2
GOA,2007,ROBBERY,0,0,0,0,0,0,0,0,0,0,0,0,0,0,0
GOA,2007,BURGLARY,0,0,0,0,0,0,2,0,2,0,0,0,2,0,2
GOA,2007,THEFTS,0,0,0,1,0,1,0,0,0,0,0,0,1,0,1
GOA,2007,EXTORTION,0,0,0,0,0,0,0,0,0,0,0,0,0,0,0
GOA,2007,RIOTS,0,0,0,0,0,0,0,0,0,0,0,0,0,0,0
GOA,2007,ARSON,0,0,0,0,0,0,0,0,0,0,0,0,0,0,0
GOA,2007,CRIMINAL BREACH OF TRUST,0,0,0,0,0,0,0,0,0,0,0,0,0,0,0
GOA,2007,CHEATING,0,0,0,5,0,5,3,0,3,0,0,0,8,0,8
GOA,2007,COUNTER FEITING,0,0,0,0,0,0,0,0,0,0,0,0,0,0,0
GOA,2007,DOWRY DEATHS,0,0,0,0,0,0,0,0,0,0,0,0,0,0,0
GOA,2007,MOLESTATION,0,0,0,0,0,0,0,0,0,0,0,0,0,0,0
GOA,2007,EVE-TEASING,0,0,0,0,0,0,0,0,0,0,0,0,0,0,0
GOA,2007,CRUELTY BY HUSBAND OR RELATIVE OF HUSBAND,0,0,0,0,0,0,0,0,0,0,0,0,0,0,0
GOA,2007,OTHER IPC CRIMES,0,0,0,1,0,1,1,0,1,3,0,3,5,0,5
GOA,2007,TOTAL IPC,0,0,0,36,1,37,56,1,57,27,0,27,119,2,121
GOA,2008,MURDER,0,0,0,31,1,32,27,1,28,6,1,7,64,3,67
GOA,2008,ATTEMPT TO COMMIT MURDER,0,0,0,1,0,1,0,0,0,1,0,1,2,0,2
GOA,2008,C.H. NOT AMOUNTING TO MURDER,0,0,0,1,0,1,4,3,7,1,0,1,6,3,9
GOA,2008,RAPE,0,0,0,7,0,7,3,0,3,1,0,1,11,0,11
GOA,2008,KIDNAPPING AND ABDUCTION,0,0,0,4,0,4,0,0,0,0,0,0,4,0,4
GOA,2008,DACOITY,0,0,0,3,0,3,3,0,3,0,0,0,6,0,6
GOA,2008,PREP. AND ASSEMBLY FOR DACOITY,0,0,0,2,0,2,1,0,1,0,0,0,3,0,3
GOA,2008,ROBBERY,0,0,0,2,0,2,0,0,0,0,0,0,2,0,2
GOA,2008,BURGLARY,0,0,0,2,0,2,0,0,0,0,0,0,2,0,2
GOA,2008,THEFTS,0,0,0,1,0,1,1,2,3,0,0,0,2,2,4
GOA,2008,EXTORTION,0,0,0,0,0,0,0,0,0,0,0,0,0,0,0
GOA,2008,RIOTS,0,0,0,0,0,0,0,0,0,0,0,0,0,0,0
GOA,2008,ARSON,0,0,0,0,0,0,0,0,0,0,0,0,0,0,0
GOA,2008,CRIMINAL BREACH OF TRUST,0,0,0,0,0,0,0,0,0,0,0,0,0,0,0
GOA,2008,CHEATING,0,0,0,6,0,6,2,0,2,0,0,0,8,0,8
GOA,2008,COUNTER FEITING,0,0,0,0,0,0,0,0,0,0,0,0,0,0,0
GOA,2008,DOWRY DEATHS,0,0,0,0,0,0,0,0,0,0,0,0,0,0,0
GOA,2008,MOLESTATION,0,0,0,0,0,0,0,0,0,0,0,0,0,0,0
GOA,2008,EVE-TEASING,0,0,0,0,0,0,0,0,0,0,0,0,0,0,0
GOA,2008,CRUELTY BY HUSBAND OR RELATIVE OF HUSBAND,0,0,0,0,0,0,0,0,0,0,0,0,0,0,0
GOA,2008,OTHER IPC CRIMES,0,0,0,0,0,0,0,1,1,0,0,0,0,1,1
GOA,2008,TOTAL IPC,0,0,0,60,1,61,41,7,48,9,1,10,110,9,119
GOA,2009,MURDER,0,0,0,31,0,31,27,1,28,6,0,6,64,1,65
GOA,2009,ATTEMPT TO COMMIT MURDER,0,0,0,1,0,1,0,0,0,1,0,1,2,0,2
GOA,2009,C.H. NOT AMOUNTING TO MURDER,0,0,0,3,0,3,6,3,9,1,0,1,10,3,13
GOA,2009,RAPE,0,0,0,10,0,10,4,0,4,0,0,0,14,0,14
GOA,2009,KIDNAPPING AND ABDUCTION,0,0,0,3,0,3,1,0,1,0,0,0,4,0,4
GOA,2009,DACOITY,0,0,0,0,0,0,2,0,2,0,0,0,2,0,2
GOA,2009,PREP. AND ASSEMBLY FOR DACOITY,0,0,0,0,0,0,0,0,0,0,0,0,0,0,0
GOA,2009,ROBBERY,0,0,0,1,0,1,0,0,0,0,0,0,1,0,1
GOA,2009,BURGLARY,0,0,0,7,0,7,0,0,0,0,0,0,7,0,7
GOA,2009,THEFTS,0,0,0,3,0,3,0,2,2,0,0,0,3,2,5
GOA,2009,EXTORTION,0,0,0,0,0,0,0,0,0,0,0,0,0,0,0
GOA,2009,RIOTS,0,0,0,0,0,0,0,0,0,0,0,0,0,0,0
GOA,2009,ARSON,0,0,0,0,0,0,0,0,0,0,0,0,0,0,0
GOA,2009,CRIMINAL BREACH OF TRUST,0,0,0,0,0,0,0,0,0,0,0,0,0,0,0
GOA,2009,CHEATING,0,0,0,2,0,2,2,0,2,1,0,1,5,0,5
GOA,2009,COUNTER FEITING,0,0,0,1,0,1,0,0,0,0,0,0,1,0,1
GOA,2009,DOWRY DEATHS,0,0,0,0,0,0,0,0,0,0,0,0,0,0,0
GOA,2009,MOLESTATION,0,0,0,0,0,0,0,0,0,0,0,0,0,0,0
GOA,2009,EVE-TEASING,0,0,0,0,0,0,0,0,0,0,0,0,0,0,0
GOA,2009,CRUELTY BY HUSBAND OR RELATIVE OF HUSBAND,0,0,0,0,0,0,0,0,0,0,0,0,0,0,0
GOA,2009,OTHER IPC CRIMES,0,0,0,3,0,3,5,1,6,0,0,0,8,1,9
GOA,2009,TOTAL IPC,0,0,0,65,0,65,47,7,54,9,0,9,121,7,128
GOA,2010,MURDER,0,0,0,30,0,30,28,2,30,6,0,6,64,2,66
GOA,2010,ATTEMPT TO COMMIT MURDER,0,0,0,1,0,1,0,1,1,1,0,1,2,1,3
GOA,2010,C.H. NOT AMOUNTING TO MURDER,0,0,0,2,0,2,6,2,8,0,0,0,8,2,10
GOA,2010,RAPE,0,0,0,12,0,12,6,0,6,0,0,0,18,0,18
GOA,2010,KIDNAPPING AND ABDUCTION,0,0,0,2,0,2,2,0,2,0,0,0,4,0,4
GOA,2010,DACOITY,0,0,0,0,0,0,4,0,4,0,0,0,4,0,4
GOA,2010,PREP. AND ASSEMBLY FOR DACOITY,0,0,0,0,0,0,0,0,0,0,0,0,0,0,0
GOA,2010,ROBBERY,0,0,0,1,0,1,2,0,2,0,0,0,3,0,3
GOA,2010,BURGLARY,0,0,0,5,0,5,2,0,2,0,0,0,7,0,7
GOA,2010,THEFTS,0,0,0,10,0,10,4,3,7,0,0,0,14,3,17
GOA,2010,EXTORTION,0,0,0,0,0,0,0,0,0,0,0,0,0,0,0
GOA,2010,RIOTS,0,0,0,0,0,0,0,0,0,0,0,0,0,0,0
GOA,2010,ARSON,0,0,0,0,0,0,0,0,0,0,0,0,0,0,0
GOA,2010,CRIMINAL BREACH OF TRUST,0,0,0,0,0,0,0,0,0,0,0,0,0,0,0
GOA,2010,CHEATING,0,0,0,1,0,1,0,0,0,0,0,0,1,0,1
GOA,2010,COUNTER FEITING,0,0,0,0,0,0,0,0,0,0,0,0,0,0,0
GOA,2010,DOWRY DEATHS,0,0,0,0,0,0,0,0,0,0,0,0,0,0,0
GOA,2010,MOLESTATION,0,0,0,0,0,0,1,0,1,0,0,0,1,0,1
GOA,2010,EVE-TEASING,0,0,0,0,0,0,0,0,0,0,0,0,0,0,0
GOA,2010,CRUELTY BY HUSBAND OR RELATIVE OF HUSBAND,0,0,0,0,0,0,0,0,0,0,0,0,0,0,0
GOA,2010,OTHER IPC CRIMES,0,0,0,0,0,0,0,0,0,0,0,0,0,0,0
GOA,2010,TOTAL IPC,0,0,0,64,0,64,55,8,63,7,0,7,126,8,134
GOA,2011,MURDER,0,0,0,27,0,27,35,2,37,9,0,9,71,2,73
GOA,2011,ATTEMPT TO COMMIT MURDER,0,0,0,2,0,2,1,0,1,0,0,0,3,0,3
GOA,2011,C.H. NOT AMOUNTING TO MURDER,0,0,0,3,0,3,4,2,6,0,0,0,7,2,9
GOA,2011,RAPE,0,0,0,10,0,10,7,0,7,1,0,1,18,0,18
GOA,2011,KIDNAPPING AND ABDUCTION,0,0,0,0,0,0,0,0,0,0,0,0,0,0,0
GOA,2011,DACOITY,0,0,0,0,0,0,0,0,0,0,0,0,0,0,0
GOA,2011,PREP. AND ASSEMBLY FOR DACOITY,0,0,0,0,0,0,0,0,0,0,0,0,0,0,0
GOA,2011,ROBBERY,0,0,0,4,0,4,2,0,2,0,0,0,6,0,6
GOA,2011,BURGLARY,0,0,0,0,0,0,2,0,2,0,0,0,2,0,2
GOA,2011,THEFTS,0,0,0,5,0,5,2,0,2,0,0,0,7,0,7
GOA,2011,EXTORTION,0,0,0,0,0,0,0,0,0,0,0,0,0,0,0
GOA,2011,RIOTS,0,0,0,0,0,0,0,0,0,0,0,0,0,0,0
GOA,2011,ARSON,0,0,0,0,0,0,0,0,0,0,0,0,0,0,0
GOA,2011,CRIMINAL BREACH OF TRUST,0,0,0,0,0,0,0,0,0,0,0,0,0,0,0
GOA,2011,CHEATING,0,0,0,3,0,3,0,2,2,0,0,0,3,2,5
GOA,2011,COUNTER FEITING,0,0,0,0,0,0,0,0,0,0,0,0,0,0,0
GOA,2011,DOWRY DEATHS,0,0,0,0,0,0,0,0,0,0,0,0,0,0,0
GOA,2011,MOLESTATION,0,0,0,0,0,0,0,0,0,0,0,0,0,0,0
GOA,2011,EVE-TEASING,0,0,0,0,0,0,0,0,0,0,0,0,0,0,0
GOA,2011,CRUELTY BY HUSBAND OR RELATIVE OF HUSBAND,0,0,0,0,0,0,0,0,0,0,0,0,0,0,0
GOA,2011,OTHER IPC CRIMES,0,0,0,0,0,0,0,0,0,0,0,0,0,0,0
GOA,2011,TOTAL IPC,0,0,0,54,0,54,53,6,59,10,0,10,117,6,123
GOA,2012,MURDER,0,0,0,23,0,23,34,1,35,8,0,8,65,1,66
GOA,2012,ATTEMPT TO COMMIT MURDER,0,0,0,1,0,1,1,0,1,0,0,0,2,0,2
GOA,2012,C.H. NOT AMOUNTING TO MURDER,0,0,0,4,0,4,3,1,4,1,0,1,8,1,9
GOA,2012,RAPE,0,0,0,10,0,10,9,0,9,0,0,0,19,0,19
GOA,2012,KIDNAPPING AND ABDUCTION,0,0,0,0,0,0,0,0,0,0,0,0,0,0,0
GOA,2012,DACOITY,0,0,0,0,0,0,0,0,0,0,0,0,0,0,0
GOA,2012,PREP. AND ASSEMBLY FOR DACOITY,0,0,0,0,0,0,0,0,0,0,0,0,0,0,0
GOA,2012,ROBBERY,0,0,0,5,0,5,3,0,3,0,0,0,8,0,8
GOA,2012,BURGLARY,0,0,0,0,0,0,1,0,1,0,0,0,1,0,1
GOA,2012,THEFTS,0,0,0,4,0,4,1,0,1,0,0,0,5,0,5
GOA,2012,EXTORTION,0,0,0,0,0,0,0,0,0,0,0,0,0,0,0
GOA,2012,RIOTS,0,0,0,0,0,0,0,0,0,0,0,0,0,0,0
GOA,2012,ARSON,0,0,0,0,0,0,0,0,0,0,0,0,0,0,0
GOA,2012,CRIMINAL BREACH OF TRUST,0,0,0,0,0,0,0,0,0,0,0,0,0,0,0
GOA,2012,CHEATING,0,0,0,2,0,2,2,1,3,0,0,0,4,1,5
GOA,2012,COUNTER FEITING,0,0,0,1,0,1,0,0,0,0,0,0,1,0,1
GOA,2012,DOWRY DEATHS,0,0,0,0,0,0,0,0,0,0,0,0,0,0,0
GOA,2012,MOLESTATION,0,0,0,0,0,0,0,0,0,0,0,0,0,0,0
GOA,2012,EVE-TEASING,0,0,0,0,0,0,0,0,0,0,0,0,0,0,0
GOA,2012,CRUELTY BY HUSBAND OR RELATIVE OF HUSBAND,0,0,0,0,0,0,0,0,0,0,0,0,0,0,0
GOA,2012,OTHER IPC CRIMES,0,0,0,0,0,0,0,1,1,0,0,0,0,1,1
GOA,2012,TOTAL IPC,0,0,0,50,0,50,54,4,58,9,0,9,113,4,117
GUJARAT,2001,MURDER,0,0,0,632,24,656,1078,15,1093,78,7,85,1788,46,1834
GUJARAT,2001,ATTEMPT TO COMMIT MURDER,0,0,0,13,0,13,23,0,23,3,0,3,39,0,39
GUJARAT,2001,C.H. NOT AMOUNTING TO MURDER,0,0,0,22,0,22,17,0,17,3,0,3,42,0,42
GUJARAT,2001,RAPE,0,0,0,43,0,43,46,0,46,0,0,0,89,0,89
GUJARAT,2001,KIDNAPPING AND ABDUCTION,0,0,0,27,0,27,38,0,38,0,0,0,65,0,65
GUJARAT,2001,DACOITY,0,0,0,14,0,14,9,1,10,0,0,0,23,1,24
GUJARAT,2001,PREP. AND ASSEMBLY FOR DACOITY,0,0,0,13,0,13,0,0,0,0,0,0,13,0,13
GUJARAT,2001,ROBBERY,0,0,0,42,0,42,26,0,26,0,0,0,68,0,68
GUJARAT,2001,BURGLARY,0,0,0,23,0,23,13,0,13,0,0,0,36,0,36
GUJARAT,2001,THEFTS,0,0,0,9,0,9,15,0,15,1,0,1,25,0,25
GUJARAT,2001,EXTORTION,0,0,0,5,0,5,3,0,3,0,0,0,8,0,8
GUJARAT,2001,RIOTS,0,0,0,0,0,0,0,0,0,0,0,0,0,0,0
GUJARAT,2001,ARSON,0,0,0,0,0,0,0,0,0,0,0,0,0,0,0
GUJARAT,2001,CRIMINAL BREACH OF TRUST,0,0,0,0,0,0,0,0,0,0,0,0,0,0,0
GUJARAT,2001,CHEATING,0,0,0,2,0,2,1,0,1,1,0,1,4,0,4
GUJARAT,2001,COUNTER FEITING,0,0,0,0,0,0,0,0,0,0,0,0,0,0,0
GUJARAT,2001,DOWRY DEATHS,0,0,0,0,0,0,0,0,0,0,0,0,0,0,0
GUJARAT,2001,MOLESTATION,0,0,0,0,0,0,0,0,0,0,0,0,0,0,0
GUJARAT,2001,EVE-TEASING,0,0,0,0,0,0,0,0,0,0,0,0,0,0,0
GUJARAT,2001,CRUELTY BY HUSBAND OR RELATIVE OF HUSBAND,0,0,0,18,5,23,32,5,37,6,0,6,56,10,66
GUJARAT,2001,OTHER IPC CRIMES,0,0,0,54,0,54,36,0,36,0,0,0,90,0,90
GUJARAT,2001,TOTAL IPC,0,0,0,917,29,946,1337,21,1358,92,7,99,2346,57,2403
GUJARAT,2002,MURDER,0,0,0,672,31,703,1108,19,1127,108,11,119,1888,61,1949
GUJARAT,2002,ATTEMPT TO COMMIT MURDER,0,0,0,20,0,20,29,2,31,10,0,10,59,2,61
GUJARAT,2002,C.H. NOT AMOUNTING TO MURDER,0,0,0,32,1,33,27,2,29,13,1,14,72,4,76
GUJARAT,2002,RAPE,0,0,0,53,0,53,55,0,55,6,0,6,114,0,114
GUJARAT,2002,KIDNAPPING AND ABDUCTION,0,0,0,30,0,30,45,2,47,3,0,3,78,2,80
GUJARAT,2002,DACOITY,0,0,0,21,0,21,11,3,14,1,0,1,33,3,36
GUJARAT,2002,PREP. AND ASSEMBLY FOR DACOITY,0,0,0,10,0,10,3,0,3,0,0,0,13,0,13
GUJARAT,2002,ROBBERY,0,0,0,52,0,52,31,0,31,3,0,3,86,0,86
GUJARAT,2002,BURGLARY,0,0,0,27,0,27,18,1,19,2,0,2,47,1,48
GUJARAT,2002,THEFTS,0,0,0,15,2,17,18,0,18,3,0,3,36,2,38
GUJARAT,2002,EXTORTION,0,0,0,3,0,3,5,0,5,2,0,2,10,0,10
GUJARAT,2002,RIOTS,0,0,0,10,0,10,14,0,14,6,0,6,30,0,30
GUJARAT,2002,ARSON,0,0,0,0,0,0,0,0,0,0,0,0,0,0,0
GUJARAT,2002,CRIMINAL BREACH OF TRUST,0,0,0,0,0,0,0,0,0,0,0,0,0,0,0
GUJARAT,2002,CHEATING,0,0,0,8,0,8,3,0,3,3,0,3,14,0,14
GUJARAT,2002,COUNTER FEITING,0,0,0,0,0,0,0,0,0,0,0,0,0,0,0
GUJARAT,2002,DOWRY DEATHS,0,0,0,0,0,0,0,0,0,0,0,0,0,0,0
GUJARAT,2002,MOLESTATION,0,0,0,0,0,0,0,0,0,0,0,0,0,0,0
GUJARAT,2002,EVE-TEASING,0,0,0,0,0,0,0,0,0,0,0,0,0,0,0
GUJARAT,2002,CRUELTY BY HUSBAND OR RELATIVE OF HUSBAND,0,0,0,28,7,35,36,5,41,10,1,11,74,13,87
GUJARAT,2002,OTHER IPC CRIMES,0,0,0,60,2,62,40,2,42,0,0,0,100,4,104
GUJARAT,2002,TOTAL IPC,0,0,0,1041,43,1084,1443,36,1479,170,13,183,2654,92,2746
GUJARAT,2003,MURDER,8,0,8,613,14,627,964,35,999,272,0,272,1857,49,1906
GUJARAT,2003,ATTEMPT TO COMMIT MURDER,0,0,0,73,2,75,47,4,51,8,2,10,128,8,136
GUJARAT,2003,C.H. NOT AMOUNTING TO MURDER,0,0,0,49,0,49,37,1,38,10,4,14,96,5,101
GUJARAT,2003,RAPE,1,0,1,116,2,118,35,0,35,3,0,3,155,2,157
GUJARAT,2003,KIDNAPPING AND ABDUCTION,0,0,0,63,0,63,41,2,43,2,0,2,106,2,108
GUJARAT,2003,DACOITY,0,0,0,32,0,32,29,3,32,2,0,2,63,3,66
GUJARAT,2003,PREP. AND ASSEMBLY FOR DACOITY,0,0,0,20,0,20,0,0,0,0,0,0,20,0,20
GUJARAT,2003,ROBBERY,0,0,0,59,0,59,11,0,11,0,0,0,70,0,70
GUJARAT,2003,BURGLARY,0,0,0,30,0,30,21,0,21,8,0,8,59,0,59
GUJARAT,2003,THEFTS,0,0,0,8,0,8,18,0,18,0,3,3,26,3,29
GUJARAT,2003,EXTORTION,0,0,0,14,0,14,2,0,2,0,0,0,16,0,16
GUJARAT,2003,RIOTS,0,0,0,0,0,0,3,0,3,0,0,0,3,0,3
GUJARAT,2003,ARSON,0,0,0,6,0,6,8,0,8,0,0,0,14,0,14
GUJARAT,2003,CRIMINAL BREACH OF TRUST,0,0,0,3,0,3,2,0,2,0,0,0,5,0,5
GUJARAT,2003,CHEATING,0,0,0,4,0,4,4,0,4,2,0,2,10,0,10
GUJARAT,2003,COUNTER FEITING,0,0,0,5,0,5,4,0,4,0,0,0,9,0,9
GUJARAT,2003,DOWRY DEATHS,0,0,0,5,3,8,2,3,5,0,0,0,7,6,13
GUJARAT,2003,MOLESTATION,0,0,0,3,0,3,0,0,0,0,0,0,3,0,3
GUJARAT,2003,EVE-TEASING,0,0,0,0,0,0,0,0,0,0,0,0,0,0,0
GUJARAT,2003,CRUELTY BY HUSBAND OR RELATIVE OF HUSBAND,0,0,0,6,4,10,12,6,18,0,3,3,18,13,31
GUJARAT,2003,OTHER IPC CRIMES,0,0,0,10,2,12,31,4,35,15,2,17,56,8,64
GUJARAT,2003,TOTAL IPC,9,0,9,1119,27,1146,1271,58,1329,322,14,336,2721,99,2820
GUJARAT,2004,MURDER,3,0,3,465,10,475,747,51,798,231,29,260,1446,90,1536
GUJARAT,2004,ATTEMPT TO COMMIT MURDER,0,0,0,161,5,166,72,8,80,50,2,52,283,15,298
GUJARAT,2004,C.H. NOT AMOUNTING TO MURDER,0,0,0,45,0,45,75,0,75,22,0,22,142,0,142
GUJARAT,2004,RAPE,0,0,0,102,1,103,57,0,57,3,0,3,162,1,163
GUJARAT,2004,KIDNAPPING AND ABDUCTION,0,0,0,150,2,152,87,2,89,8,0,8,245,4,249
GUJARAT,2004,DACOITY,0,0,0,10,0,10,167,0,167,9,0,9,186,0,186
GUJARAT,2004,PREP. AND ASSEMBLY FOR DACOITY,0,0,0,0,0,0,0,0,0,0,0,0,0,0,0
GUJARAT,2004,ROBBERY,0,0,0,22,0,22,62,0,62,13,0,13,97,0,97
GUJARAT,2004,BURGLARY,0,0,0,5,0,5,10,0,10,0,0,0,15,0,15
GUJARAT,2004,THEFTS,0,0,0,16,1,17,24,0,24,0,0,0,40,1,41
GUJARAT,2004,EXTORTION,0,0,0,0,0,0,0,0,0,0,0,0,0,0,0
GUJARAT,2004,RIOTS,0,0,0,8,0,8,31,0,31,0,0,0,39,0,39
GUJARAT,2004,ARSON,0,0,0,5,0,5,0,0,0,0,0,0,5,0,5
GUJARAT,2004,CRIMINAL BREACH OF TRUST,0,0,0,0,0,0,0,0,0,0,0,0,0,0,0
GUJARAT,2004,CHEATING,0,0,0,12,0,12,48,3,51,4,0,4,64,3,67
GUJARAT,2004,COUNTER FEITING,0,0,0,0,0,0,0,0,0,0,0,0,0,0,0
GUJARAT,2004,DOWRY DEATHS,0,0,0,22,2,24,50,1,51,20,0,20,92,3,95
GUJARAT,2004,MOLESTATION,0,0,0,0,0,0,0,0,0,0,0,0,0,0,0
GUJARAT,2004,EVE-TEASING,0,0,0,0,0,0,0,0,0,0,0,0,0,0,0
GUJARAT,2004,CRUELTY BY HUSBAND OR RELATIVE OF HUSBAND,0,0,0,31,1,32,144,6,150,63,4,67,238,11,249
GUJARAT,2004,OTHER IPC CRIMES,0,0,0,38,2,40,55,1,56,42,2,44,135,5,140
GUJARAT,2004,TOTAL IPC,3,0,3,1092,24,1116,1629,72,1701,465,37,502,3189,133,3322
GUJARAT,2005,MURDER,0,0,0,810,15,825,1518,52,1570,198,29,227,2526,96,2622
GUJARAT,2005,ATTEMPT TO COMMIT MURDER,0,0,0,80,3,83,133,2,135,9,1,10,222,6,228
GUJARAT,2005,C.H. NOT AMOUNTING TO MURDER,0,0,0,22,0,22,77,1,78,6,0,6,105,1,106
GUJARAT,2005,RAPE,0,0,0,114,1,115,58,0,58,6,0,6,178,1,179
GUJARAT,2005,KIDNAPPING AND ABDUCTION,0,0,0,128,4,132,40,1,41,8,1,9,176,6,182
GUJARAT,2005,DACOITY,0,0,0,13,0,13,12,0,12,1,0,1,26,0,26
GUJARAT,2005,PREP. AND ASSEMBLY FOR DACOITY,0,0,0,2,0,2,11,0,11,0,0,0,13,0,13
GUJARAT,2005,ROBBERY,0,0,0,16,0,16,10,0,10,1,0,1,27,0,27
GUJARAT,2005,BURGLARY,0,0,0,8,0,8,4,0,4,0,0,0,12,0,12
GUJARAT,2005,THEFTS,0,0,0,45,2,47,40,1,41,15,0,15,100,3,103
GUJARAT,2005,EXTORTION,0,0,0,0,0,0,0,0,0,0,0,0,0,0,0
GUJARAT,2005,RIOTS,0,0,0,0,0,0,0,0,0,0,0,0,0,0,0
GUJARAT,2005,ARSON,0,0,0,0,0,0,0,0,0,0,0,0,0,0,0
GUJARAT,2005,CRIMINAL BREACH OF TRUST,0,0,0,0,0,0,1,0,1,0,0,0,1,0,1
GUJARAT,2005,CHEATING,0,0,0,1,0,1,10,0,10,0,0,0,11,0,11
GUJARAT,2005,COUNTER FEITING,0,0,0,6,0,6,6,0,6,1,0,1,13,0,13
GUJARAT,2005,DOWRY DEATHS,0,0,0,33,1,34,14,0,14,0,2,2,47,3,50
GUJARAT,2005,MOLESTATION,0,0,0,0,0,0,0,0,0,0,0,0,0,0,0
GUJARAT,2005,EVE-TEASING,0,0,0,0,0,0,0,0,0,0,0,0,0,0,0
GUJARAT,2005,CRUELTY BY HUSBAND OR RELATIVE OF HUSBAND,0,0,0,26,0,26,2,0,2,0,0,0,28,0,28
GUJARAT,2005,OTHER IPC CRIMES,0,0,0,220,0,220,88,1,89,42,0,42,350,1,351
GUJARAT,2005,TOTAL IPC,0,0,0,1524,26,1550,2024,58,2082,287,33,320,3835,117,3952
GUJARAT,2006,MURDER,0,0,0,864,13,877,1441,64,1505,182,15,197,2487,92,2579
GUJARAT,2006,ATTEMPT TO COMMIT MURDER,0,0,0,96,0,96,116,2,118,38,1,39,250,3,253
GUJARAT,2006,C.H. NOT AMOUNTING TO MURDER,0,0,0,42,0,42,106,0,106,16,0,16,164,0,164
GUJARAT,2006,RAPE,0,0,0,123,1,124,102,1,103,5,0,5,230,2,232
GUJARAT,2006,KIDNAPPING AND ABDUCTION,0,0,0,37,2,39,24,0,24,4,0,4,65,2,67
GUJARAT,2006,DACOITY,0,0,0,15,0,15,25,2,27,6,0,6,46,2,48
GUJARAT,2006,PREP. AND ASSEMBLY FOR DACOITY,0,0,0,5,0,5,10,0,10,1,0,1,16,0,16
GUJARAT,2006,ROBBERY,0,0,0,35,0,35,19,1,20,11,0,11,65,1,66
GUJARAT,2006,BURGLARY,0,0,0,4,0,4,0,0,0,0,0,0,4,0,4
GUJARAT,2006,THEFTS,0,0,0,65,0,65,61,4,65,7,0,7,133,4,137
GUJARAT,2006,EXTORTION,0,0,0,0,0,0,0,0,0,0,0,0,0,0,0
GUJARAT,2006,RIOTS,0,0,0,0,0,0,0,0,0,0,0,0,0,0,0
GUJARAT,2006,ARSON,0,0,0,0,0,0,0,0,0,0,0,0,0,0,0
GUJARAT,2006,CRIMINAL BREACH OF TRUST,0,0,0,0,0,0,1,0,1,0,0,0,1,0,1
GUJARAT,2006,CHEATING,0,0,0,7,0,7,13,0,13,0,0,0,20,0,20
GUJARAT,2006,COUNTER FEITING,0,0,0,10,0,10,9,0,9,2,2,4,21,2,23
GUJARAT,2006,DOWRY DEATHS,0,0,0,42,2,44,26,1,27,3,0,3,71,3,74
GUJARAT,2006,MOLESTATION,0,0,0,0,0,0,0,0,0,0,0,0,0,0,0
GUJARAT,2006,EVE-TEASING,0,0,0,0,0,0,0,0,0,0,0,0,0,0,0
GUJARAT,2006,CRUELTY BY HUSBAND OR RELATIVE OF HUSBAND,0,0,0,34,0,34,7,12,19,11,7,18,52,19,71
GUJARAT,2006,OTHER IPC CRIMES,0,0,0,251,3,254,64,1,65,34,0,34,349,4,353
GUJARAT,2006,TOTAL IPC,0,0,0,1630,21,1651,2024,88,2112,320,25,345,3974,134,4108
GUJARAT,2007,MURDER,0,0,0,924,17,941,959,63,1022,313,23,336,2196,103,2299
GUJARAT,2007,ATTEMPT TO COMMIT MURDER,0,0,0,106,2,108,120,0,120,47,0,47,273,2,275
GUJARAT,2007,C.H. NOT AMOUNTING TO MURDER,0,0,0,125,0,125,111,2,113,58,2,60,294,4,298
GUJARAT,2007,RAPE,0,0,0,215,1,216,178,1,179,22,0,22,415,2,417
GUJARAT,2007,KIDNAPPING AND ABDUCTION,0,0,0,32,2,34,33,1,34,8,0,8,73,3,76
GUJARAT,2007,DACOITY,0,0,0,44,0,44,56,2,58,6,0,6,106,2,108
GUJARAT,2007,PREP. AND ASSEMBLY FOR DACOITY,0,0,0,0,0,0,6,0,6,0,0,0,6,0,6
GUJARAT,2007,ROBBERY,0,0,0,94,0,94,16,1,17,13,0,13,123,1,124
GUJARAT,2007,BURGLARY,0,0,0,11,0,11,0,0,0,0,0,0,11,0,11
GUJARAT,2007,THEFTS,0,0,0,99,0,99,52,0,52,7,0,7,158,0,158
GUJARAT,2007,EXTORTION,0,0,0,10,0,10,6,0,6,5,0,5,21,0,21
GUJARAT,2007,RIOTS,0,0,0,0,0,0,0,0,0,0,0,0,0,0,0
GUJARAT,2007,ARSON,0,0,0,5,0,5,10,0,10,8,0,8,23,0,23
GUJARAT,2007,CRIMINAL BREACH OF TRUST,0,0,0,2,0,2,0,0,0,1,0,1,3,0,3
GUJARAT,2007,CHEATING,0,0,0,8,0,8,11,0,11,1,0,1,20,0,20
GUJARAT,2007,COUNTER FEITING,0,0,0,5,0,5,0,0,0,0,0,0,5,0,5
GUJARAT,2007,DOWRY DEATHS,0,0,0,52,2,54,29,1,30,3,1,4,84,4,88
GUJARAT,2007,MOLESTATION,0,0,0,0,0,0,0,0,0,0,0,0,0,0,0
GUJARAT,2007,EVE-TEASING,0,0,0,0,0,0,0,0,0,0,0,0,0,0,0
GUJARAT,2007,CRUELTY BY HUSBAND OR RELATIVE OF HUSBAND,0,0,0,101,10,111,28,19,47,16,7,23,145,36,181
GUJARAT,2007,OTHER IPC CRIMES,0,0,0,43,4,47,37,2,39,11,0,11,91,6,97
GUJARAT,2007,TOTAL IPC,0,0,0,1876,38,1914,1652,92,1744,519,33,552,4047,163,4210
GUJARAT,2008,MURDER,0,0,0,767,33,800,905,91,996,342,33,375,2014,157,2171
GUJARAT,2008,ATTEMPT TO COMMIT MURDER,0,0,0,139,0,139,187,0,187,41,0,41,367,0,367
GUJARAT,2008,C.H. NOT AMOUNTING TO MURDER,0,0,0,154,0,154,37,1,38,38,0,38,229,1,230
GUJARAT,2008,RAPE,0,0,0,291,0,291,210,0,210,24,2,26,525,2,527
GUJARAT,2008,KIDNAPPING AND ABDUCTION,0,0,0,46,0,46,88,2,90,8,2,10,142,4,146
GUJARAT,2008,DACOITY,0,0,0,33,0,33,34,0,34,8,0,8,75,0,75
GUJARAT,2008,PREP. AND ASSEMBLY FOR DACOITY,0,0,0,5,0,5,38,0,38,0,0,0,43,0,43
GUJARAT,2008,ROBBERY,0,0,0,55,0,55,108,0,108,15,0,15,178,0,178
GUJARAT,2008,BURGLARY,0,0,0,42,0,42,0,0,0,0,0,0,42,0,42
GUJARAT,2008,THEFTS,0,0,0,22,0,22,49,0,49,8,0,8,79,0,79
GUJARAT,2008,EXTORTION,0,0,0,0,0,0,0,0,0,0,0,0,0,0,0
GUJARAT,2008,RIOTS,0,0,0,5,0,5,35,0,35,18,0,18,58,0,58
GUJARAT,2008,ARSON,0,0,0,2,0,2,0,0,0,0,0,0,2,0,2
GUJARAT,2008,CRIMINAL BREACH OF TRUST,0,0,0,15,0,15,32,0,32,8,0,8,55,0,55
GUJARAT,2008,CHEATING,0,0,0,1,0,1,1,0,1,1,0,1,3,0,3
GUJARAT,2008,COUNTER FEITING,0,0,0,30,1,31,33,0,33,5,0,5,68,1,69
GUJARAT,2008,DOWRY DEATHS,0,0,0,34,0,34,26,0,26,3,0,3,63,0,63
GUJARAT,2008,MOLESTATION,0,0,0,0,0,0,0,0,0,0,0,0,0,0,0
GUJARAT,2008,EVE-TEASING,0,0,0,0,0,0,0,0,0,0,0,0,0,0,0
GUJARAT,2008,CRUELTY BY HUSBAND OR RELATIVE OF HUSBAND,0,0,0,30,9,39,72,10,82,27,6,33,129,25,154
GUJARAT,2008,OTHER IPC CRIMES,0,0,0,21,0,21,46,1,47,7,0,7,74,1,75
GUJARAT,2008,TOTAL IPC,0,0,0,1692,43,1735,1901,105,2006,553,43,596,4146,191,4337
GUJARAT,2009,MURDER,0,0,0,794,62,856,797,25,822,114,20,134,1705,107,1812
GUJARAT,2009,ATTEMPT TO COMMIT MURDER,0,0,0,82,0,82,68,0,68,24,0,24,174,0,174
GUJARAT,2009,C.H. NOT AMOUNTING TO MURDER,0,0,0,144,1,145,55,3,58,29,2,31,228,6,234
GUJARAT,2009,RAPE,0,0,0,345,1,346,131,1,132,8,0,8,484,2,486
GUJARAT,2009,KIDNAPPING AND ABDUCTION,0,0,0,46,0,46,28,0,28,11,0,11,85,0,85
GUJARAT,2009,DACOITY,0,0,0,70,1,71,26,0,26,1,0,1,97,1,98
GUJARAT,2009,PREP. AND ASSEMBLY FOR DACOITY,0,0,0,14,1,15,24,0,24,1,0,1,39,1,40
GUJARAT,2009,ROBBERY,0,0,0,22,0,22,73,0,73,0,0,0,95,0,95
GUJARAT,2009,BURGLARY,0,0,0,0,0,0,26,0,26,0,0,0,26,0,26
GUJARAT,2009,THEFTS,0,0,0,7,0,7,44,0,44,2,0,2,53,0,53
GUJARAT,2009,EXTORTION,0,0,0,0,0,0,0,0,0,0,0,0,0,0,0
GUJARAT,2009,RIOTS,0,0,0,1,0,1,21,0,21,11,0,11,33,0,33
GUJARAT,2009,ARSON,0,0,0,3,0,3,2,0,2,0,0,0,5,0,5
GUJARAT,2009,CRIMINAL BREACH OF TRUST,0,0,0,11,0,11,28,0,28,7,0,7,46,0,46
GUJARAT,2009,CHEATING,0,0,0,3,0,3,2,0,2,4,0,4,9,0,9
GUJARAT,2009,COUNTER FEITING,0,0,0,41,0,41,36,0,36,8,0,8,85,0,85
GUJARAT,2009,DOWRY DEATHS,0,0,0,29,1,30,30,2,32,0,0,0,59,3,62
GUJARAT,2009,MOLESTATION,0,0,0,0,0,0,0,0,0,0,0,0,0,0,0
GUJARAT,2009,EVE-TEASING,0,0,0,0,0,0,0,0,0,0,0,0,0,0,0
GUJARAT,2009,CRUELTY BY HUSBAND OR RELATIVE OF HUSBAND,0,0,0,13,0,13,52,0,52,18,0,18,83,0,83
GUJARAT,2009,OTHER IPC CRIMES,0,0,0,20,9,29,40,9,49,7,0,7,67,18,85
GUJARAT,2009,TOTAL IPC,0,0,0,1645,76,1721,1483,40,1523,245,22,267,3373,138,3511
GUJARAT,2010,MURDER,0,0,0,714,29,743,951,56,1007,116,25,141,1781,110,1891
GUJARAT,2010,ATTEMPT TO COMMIT MURDER,0,0,0,67,0,67,47,0,47,23,0,23,137,0,137
GUJARAT,2010,C.H. NOT AMOUNTING TO MURDER,0,0,0,143,4,147,84,8,92,37,3,40,264,15,279
GUJARAT,2010,RAPE,0,0,0,392,1,393,129,3,132,8,1,9,529,5,534
GUJARAT,2010,KIDNAPPING AND ABDUCTION,0,0,0,35,0,35,24,2,26,4,0,4,63,2,65
GUJARAT,2010,DACOITY,0,0,0,82,0,82,43,0,43,0,0,0,125,0,125
GUJARAT,2010,PREP. AND ASSEMBLY FOR DACOITY,0,0,0,10,0,10,7,0,7,1,0,1,18,0,18
GUJARAT,2010,ROBBERY,0,0,0,29,0,29,16,0,16,3,0,3,48,0,48
GUJARAT,2010,BURGLARY,0,0,0,1,0,1,5,0,5,11,0,11,17,0,17
GUJARAT,2010,THEFTS,0,0,0,48,0,48,20,1,21,5,0,5,73,1,74
GUJARAT,2010,EXTORTION,0,0,0,4,0,4,0,0,0,0,0,0,4,0,4
GUJARAT,2010,RIOTS,0,0,0,0,0,0,0,0,0,0,0,0,0,0,0
GUJARAT,2010,ARSON,0,0,0,0,0,0,0,0,0,0,0,0,0,0,0
GUJARAT,2010,CRIMINAL BREACH OF TRUST,0,0,0,2,1,3,7,1,8,4,0,4,13,2,15
GUJARAT,2010,CHEATING,0,0,0,3,0,3,1,0,1,4,0,4,8,0,8
GUJARAT,2010,COUNTER FEITING,0,0,0,38,0,38,21,0,21,15,0,15,74,0,74
GUJARAT,2010,DOWRY DEATHS,0,0,0,6,0,6,14,2,16,0,0,0,20,2,22
GUJARAT,2010,MOLESTATION,0,0,0,1,0,1,1,0,1,0,0,0,2,0,2
GUJARAT,2010,EVE-TEASING,0,0,0,0,0,0,0,0,0,0,0,0,0,0,0
GUJARAT,2010,CRUELTY BY HUSBAND OR RELATIVE OF HUSBAND,0,0,0,44,0,44,34,0,34,11,3,14,89,3,92
GUJARAT,2010,OTHER IPC CRIMES,0,0,0,34,2,36,57,5,62,31,1,32,122,8,130
GUJARAT,2010,TOTAL IPC,0,0,0,1653,37,1690,1461,78,1539,273,33,306,3387,148,3535
GUJARAT,2011,MURDER,0,0,0,636,36,672,929,52,981,122,27,149,1687,115,1802
GUJARAT,2011,ATTEMPT TO COMMIT MURDER,0,0,0,61,0,61,78,0,78,14,1,15,153,1,154
GUJARAT,2011,C.H. NOT AMOUNTING TO MURDER,0,0,0,145,4,149,99,9,108,40,5,45,284,18,302
GUJARAT,2011,RAPE,0,0,0,346,0,346,138,1,139,6,0,6,490,1,491
GUJARAT,2011,KIDNAPPING AND ABDUCTION,0,0,0,63,1,64,40,3,43,0,1,1,103,5,108
GUJARAT,2011,DACOITY,0,0,0,67,0,67,56,0,56,3,0,3,126,0,126
GUJARAT,2011,PREP. AND ASSEMBLY FOR DACOITY,0,0,0,21,0,21,14,0,14,4,0,4,39,0,39
GUJARAT,2011,ROBBERY,0,0,0,60,0,60,71,0,71,6,0,6,137,0,137
GUJARAT,2011,BURGLARY,0,0,0,1,0,1,23,0,23,13,0,13,37,0,37
GUJARAT,2011,THEFTS,0,0,0,47,1,48,32,0,32,12,0,12,91,1,92
GUJARAT,2011,EXTORTION,0,0,0,0,0,0,0,0,0,0,0,0,0,0,0
GUJARAT,2011,RIOTS,0,0,0,0,0,0,0,0,0,0,0,0,0,0,0
GUJARAT,2011,ARSON,0,0,0,9,0,9,1,0,1,0,0,0,10,0,10
GUJARAT,2011,CRIMINAL BREACH OF TRUST,0,0,0,17,0,17,13,1,14,8,0,8,38,1,39
GUJARAT,2011,CHEATING,0,0,0,3,0,3,1,0,1,0,0,0,4,0,4
GUJARAT,2011,COUNTER FEITING,0,0,0,34,0,34,27,0,27,11,0,11,72,0,72
GUJARAT,2011,DOWRY DEATHS,0,0,0,11,0,11,29,0,29,5,0,5,45,0,45
GUJARAT,2011,MOLESTATION,0,0,0,0,0,0,1,0,1,0,0,0,1,0,1
GUJARAT,2011,EVE-TEASING,0,0,0,2,0,2,0,0,0,0,0,0,2,0,2
GUJARAT,2011,CRUELTY BY HUSBAND OR RELATIVE OF HUSBAND,0,0,0,41,2,43,40,3,43,13,7,20,94,12,106
GUJARAT,2011,OTHER IPC CRIMES,0,0,0,83,1,84,77,2,79,15,0,15,175,3,178
GUJARAT,2011,TOTAL IPC,0,0,0,1647,45,1692,1669,71,1740,272,41,313,3588,157,3745
GUJARAT,2012,MURDER,0,0,0,352,18,370,1001,71,1072,270,26,296,1623,115,1738
GUJARAT,2012,ATTEMPT TO COMMIT MURDER,0,0,0,72,0,72,127,0,127,55,2,57,254,2,256
GUJARAT,2012,C.H. NOT AMOUNTING TO MURDER,0,0,0,140,1,141,124,7,131,50,4,54,314,12,326
GUJARAT,2012,RAPE,0,0,0,179,0,179,192,4,196,36,0,36,407,4,411
GUJARAT,2012,KIDNAPPING AND ABDUCTION,0,0,0,41,0,41,37,0,37,6,2,8,84,2,86
GUJARAT,2012,DACOITY,0,0,0,40,0,40,63,0,63,2,0,2,105,0,105
GUJARAT,2012,PREP. AND ASSEMBLY FOR DACOITY,0,0,0,28,0,28,24,0,24,1,0,1,53,0,53
GUJARAT,2012,ROBBERY,0,0,0,65,0,65,86,0,86,7,0,7,158,0,158
GUJARAT,2012,BURGLARY,0,0,0,16,0,16,19,1,20,13,0,13,48,1,49
GUJARAT,2012,THEFTS,0,0,0,32,0,32,18,0,18,7,0,7,57,0,57
GUJARAT,2012,EXTORTION,0,0,0,0,0,0,0,0,0,0,0,0,0,0,0
GUJARAT,2012,RIOTS,0,0,0,0,0,0,0,0,0,0,0,0,0,0,0
GUJARAT,2012,ARSON,0,0,0,6,0,6,1,0,1,3,1,4,10,1,11
GUJARAT,2012,CRIMINAL BREACH OF TRUST,0,0,0,14,0,14,12,0,12,7,0,7,33,0,33
GUJARAT,2012,CHEATING,0,0,0,12,0,12,1,0,1,0,0,0,13,0,13
GUJARAT,2012,COUNTER FEITING,0,0,0,15,0,15,37,0,37,18,0,18,70,0,70
GUJARAT,2012,DOWRY DEATHS,0,0,0,3,1,4,55,4,59,10,3,13,68,8,76
GUJARAT,2012,MOLESTATION,0,0,0,0,0,0,1,0,1,0,0,0,1,0,1
GUJARAT,2012,EVE-TEASING,0,0,0,1,0,1,0,0,0,0,0,0,1,0,1
GUJARAT,2012,CRUELTY BY HUSBAND OR RELATIVE OF HUSBAND,0,0,0,34,3,37,46,12,58,14,9,23,94,24,118
GUJARAT,2012,OTHER IPC CRIMES,0,0,0,38,0,38,114,1,115,14,0,14,166,1,167
GUJARAT,2012,TOTAL IPC,0,0,0,1088,23,1111,1958,100,2058,513,47,560,3559,170,3729
HARYANA,2001,MURDER,0,0,0,399,13,412,589,28,617,215,15,230,1203,56,1259
HARYANA,2001,ATTEMPT TO COMMIT MURDER,0,0,0,71,0,71,79,2,81,29,2,31,179,4,183
HARYANA,2001,C.H. NOT AMOUNTING TO MURDER,0,0,0,21,0,21,30,0,30,10,0,10,61,0,61
HARYANA,2001,RAPE,0,0,0,128,0,128,69,0,69,10,0,10,207,0,207
HARYANA,2001,KIDNAPPING AND ABDUCTION,0,0,0,26,0,26,50,0,50,11,0,11,87,0,87
HARYANA,2001,DACOITY,0,0,0,61,0,61,55,0,55,12,0,12,128,0,128
HARYANA,2001,PREP. AND ASSEMBLY FOR DACOITY,0,0,0,41,0,41,51,0,51,17,0,17,109,0,109
HARYANA,2001,ROBBERY,0,0,0,27,0,27,23,0,23,9,0,9,59,0,59
HARYANA,2001,BURGLARY,0,0,0,36,0,36,43,0,43,21,0,21,100,0,100
HARYANA,2001,THEFTS,0,0,0,27,2,29,21,0,21,7,0,7,55,2,57
HARYANA,2001,EXTORTION,0,0,0,0,0,0,0,0,0,0,0,0,0,0,0
HARYANA,2001,RIOTS,0,0,0,0,0,0,0,0,0,1,0,1,1,0,1
HARYANA,2001,ARSON,0,0,0,0,0,0,0,0,0,1,0,1,1,0,1
HARYANA,2001,CRIMINAL BREACH OF TRUST,0,0,0,0,0,0,0,0,0,0,0,0,0,0,0
HARYANA,2001,CHEATING,0,0,0,17,0,17,18,0,18,4,0,4,39,0,39
HARYANA,2001,COUNTER FEITING,0,0,0,0,0,0,0,0,0,0,0,0,0,0,0
HARYANA,2001,DOWRY DEATHS,0,0,0,66,4,70,70,19,89,27,12,39,163,35,198
HARYANA,2001,MOLESTATION,0,0,0,4,0,4,2,0,2,0,0,0,6,0,6
HARYANA,2001,EVE-TEASING,0,0,0,1,0,1,0,0,0,0,0,0,1,0,1
HARYANA,2001,CRUELTY BY HUSBAND OR RELATIVE OF HUSBAND,0,0,0,10,0,10,21,0,21,9,0,9,40,0,40
HARYANA,2001,OTHER IPC CRIMES,0,0,0,19,0,19,8,0,8,7,0,7,34,0,34
HARYANA,2001,TOTAL IPC,0,0,0,954,19,973,1129,49,1178,390,29,419,2473,97,2570
HARYANA,2002,MURDER,3,0,3,647,9,656,769,39,808,216,19,235,1635,67,1702
HARYANA,2002,ATTEMPT TO COMMIT MURDER,0,0,0,94,1,95,58,2,60,33,0,33,185,3,188
HARYANA,2002,C.H. NOT AMOUNTING TO MURDER,0,0,0,52,3,55,41,8,49,25,2,27,118,13,131
HARYANA,2002,RAPE,0,0,0,118,0,118,72,0,72,7,0,7,197,0,197
HARYANA,2002,KIDNAPPING AND ABDUCTION,0,0,0,25,3,28,25,2,27,26,0,26,76,5,81
HARYANA,2002,DACOITY,0,0,0,54,0,54,39,0,39,8,1,9,101,1,102
HARYANA,2002,PREP. AND ASSEMBLY FOR DACOITY,0,0,0,13,0,13,4,0,4,0,0,0,17,0,17
HARYANA,2002,ROBBERY,0,0,0,59,0,59,33,0,33,11,0,11,103,0,103
HARYANA,2002,BURGLARY,0,0,0,39,0,39,44,0,44,4,0,4,87,0,87
HARYANA,2002,THEFTS,0,0,0,35,0,35,13,0,13,4,0,4,52,0,52
HARYANA,2002,EXTORTION,0,0,0,2,0,2,0,0,0,0,0,0,2,0,2
HARYANA,2002,RIOTS,0,0,0,7,0,7,0,0,0,0,0,0,7,0,7
HARYANA,2002,ARSON,0,0,0,2,0,2,8,0,8,0,0,0,10,0,10
HARYANA,2002,CRIMINAL BREACH OF TRUST,0,0,0,1,0,1,9,0,9,0,0,0,10,0,10
HARYANA,2002,CHEATING,0,0,0,6,0,6,4,1,5,2,0,2,12,1,13
HARYANA,2002,COUNTER FEITING,0,0,0,1,0,1,0,0,0,0,0,0,1,0,1
HARYANA,2002,DOWRY DEATHS,0,0,0,67,3,70,27,18,45,13,12,25,107,33,140
HARYANA,2002,MOLESTATION,0,0,0,8,0,8,4,0,4,0,0,0,12,0,12
HARYANA,2002,EVE-TEASING,0,0,0,0,0,0,0,0,0,0,0,0,0,0,0
HARYANA,2002,CRUELTY BY HUSBAND OR RELATIVE OF HUSBAND,2,0,2,10,0,10,15,0,15,0,0,0,27,0,27
HARYANA,2002,OTHER IPC CRIMES,0,0,0,7,0,7,7,0,7,14,0,14,28,0,28
HARYANA,2002,TOTAL IPC,5,0,5,1247,19,1266,1172,70,1242,363,34,397,2787,123,2910
HARYANA,2003,MURDER,0,0,0,600,30,630,826,40,866,330,27,357,1756,97,1853
HARYANA,2003,ATTEMPT TO COMMIT MURDER,0,0,0,100,2,102,121,0,121,71,0,71,292,2,294
HARYANA,2003,C.H. NOT AMOUNTING TO MURDER,0,0,0,0,0,0,0,0,0,0,0,0,0,0,0
HARYANA,2003,RAPE,0,0,0,151,5,156,143,3,146,53,1,54,347,9,356
HARYANA,2003,KIDNAPPING AND ABDUCTION,0,0,0,47,0,47,44,0,44,5,0,5,96,0,96
HARYANA,2003,DACOITY,0,0,0,77,0,77,50,0,50,7,0,7,134,0,134
HARYANA,2003,PREP. AND ASSEMBLY FOR DACOITY,0,0,0,43,0,43,39,0,39,8,0,8,90,0,90
HARYANA,2003,ROBBERY,0,0,0,44,0,44,61,0,61,37,0,37,142,0,142
HARYANA,2003,BURGLARY,0,0,0,30,0,30,59,0,59,26,0,26,115,0,115
HARYANA,2003,THEFTS,0,0,0,40,0,40,19,0,19,6,0,6,65,0,65
HARYANA,2003,EXTORTION,0,0,0,0,0,0,0,0,0,0,0,0,0,0,0
HARYANA,2003,RIOTS,0,0,0,0,0,0,1,0,1,0,0,0,1,0,1
HARYANA,2003,ARSON,0,0,0,0,0,0,2,0,2,0,0,0,2,0,2
HARYANA,2003,CRIMINAL BREACH OF TRUST,0,0,0,0,0,0,5,0,5,2,0,2,7,0,7
HARYANA,2003,CHEATING,0,0,0,0,0,0,8,2,10,0,0,0,8,2,10
HARYANA,2003,COUNTER FEITING,0,0,0,0,0,0,0,0,0,0,0,0,0,0,0
HARYANA,2003,DOWRY DEATHS,0,0,0,108,20,128,98,9,107,73,9,82,279,38,317
HARYANA,2003,MOLESTATION,0,0,0,4,0,4,2,0,2,0,0,0,6,0,6
HARYANA,2003,EVE-TEASING,0,0,0,0,0,0,0,0,0,0,0,0,0,0,0
HARYANA,2003,CRUELTY BY HUSBAND OR RELATIVE OF HUSBAND,0,0,0,18,0,18,22,2,24,13,0,13,53,2,55
HARYANA,2003,OTHER IPC CRIMES,0,0,0,15,0,15,13,0,13,3,0,3,31,0,31
HARYANA,2003,TOTAL IPC,0,0,0,1277,57,1334,1513,56,1569,634,37,671,3424,150,3574
HARYANA,2004,MURDER,0,0,0,733,29,762,751,44,795,282,25,307,1766,98,1864
HARYANA,2004,ATTEMPT TO COMMIT MURDER,0,0,0,108,2,110,130,0,130,58,1,59,296,3,299
HARYANA,2004,C.H. NOT AMOUNTING TO MURDER,0,0,0,54,2,56,58,0,58,14,0,14,126,2,128
HARYANA,2004,RAPE,0,0,0,221,2,223,151,0,151,28,0,28,400,2,402
HARYANA,2004,KIDNAPPING AND ABDUCTION,0,0,0,38,1,39,26,0,26,5,0,5,69,1,70
HARYANA,2004,DACOITY,0,0,0,95,0,95,110,0,110,17,0,17,222,0,222
HARYANA,2004,PREP. AND ASSEMBLY FOR DACOITY,0,0,0,26,0,26,51,0,51,6,0,6,83,0,83
HARYANA,2004,ROBBERY,0,0,0,59,0,59,60,0,60,15,0,15,134,0,134
HARYANA,2004,BURGLARY,0,0,0,37,0,37,44,0,44,22,0,22,103,0,103
HARYANA,2004,THEFTS,0,0,0,31,0,31,28,0,28,4,0,4,63,0,63
HARYANA,2004,EXTORTION,0,0,0,1,0,1,0,0,0,0,0,0,1,0,1
HARYANA,2004,RIOTS,0,0,0,0,0,0,0,0,0,0,0,0,0,0,0
HARYANA,2004,ARSON,0,0,0,0,0,0,0,0,0,0,0,0,0,0,0
HARYANA,2004,CRIMINAL BREACH OF TRUST,0,0,0,0,0,0,0,0,0,0,0,0,0,0,0
HARYANA,2004,CHEATING,0,0,0,2,0,2,5,0,5,0,0,0,7,0,7
HARYANA,2004,COUNTER FEITING,0,0,0,4,0,4,11,0,11,0,0,0,15,0,15
HARYANA,2004,DOWRY DEATHS,0,0,0,107,13,120,142,23,165,103,19,122,352,55,407
HARYANA,2004,MOLESTATION,0,0,0,5,0,5,3,0,3,0,0,0,8,0,8
HARYANA,2004,EVE-TEASING,0,0,0,0,0,0,0,0,0,0,0,0,0,0,0
HARYANA,2004,CRUELTY BY HUSBAND OR RELATIVE OF HUSBAND,0,0,0,25,0,25,14,0,14,0,0,0,39,0,39
HARYANA,2004,OTHER IPC CRIMES,0,0,0,18,4,22,22,4,26,14,0,14,54,8,62
HARYANA,2004,TOTAL IPC,0,0,0,1564,53,1617,1606,71,1677,568,45,613,3738,169,3907
HARYANA,2005,MURDER,0,0,0,659,28,687,1004,26,1030,246,10,256,1909,64,1973
HARYANA,2005,ATTEMPT TO COMMIT MURDER,0,0,0,216,2,218,182,4,186,46,0,46,444,6,450
HARYANA,2005,C.H. NOT AMOUNTING TO MURDER,0,0,0,42,3,45,56,1,57,7,0,7,105,4,109
HARYANA,2005,RAPE,0,0,0,298,1,299,79,3,82,17,0,17,394,4,398
HARYANA,2005,KIDNAPPING AND ABDUCTION,0,0,0,97,0,97,36,0,36,9,0,9,142,0,142
HARYANA,2005,DACOITY,0,0,0,99,0,99,47,0,47,12,0,12,158,0,158
HARYANA,2005,PREP. AND ASSEMBLY FOR DACOITY,0,0,0,36,0,36,38,0,38,9,0,9,83,0,83
HARYANA,2005,ROBBERY,4,0,4,71,0,71,44,0,44,4,0,4,123,0,123
HARYANA,2005,BURGLARY,0,0,0,19,0,19,16,0,16,8,0,8,43,0,43
HARYANA,2005,THEFTS,4,0,4,23,0,23,10,0,10,0,0,0,37,0,37
HARYANA,2005,EXTORTION,0,0,0,6,0,6,2,0,2,0,0,0,8,0,8
HARYANA,2005,RIOTS,0,0,0,3,0,3,3,0,3,1,0,1,7,0,7
HARYANA,2005,ARSON,0,0,0,1,0,1,3,0,3,1,0,1,5,0,5
HARYANA,2005,CRIMINAL BREACH OF TRUST,0,0,0,3,0,3,1,0,1,1,0,1,5,0,5
HARYANA,2005,CHEATING,0,0,0,2,0,2,1,0,1,2,0,2,5,0,5
HARYANA,2005,COUNTER FEITING,0,0,0,7,0,7,3,0,3,0,0,0,10,0,10
HARYANA,2005,DOWRY DEATHS,0,0,0,102,22,124,89,22,111,33,27,60,224,71,295
HARYANA,2005,MOLESTATION,0,0,0,1,0,1,2,0,2,1,0,1,4,0,4
HARYANA,2005,EVE-TEASING,0,0,0,0,0,0,0,0,0,0,0,0,0,0,0
HARYANA,2005,CRUELTY BY HUSBAND OR RELATIVE OF HUSBAND,0,0,0,20,2,22,12,2,14,6,0,6,38,4,42
HARYANA,2005,OTHER IPC CRIMES,0,0,0,49,1,50,46,0,46,31,0,31,126,1,127
HARYANA,2005,TOTAL IPC,8,0,8,1754,59,1813,1674,58,1732,434,37,471,3870,154,4024
HARYANA,2006,MURDER,0,0,0,672,28,700,1047,52,1099,414,26,440,2133,106,2239
HARYANA,2006,ATTEMPT TO COMMIT MURDER,0,0,0,107,2,109,189,4,193,142,2,144,438,8,446
HARYANA,2006,C.H. NOT AMOUNTING TO MURDER,0,0,0,38,0,38,48,2,50,14,2,16,100,4,104
HARYANA,2006,RAPE,0,0,0,164,0,164,188,5,193,60,1,61,412,6,418
HARYANA,2006,KIDNAPPING AND ABDUCTION,0,0,0,47,1,48,52,4,56,22,0,22,121,5,126
HARYANA,2006,DACOITY,0,0,0,78,1,79,72,0,72,42,0,42,192,1,193
HARYANA,2006,PREP. AND ASSEMBLY FOR DACOITY,0,0,0,89,0,89,11,0,11,0,0,0,100,0,100
HARYANA,2006,ROBBERY,0,0,0,39,0,39,42,0,42,1,0,1,82,0,82
HARYANA,2006,BURGLARY,0,0,0,14,0,14,9,0,9,0,0,0,23,0,23
HARYANA,2006,THEFTS,0,0,0,29,0,29,19,3,22,1,0,1,49,3,52
HARYANA,2006,EXTORTION,0,0,0,4,0,4,5,0,5,0,0,0,9,0,9
HARYANA,2006,RIOTS,0,0,0,2,0,2,1,0,1,0,0,0,3,0,3
HARYANA,2006,ARSON,0,0,0,3,0,3,1,0,1,2,0,2,6,0,6
HARYANA,2006,CRIMINAL BREACH OF TRUST,0,0,0,4,0,4,2,0,2,0,0,0,6,0,6
HARYANA,2006,CHEATING,0,0,0,13,0,13,29,0,29,3,0,3,45,0,45
HARYANA,2006,COUNTER FEITING,0,0,0,5,0,5,5,0,5,0,0,0,10,0,10
HARYANA,2006,DOWRY DEATHS,0,0,0,109,10,119,111,22,133,51,10,61,271,42,313
HARYANA,2006,MOLESTATION,0,0,0,0,0,0,2,0,2,0,0,0,2,0,2
HARYANA,2006,EVE-TEASING,0,0,0,0,0,0,0,0,0,0,0,0,0,0,0
HARYANA,2006,CRUELTY BY HUSBAND OR RELATIVE OF HUSBAND,0,0,0,26,0,26,20,2,22,2,1,3,48,3,51
HARYANA,2006,OTHER IPC CRIMES,0,0,0,14,0,14,71,0,71,6,0,6,91,0,91
HARYANA,2006,TOTAL IPC,0,0,0,1457,42,1499,1924,94,2018,760,42,802,4141,178,4319
HARYANA,2007,MURDER,0,0,0,672,28,700,1047,52,1099,414,26,440,2133,106,2239
HARYANA,2007,ATTEMPT TO COMMIT MURDER,0,0,0,107,2,109,189,4,193,142,2,144,438,8,446
HARYANA,2007,C.H. NOT AMOUNTING TO MURDER,0,0,0,38,0,38,48,2,50,14,2,16,100,4,104
HARYANA,2007,RAPE,0,0,0,164,0,164,188,5,193,60,1,61,412,6,418
HARYANA,2007,KIDNAPPING AND ABDUCTION,0,0,0,47,1,48,52,4,56,22,0,22,121,5,126
HARYANA,2007,DACOITY,0,0,0,78,1,79,72,0,72,42,0,42,192,1,193
HARYANA,2007,PREP. AND ASSEMBLY FOR DACOITY,0,0,0,89,0,89,11,0,11,0,0,0,100,0,100
HARYANA,2007,ROBBERY,0,0,0,39,0,39,42,0,42,1,0,1,82,0,82
HARYANA,2007,BURGLARY,0,0,0,14,0,14,9,0,9,0,0,0,23,0,23
HARYANA,2007,THEFTS,0,0,0,29,0,29,19,3,22,1,0,1,49,3,52
HARYANA,2007,EXTORTION,0,0,0,4,0,4,5,0,5,0,0,0,9,0,9
HARYANA,2007,RIOTS,0,0,0,2,0,2,1,0,1,0,0,0,3,0,3
HARYANA,2007,ARSON,0,0,0,3,0,3,1,0,1,2,0,2,6,0,6
HARYANA,2007,CRIMINAL BREACH OF TRUST,0,0,0,4,0,4,2,0,2,0,0,0,6,0,6
HARYANA,2007,CHEATING,0,0,0,13,0,13,29,0,29,3,0,3,45,0,45
HARYANA,2007,COUNTER FEITING,0,0,0,5,0,5,5,0,5,0,0,0,10,0,10
HARYANA,2007,DOWRY DEATHS,0,0,0,109,10,119,111,22,133,51,10,61,271,42,313
HARYANA,2007,MOLESTATION,0,0,0,0,0,0,2,0,2,0,0,0,2,0,2
HARYANA,2007,EVE-TEASING,0,0,0,0,0,0,0,0,0,0,0,0,0,0,0
HARYANA,2007,CRUELTY BY HUSBAND OR RELATIVE OF HUSBAND,0,0,0,26,0,26,20,2,22,2,1,3,48,3,51
HARYANA,2007,OTHER IPC CRIMES,0,0,0,14,0,14,71,0,71,6,0,6,91,0,91
HARYANA,2007,TOTAL IPC,0,0,0,1457,42,1499,1924,94,2018,760,42,802,4141,178,4319
HARYANA,2008,MURDER,0,0,0,746,33,779,1243,77,1320,429,23,452,2418,133,2551
HARYANA,2008,ATTEMPT TO COMMIT MURDER,0,0,0,103,1,104,114,3,117,43,0,43,260,4,264
HARYANA,2008,C.H. NOT AMOUNTING TO MURDER,0,0,0,37,1,38,52,1,53,17,1,18,106,3,109
HARYANA,2008,RAPE,0,0,0,194,4,198,194,8,202,50,0,50,438,12,450
HARYANA,2008,KIDNAPPING AND ABDUCTION,0,0,0,48,1,49,62,2,64,5,0,5,115,3,118
HARYANA,2008,DACOITY,0,0,0,84,0,84,98,0,98,7,0,7,189,0,189
HARYANA,2008,PREP. AND ASSEMBLY FOR DACOITY,0,0,0,45,0,45,44,0,44,1,0,1,90,0,90
HARYANA,2008,ROBBERY,0,0,0,69,0,69,58,0,58,4,0,4,131,0,131
HARYANA,2008,BURGLARY,0,0,0,29,0,29,26,0,26,3,0,3,58,0,58
HARYANA,2008,THEFTS,0,0,0,33,0,33,47,1,48,3,0,3,83,1,84
HARYANA,2008,EXTORTION,0,0,0,8,0,8,2,0,2,0,0,0,10,0,10
HARYANA,2008,RIOTS,0,0,0,12,0,12,7,0,7,5,0,5,24,0,24
HARYANA,2008,ARSON,0,0,0,5,0,5,2,0,2,1,0,1,8,0,8
HARYANA,2008,CRIMINAL BREACH OF TRUST,0,0,0,3,0,3,5,0,5,0,0,0,8,0,8
HARYANA,2008,CHEATING,0,0,0,2,0,2,16,0,16,5,0,5,23,0,23
HARYANA,2008,COUNTER FEITING,0,0,0,10,0,10,12,0,12,3,0,3,25,0,25
HARYANA,2008,DOWRY DEATHS,0,0,0,94,9,103,93,17,110,61,34,95,248,60,308
HARYANA,2008,MOLESTATION,0,0,0,0,1,1,8,0,8,1,0,1,9,1,10
HARYANA,2008,EVE-TEASING,0,0,0,0,0,0,0,0,0,0,0,0,0,0,0
HARYANA,2008,CRUELTY BY HUSBAND OR RELATIVE OF HUSBAND,0,0,0,13,0,13,20,0,20,1,2,3,34,2,36
HARYANA,2008,OTHER IPC CRIMES,0,0,0,33,3,36,35,1,36,18,3,21,86,7,93
HARYANA,2008,TOTAL IPC,0,0,0,1568,53,1621,2138,110,2248,657,63,720,4363,226,4589
HARYANA,2009,MURDER,0,0,0,883,28,911,1301,45,1346,481,54,535,2665,127,2792
HARYANA,2009,ATTEMPT TO COMMIT MURDER,0,0,0,157,1,158,131,2,133,44,2,46,332,5,337
HARYANA,2009,C.H. NOT AMOUNTING TO MURDER,0,0,0,64,0,64,62,0,62,25,0,25,151,0,151
HARYANA,2009,RAPE,0,0,0,236,3,239,161,1,162,41,0,41,438,4,442
HARYANA,2009,KIDNAPPING AND ABDUCTION,0,0,0,71,13,84,45,4,49,22,5,27,138,22,160
HARYANA,2009,DACOITY,0,0,0,146,0,146,86,0,86,12,0,12,244,0,244
HARYANA,2009,PREP. AND ASSEMBLY FOR DACOITY,0,0,0,38,0,38,42,0,42,1,0,1,81,0,81
HARYANA,2009,ROBBERY,0,0,0,74,0,74,50,0,50,20,0,20,144,0,144
HARYANA,2009,BURGLARY,0,0,0,30,0,30,28,0,28,0,0,0,58,0,58
HARYANA,2009,THEFTS,0,0,0,20,1,21,21,0,21,1,0,1,42,1,43
HARYANA,2009,EXTORTION,0,0,0,4,0,4,2,0,2,0,0,0,6,0,6
HARYANA,2009,RIOTS,0,0,0,3,0,3,3,0,3,1,0,1,7,0,7
HARYANA,2009,ARSON,0,0,0,5,0,5,2,0,2,1,0,1,8,0,8
HARYANA,2009,CRIMINAL BREACH OF TRUST,0,0,0,6,0,6,7,0,7,0,0,0,13,0,13
HARYANA,2009,CHEATING,0,0,0,0,0,0,5,0,5,1,0,1,6,0,6
HARYANA,2009,COUNTER FEITING,0,0,0,11,0,11,13,1,14,1,0,1,25,1,26
HARYANA,2009,DOWRY DEATHS,0,0,0,121,12,133,138,27,165,81,27,108,340,66,406
HARYANA,2009,MOLESTATION,0,0,0,1,0,1,1,0,1,1,0,1,3,0,3
HARYANA,2009,EVE-TEASING,0,0,0,0,0,0,0,0,0,0,0,0,0,0,0
HARYANA,2009,CRUELTY BY HUSBAND OR RELATIVE OF HUSBAND,0,0,0,15,0,15,20,9,29,1,0,1,36,9,45
HARYANA,2009,OTHER IPC CRIMES,0,0,0,17,0,17,16,0,16,5,0,5,38,0,38
HARYANA,2009,TOTAL IPC,0,0,0,1902,58,1960,2134,89,2223,739,88,827,4775,235,5010
HARYANA,2010,MURDER,0,0,0,1163,25,1188,1107,46,1153,370,38,408,2640,109,2749
HARYANA,2010,ATTEMPT TO COMMIT MURDER,0,0,0,169,0,169,176,5,181,63,0,63,408,5,413
HARYANA,2010,C.H. NOT AMOUNTING TO MURDER,0,0,0,34,0,34,54,1,55,21,2,23,109,3,112
HARYANA,2010,RAPE,0,0,0,314,1,315,185,3,188,22,0,22,521,4,525
HARYANA,2010,KIDNAPPING AND ABDUCTION,0,0,0,133,3,136,82,7,89,9,1,10,224,11,235
HARYANA,2010,DACOITY,0,0,0,229,0,229,79,0,79,6,0,6,314,0,314
HARYANA,2010,PREP. AND ASSEMBLY FOR DACOITY,0,0,0,42,0,42,26,0,26,1,0,1,69,0,69
HARYANA,2010,ROBBERY,0,0,0,100,0,100,61,0,61,0,0,0,161,0,161
HARYANA,2010,BURGLARY,0,0,0,19,0,19,17,0,17,7,0,7,43,0,43
HARYANA,2010,THEFTS,0,0,0,20,0,20,19,0,19,3,0,3,42,0,42
HARYANA,2010,EXTORTION,0,0,0,3,0,3,2,0,2,0,0,0,5,0,5
HARYANA,2010,RIOTS,0,0,0,2,0,2,0,0,0,0,0,0,2,0,2
HARYANA,2010,ARSON,0,0,0,0,0,0,1,0,1,0,0,0,1,0,1
HARYANA,2010,CRIMINAL BREACH OF TRUST,0,0,0,0,0,0,6,1,7,3,0,3,9,1,10
HARYANA,2010,CHEATING,0,0,0,1,0,1,7,0,7,2,0,2,10,0,10
HARYANA,2010,COUNTER FEITING,0,0,0,10,0,10,9,1,10,1,0,1,20,1,21
HARYANA,2010,DOWRY DEATHS,0,0,0,175,2,177,154,30,184,100,43,143,429,75,504
HARYANA,2010,MOLESTATION,0,0,0,9,0,9,4,0,4,0,0,0,13,0,13
HARYANA,2010,EVE-TEASING,0,0,0,0,0,0,0,0,0,0,0,0,0,0,0
HARYANA,2010,CRUELTY BY HUSBAND OR RELATIVE OF HUSBAND,0,0,0,14,0,14,10,3,13,6,9,15,30,12,42
HARYANA,2010,OTHER IPC CRIMES,0,0,0,0,0,0,169,1,170,28,2,30,197,3,200
HARYANA,2010,TOTAL IPC,0,0,0,2437,31,2468,2168,98,2266,642,95,737,5247,224,5471
HARYANA,2011,MURDER,0,0,0,1188,31,1219,1286,59,1345,376,43,419,2850,133,2983
HARYANA,2011,ATTEMPT TO COMMIT MURDER,0,0,0,143,5,148,200,1,201,60,2,62,403,8,411
HARYANA,2011,C.H. NOT AMOUNTING TO MURDER,0,0,0,74,2,76,106,4,110,59,4,63,239,10,249
HARYANA,2011,RAPE,0,0,0,292,0,292,195,1,196,34,0,34,521,1,522
HARYANA,2011,KIDNAPPING AND ABDUCTION,0,0,0,141,5,146,98,6,104,27,1,28,266,12,278
HARYANA,2011,DACOITY,0,0,0,173,0,173,83,2,85,16,0,16,272,2,274
HARYANA,2011,PREP. AND ASSEMBLY FOR DACOITY,0,0,0,76,0,76,43,0,43,0,0,0,119,0,119
HARYANA,2011,ROBBERY,0,0,0,108,0,108,66,0,66,3,0,3,177,0,177
HARYANA,2011,BURGLARY,0,0,0,21,0,21,18,0,18,4,0,4,43,0,43
HARYANA,2011,THEFTS,0,0,0,15,0,15,11,0,11,2,1,3,28,1,29
HARYANA,2011,EXTORTION,0,0,0,4,0,4,1,0,1,0,0,0,5,0,5
HARYANA,2011,RIOTS,0,0,0,6,0,6,2,0,2,0,0,0,8,0,8
HARYANA,2011,ARSON,0,0,0,1,0,1,1,0,1,0,0,0,2,0,2
HARYANA,2011,CRIMINAL BREACH OF TRUST,0,0,0,6,0,6,5,0,5,0,0,0,11,0,11
HARYANA,2011,CHEATING,0,0,0,6,0,6,7,0,7,1,1,2,14,1,15
HARYANA,2011,COUNTER FEITING,0,0,0,5,0,5,8,1,9,1,1,2,14,2,16
HARYANA,2011,DOWRY DEATHS,0,0,0,143,5,148,121,37,158,39,44,83,303,86,389
HARYANA,2011,MOLESTATION,0,0,0,9,0,9,5,0,5,3,0,3,17,0,17
HARYANA,2011,EVE-TEASING,0,0,0,1,0,1,1,1,2,0,0,0,2,1,3
HARYANA,2011,CRUELTY BY HUSBAND OR RELATIVE OF HUSBAND,0,0,0,11,0,11,15,0,15,8,1,9,34,1,35
HARYANA,2011,OTHER IPC CRIMES,0,0,0,55,0,55,112,2,114,46,1,47,213,3,216
HARYANA,2011,TOTAL IPC,0,0,0,2478,48,2526,2384,114,2498,679,99,778,5541,261,5802
HARYANA,2012,MURDER,0,0,0,1082,39,1121,1394,71,1465,358,39,397,2834,149,2983
HARYANA,2012,ATTEMPT TO COMMIT MURDER,0,0,0,144,0,144,210,0,210,65,0,65,419,0,419
HARYANA,2012,C.H. NOT AMOUNTING TO MURDER,0,0,0,63,0,63,62,6,68,37,2,39,162,8,170
HARYANA,2012,RAPE,0,0,0,244,1,245,214,3,217,40,0,40,498,4,502
HARYANA,2012,KIDNAPPING AND ABDUCTION,0,0,0,128,5,133,85,5,90,29,1,30,242,11,253
HARYANA,2012,DACOITY,0,0,0,233,0,233,153,0,153,12,0,12,398,0,398
HARYANA,2012,PREP. AND ASSEMBLY FOR DACOITY,0,0,0,20,0,20,22,0,22,0,0,0,42,0,42
HARYANA,2012,ROBBERY,0,0,0,110,0,110,49,0,49,2,0,2,161,0,161
HARYANA,2012,BURGLARY,0,0,0,19,0,19,28,0,28,4,0,4,51,0,51
HARYANA,2012,THEFTS,0,0,0,30,0,30,22,1,23,0,1,1,52,2,54
HARYANA,2012,EXTORTION,0,0,0,1,0,1,6,0,6,0,0,0,7,0,7
HARYANA,2012,RIOTS,0,0,0,25,1,26,16,0,16,9,0,9,50,1,51
HARYANA,2012,ARSON,0,0,0,2,0,2,1,0,1,1,0,1,4,0,4
HARYANA,2012,CRIMINAL BREACH OF TRUST,0,0,0,0,0,0,7,0,7,3,0,3,10,0,10
HARYANA,2012,CHEATING,0,0,0,2,0,2,15,0,15,6,0,6,23,0,23
HARYANA,2012,COUNTER FEITING,0,0,0,2,0,2,5,1,6,1,0,1,8,1,9
HARYANA,2012,DOWRY DEATHS,0,0,0,143,3,146,149,33,182,63,42,105,355,78,433
HARYANA,2012,MOLESTATION,0,0,0,3,0,3,6,0,6,0,0,0,9,0,9
HARYANA,2012,EVE-TEASING,0,0,0,0,0,0,0,0,0,0,0,0,0,0,0
HARYANA,2012,CRUELTY BY HUSBAND OR RELATIVE OF HUSBAND,0,0,0,11,1,12,24,1,25,2,3,5,37,5,42
HARYANA,2012,OTHER IPC CRIMES,0,0,0,152,2,154,181,4,185,64,0,64,397,6,403
HARYANA,2012,TOTAL IPC,0,0,0,2414,52,2466,2649,125,2774,696,88,784,5759,265,6024
HIMACHAL PRADESH,2001,MURDER,0,0,0,34,1,35,29,2,31,26,0,26,89,3,92
HIMACHAL PRADESH,2001,ATTEMPT TO COMMIT MURDER,4,0,4,31,1,32,61,1,62,19,1,20,115,3,118
HIMACHAL PRADESH,2001,C.H. NOT AMOUNTING TO MURDER,3,0,3,20,2,22,35,1,36,11,1,12,69,4,73
HIMACHAL PRADESH,2001,RAPE,0,0,0,21,0,21,11,0,11,4,0,4,36,0,36
HIMACHAL PRADESH,2001,KIDNAPPING AND ABDUCTION,0,0,0,0,0,0,0,0,0,0,0,0,0,0,0
HIMACHAL PRADESH,2001,DACOITY,0,0,0,9,0,9,6,0,6,3,0,3,18,0,18
HIMACHAL PRADESH,2001,PREP. AND ASSEMBLY FOR DACOITY,0,0,0,0,0,0,0,0,0,0,0,0,0,0,0
HIMACHAL PRADESH,2001,ROBBERY,0,0,0,0,0,0,0,0,0,0,0,0,0,0,0
HIMACHAL PRADESH,2001,BURGLARY,0,0,0,7,0,7,15,0,15,3,0,3,25,0,25
HIMACHAL PRADESH,2001,THEFTS,0,0,0,0,0,0,0,0,0,0,0,0,0,0,0
HIMACHAL PRADESH,2001,EXTORTION,0,0,0,0,0,0,0,0,0,0,0,0,0,0,0
HIMACHAL PRADESH,2001,RIOTS,0,0,0,0,0,0,0,0,0,0,0,0,0,0,0
HIMACHAL PRADESH,2001,ARSON,0,0,0,0,0,0,0,0,0,0,0,0,0,0,0
HIMACHAL PRADESH,2001,CRIMINAL BREACH OF TRUST,0,0,0,0,0,0,0,0,0,0,0,0,0,0,0
HIMACHAL PRADESH,2001,CHEATING,0,0,0,6,0,6,5,1,6,0,0,0,11,1,12
HIMACHAL PRADESH,2001,COUNTER FEITING,0,0,0,0,0,0,0,0,0,0,0,0,0,0,0
HIMACHAL PRADESH,2001,DOWRY DEATHS,0,0,0,0,0,0,0,0,0,0,0,0,0,0,0
HIMACHAL PRADESH,2001,MOLESTATION,0,0,0,0,0,0,0,0,0,0,0,0,0,0,0
HIMACHAL PRADESH,2001,EVE-TEASING,0,0,0,0,0,0,0,0,0,0,0,0,0,0,0
HIMACHAL PRADESH,2001,CRUELTY BY HUSBAND OR RELATIVE OF HUSBAND,0,0,0,0,0,0,0,0,0,0,0,0,0,0,0
HIMACHAL PRADESH,2001,OTHER IPC CRIMES,0,0,0,0,0,0,0,0,0,0,0,0,0,0,0
HIMACHAL PRADESH,2001,TOTAL IPC,7,0,7,128,4,132,162,5,167,66,2,68,363,11,374
HIMACHAL PRADESH,2002,MURDER,0,0,0,61,2,63,106,3,109,14,0,14,181,5,186
HIMACHAL PRADESH,2002,ATTEMPT TO COMMIT MURDER,0,0,0,1,0,1,7,0,7,8,0,8,16,0,16
HIMACHAL PRADESH,2002,C.H. NOT AMOUNTING TO MURDER,0,0,0,2,0,2,8,0,8,15,0,15,25,0,25
HIMACHAL PRADESH,2002,RAPE,0,0,0,41,0,41,24,0,24,0,0,0,65,0,65
HIMACHAL PRADESH,2002,KIDNAPPING AND ABDUCTION,0,0,0,2,0,2,2,0,2,0,0,0,4,0,4
HIMACHAL PRADESH,2002,DACOITY,0,0,0,0,0,0,0,0,0,0,0,0,0,0,0
HIMACHAL PRADESH,2002,PREP. AND ASSEMBLY FOR DACOITY,0,0,0,0,0,0,0,0,0,0,0,0,0,0,0
HIMACHAL PRADESH,2002,ROBBERY,0,0,0,1,0,1,0,0,0,0,0,0,1,0,1
HIMACHAL PRADESH,2002,BURGLARY,0,0,0,1,0,1,0,0,0,0,0,0,1,0,1
HIMACHAL PRADESH,2002,THEFTS,0,0,0,7,0,7,0,0,0,0,0,0,7,0,7
HIMACHAL PRADESH,2002,EXTORTION,0,0,0,0,0,0,0,0,0,0,0,0,0,0,0
HIMACHAL PRADESH,2002,RIOTS,0,0,0,0,0,0,0,0,0,0,0,0,0,0,0
HIMACHAL PRADESH,2002,ARSON,0,0,0,0,0,0,0,0,0,0,0,0,0,0,0
HIMACHAL PRADESH,2002,CRIMINAL BREACH OF TRUST,0,0,0,0,0,0,0,0,0,0,0,0,0,0,0
HIMACHAL PRADESH,2002,CHEATING,0,0,0,0,0,0,0,0,0,0,0,0,0,0,0
HIMACHAL PRADESH,2002,COUNTER FEITING,0,0,0,0,0,0,0,0,0,0,0,0,0,0,0
HIMACHAL PRADESH,2002,DOWRY DEATHS,0,0,0,1,0,1,5,0,5,0,0,0,6,0,6
HIMACHAL PRADESH,2002,MOLESTATION,0,0,0,0,0,0,0,0,0,1,0,1,1,0,1
HIMACHAL PRADESH,2002,EVE-TEASING,0,0,0,0,0,0,0,0,0,0,0,0,0,0,0
HIMACHAL PRADESH,2002,CRUELTY BY HUSBAND OR RELATIVE OF HUSBAND,0,0,0,0,0,0,0,0,0,0,0,0,0,0,0
HIMACHAL PRADESH,2002,OTHER IPC CRIMES,0,0,0,0,0,0,2,0,2,0,0,0,2,0,2
HIMACHAL PRADESH,2002,TOTAL IPC,0,0,0,117,2,119,154,3,157,38,0,38,309,5,314
HIMACHAL PRADESH,2003,MURDER,0,0,0,47,0,47,113,4,117,30,2,32,190,6,196
HIMACHAL PRADESH,2003,ATTEMPT TO COMMIT MURDER,0,0,0,0,0,0,7,0,7,1,0,1,8,0,8
HIMACHAL PRADESH,2003,C.H. NOT AMOUNTING TO MURDER,0,0,0,9,0,9,9,0,9,2,0,2,20,0,20
HIMACHAL PRADESH,2003,RAPE,0,0,0,53,0,53,43,0,43,0,0,0,96,0,96
HIMACHAL PRADESH,2003,KIDNAPPING AND ABDUCTION,0,0,0,0,0,0,0,0,0,0,0,0,0,0,0
HIMACHAL PRADESH,2003,DACOITY,0,0,0,0,0,0,0,0,0,0,0,0,0,0,0
HIMACHAL PRADESH,2003,PREP. AND ASSEMBLY FOR DACOITY,0,0,0,0,0,0,0,0,0,0,0,0,0,0,0
HIMACHAL PRADESH,2003,ROBBERY,1,0,1,0,0,0,0,0,0,0,0,0,1,0,1
HIMACHAL PRADESH,2003,BURGLARY,0,0,0,0,0,0,0,0,0,0,0,0,0,0,0
HIMACHAL PRADESH,2003,THEFTS,0,0,0,2,0,2,3,0,3,0,0,0,5,0,5
HIMACHAL PRADESH,2003,EXTORTION,0,0,0,0,0,0,0,0,0,0,0,0,0,0,0
HIMACHAL PRADESH,2003,RIOTS,0,0,0,0,0,0,0,0,0,0,0,0,0,0,0
HIMACHAL PRADESH,2003,ARSON,0,0,0,0,0,0,0,0,0,0,0,0,0,0,0
HIMACHAL PRADESH,2003,CRIMINAL BREACH OF TRUST,0,0,0,0,0,0,1,0,1,0,0,0,1,0,1
HIMACHAL PRADESH,2003,CHEATING,0,0,0,0,0,0,0,0,0,0,0,0,0,0,0
HIMACHAL PRADESH,2003,COUNTER FEITING,0,0,0,0,0,0,0,0,0,0,0,0,0,0,0
HIMACHAL PRADESH,2003,DOWRY DEATHS,1,0,1,0,0,0,0,0,0,0,0,0,1,0,1
HIMACHAL PRADESH,2003,MOLESTATION,0,0,0,0,0,0,0,0,0,0,0,0,0,0,0
HIMACHAL PRADESH,2003,EVE-TEASING,0,0,0,0,0,0,0,0,0,0,0,0,0,0,0
HIMACHAL PRADESH,2003,CRUELTY BY HUSBAND OR RELATIVE OF HUSBAND,0,0,0,1,0,1,2,0,2,0,0,0,3,0,3
HIMACHAL PRADESH,2003,OTHER IPC CRIMES,0,0,0,14,0,14,11,0,11,1,0,1,26,0,26
HIMACHAL PRADESH,2003,TOTAL IPC,2,0,2,126,0,126,189,4,193,34,2,36,351,6,357
HIMACHAL PRADESH,2004,MURDER,0,0,0,60,1,61,118,6,124,36,3,39,214,10,224
HIMACHAL PRADESH,2004,ATTEMPT TO COMMIT MURDER,0,0,0,13,0,13,5,0,5,3,0,3,21,0,21
HIMACHAL PRADESH,2004,C.H. NOT AMOUNTING TO MURDER,0,0,0,11,0,11,5,0,5,3,0,3,19,0,19
HIMACHAL PRADESH,2004,RAPE,0,0,0,39,0,39,47,0,47,4,0,4,90,0,90
HIMACHAL PRADESH,2004,KIDNAPPING AND ABDUCTION,0,0,0,2,0,2,0,0,0,0,0,0,2,0,2
HIMACHAL PRADESH,2004,DACOITY,0,0,0,1,0,1,0,0,0,0,0,0,1,0,1
HIMACHAL PRADESH,2004,PREP. AND ASSEMBLY FOR DACOITY,0,0,0,0,0,0,0,0,0,0,0,0,0,0,0
HIMACHAL PRADESH,2004,ROBBERY,0,0,0,2,0,2,1,0,1,0,0,0,3,0,3
HIMACHAL PRADESH,2004,BURGLARY,0,0,0,2,0,2,0,0,0,0,0,0,2,0,2
HIMACHAL PRADESH,2004,THEFTS,0,0,0,3,0,3,4,0,4,1,0,1,8,0,8
HIMACHAL PRADESH,2004,EXTORTION,0,0,0,0,0,0,0,0,0,0,0,0,0,0,0
HIMACHAL PRADESH,2004,RIOTS,0,0,0,0,0,0,0,0,0,0,0,0,0,0,0
HIMACHAL PRADESH,2004,ARSON,0,0,0,0,0,0,0,0,0,0,0,0,0,0,0
HIMACHAL PRADESH,2004,CRIMINAL BREACH OF TRUST,0,0,0,0,0,0,1,0,1,0,0,0,1,0,1
HIMACHAL PRADESH,2004,CHEATING,0,0,0,0,0,0,1,0,1,0,0,0,1,0,1
HIMACHAL PRADESH,2004,COUNTER FEITING,0,0,0,0,0,0,0,0,0,0,0,0,0,0,0
HIMACHAL PRADESH,2004,DOWRY DEATHS,0,0,0,3,0,3,0,0,0,0,0,0,3,0,3
HIMACHAL PRADESH,2004,MOLESTATION,0,0,0,0,0,0,0,0,0,0,0,0,0,0,0
HIMACHAL PRADESH,2004,EVE-TEASING,0,0,0,0,0,0,0,0,0,0,0,0,0,0,0
HIMACHAL PRADESH,2004,CRUELTY BY HUSBAND OR RELATIVE OF HUSBAND,0,0,0,0,0,0,1,0,1,0,0,0,1,0,1
HIMACHAL PRADESH,2004,OTHER IPC CRIMES,0,0,0,2,0,2,3,0,3,0,0,0,5,0,5
HIMACHAL PRADESH,2004,TOTAL IPC,0,0,0,138,1,139,186,6,192,47,3,50,371,10,381
HIMACHAL PRADESH,2005,MURDER,0,0,0,61,0,61,132,2,134,52,3,55,245,5,250
HIMACHAL PRADESH,2005,ATTEMPT TO COMMIT MURDER,0,0,0,12,0,12,2,0,2,6,0,6,20,0,20
HIMACHAL PRADESH,2005,C.H. NOT AMOUNTING TO MURDER,0,0,0,8,0,8,7,0,7,0,0,0,15,0,15
HIMACHAL PRADESH,2005,RAPE,0,0,0,49,0,49,35,1,36,8,0,8,92,1,93
HIMACHAL PRADESH,2005,KIDNAPPING AND ABDUCTION,0,0,0,3,0,3,3,0,3,0,0,0,6,0,6
HIMACHAL PRADESH,2005,DACOITY,0,0,0,0,0,0,0,0,0,0,0,0,0,0,0
HIMACHAL PRADESH,2005,PREP. AND ASSEMBLY FOR DACOITY,0,0,0,2,0,2,6,0,6,0,0,0,8,0,8
HIMACHAL PRADESH,2005,ROBBERY,0,0,0,0,0,0,0,0,0,0,0,0,0,0,0
HIMACHAL PRADESH,2005,BURGLARY,0,0,0,5,0,5,3,0,3,0,0,0,8,0,8
HIMACHAL PRADESH,2005,THEFTS,0,0,0,11,0,11,2,0,2,0,0,0,13,0,13
HIMACHAL PRADESH,2005,EXTORTION,0,0,0,0,0,0,0,0,0,0,0,0,0,0,0
HIMACHAL PRADESH,2005,RIOTS,0,0,0,0,0,0,0,0,0,0,0,0,0,0,0
HIMACHAL PRADESH,2005,ARSON,0,0,0,0,0,0,0,0,0,0,0,0,0,0,0
HIMACHAL PRADESH,2005,CRIMINAL BREACH OF TRUST,0,0,0,0,0,0,3,0,3,0,0,0,3,0,3
HIMACHAL PRADESH,2005,CHEATING,0,0,0,0,0,0,0,0,0,0,0,0,0,0,0
HIMACHAL PRADESH,2005,COUNTER FEITING,0,0,0,0,0,0,0,0,0,0,0,0,0,0,0
HIMACHAL PRADESH,2005,DOWRY DEATHS,0,0,0,1,0,1,2,0,2,0,0,0,3,0,3
HIMACHAL PRADESH,2005,MOLESTATION,0,0,0,0,0,0,0,0,0,0,0,0,0,0,0
HIMACHAL PRADESH,2005,EVE-TEASING,0,0,0,0,0,0,0,0,0,0,0,0,0,0,0
HIMACHAL PRADESH,2005,CRUELTY BY HUSBAND OR RELATIVE OF HUSBAND,0,0,0,0,0,0,1,0,1,0,0,0,1,0,1
HIMACHAL PRADESH,2005,OTHER IPC CRIMES,0,0,0,1,0,1,0,0,0,0,0,0,1,0,1
HIMACHAL PRADESH,2005,TOTAL IPC,0,0,0,153,0,153,196,3,199,66,3,69,415,6,421
HIMACHAL PRADESH,2006,MURDER,0,0,0,95,0,95,146,9,155,41,3,44,282,12,294
HIMACHAL PRADESH,2006,ATTEMPT TO COMMIT MURDER,0,0,0,19,0,19,8,0,8,4,0,4,31,0,31
HIMACHAL PRADESH,2006,C.H. NOT AMOUNTING TO MURDER,0,0,0,4,0,4,6,0,6,0,0,0,10,0,10
HIMACHAL PRADESH,2006,RAPE,0,0,0,75,0,75,40,1,41,7,0,7,122,1,123
HIMACHAL PRADESH,2006,KIDNAPPING AND ABDUCTION,0,0,0,3,0,3,1,0,1,1,0,1,5,0,5
HIMACHAL PRADESH,2006,DACOITY,0,0,0,10,0,10,3,0,3,0,0,0,13,0,13
HIMACHAL PRADESH,2006,PREP. AND ASSEMBLY FOR DACOITY,0,0,0,0,0,0,1,0,1,0,0,0,1,0,1
HIMACHAL PRADESH,2006,ROBBERY,0,0,0,3,0,3,0,0,0,0,0,0,3,0,3
HIMACHAL PRADESH,2006,BURGLARY,0,0,0,2,0,2,0,0,0,0,0,0,2,0,2
HIMACHAL PRADESH,2006,THEFTS,0,0,0,5,0,5,7,0,7,0,0,0,12,0,12
HIMACHAL PRADESH,2006,EXTORTION,0,0,0,0,0,0,0,0,0,0,0,0,0,0,0
HIMACHAL PRADESH,2006,RIOTS,0,0,0,0,0,0,0,0,0,0,0,0,0,0,0
HIMACHAL PRADESH,2006,ARSON,0,0,0,0,0,0,0,0,0,0,0,0,0,0,0
HIMACHAL PRADESH,2006,CRIMINAL BREACH OF TRUST,0,0,0,0,0,0,0,0,0,0,0,0,0,0,0
HIMACHAL PRADESH,2006,CHEATING,0,0,0,1,0,1,1,0,1,0,0,0,2,0,2
HIMACHAL PRADESH,2006,COUNTER FEITING,0,0,0,0,0,0,0,0,0,0,0,0,0,0,0
HIMACHAL PRADESH,2006,DOWRY DEATHS,0,0,0,2,0,2,3,0,3,2,1,3,7,1,8
HIMACHAL PRADESH,2006,MOLESTATION,0,0,0,0,0,0,0,0,0,0,0,0,0,0,0
HIMACHAL PRADESH,2006,EVE-TEASING,0,0,0,0,0,0,0,0,0,0,0,0,0,0,0
HIMACHAL PRADESH,2006,CRUELTY BY HUSBAND OR RELATIVE OF HUSBAND,0,0,0,0,0,0,0,0,0,1,0,1,1,0,1
HIMACHAL PRADESH,2006,OTHER IPC CRIMES,0,0,0,4,0,4,6,0,6,0,0,0,10,0,10
HIMACHAL PRADESH,2006,TOTAL IPC,0,0,0,223,0,223,222,10,232,56,4,60,501,14,515
HIMACHAL PRADESH,2007,MURDER,0,0,0,98,5,103,176,10,186,34,2,36,308,17,325
HIMACHAL PRADESH,2007,ATTEMPT TO COMMIT MURDER,0,0,0,6,0,6,26,2,28,6,0,6,38,2,40
HIMACHAL PRADESH,2007,C.H. NOT AMOUNTING TO MURDER,0,0,0,2,0,2,13,0,13,3,2,5,18,2,20
HIMACHAL PRADESH,2007,RAPE,0,0,0,105,0,105,68,1,69,14,0,14,187,1,188
HIMACHAL PRADESH,2007,KIDNAPPING AND ABDUCTION,0,0,0,9,0,9,2,0,2,0,0,0,11,0,11
HIMACHAL PRADESH,2007,DACOITY,0,0,0,8,0,8,9,0,9,0,0,0,17,0,17
HIMACHAL PRADESH,2007,PREP. AND ASSEMBLY FOR DACOITY,0,0,0,0,0,0,0,0,0,0,0,0,0,0,0
HIMACHAL PRADESH,2007,ROBBERY,0,0,0,2,0,2,0,0,0,0,0,0,2,0,2
HIMACHAL PRADESH,2007,BURGLARY,0,0,0,0,0,0,0,0,0,0,0,0,0,0,0
HIMACHAL PRADESH,2007,THEFTS,0,0,0,12,0,12,8,0,8,0,0,0,20,0,20
HIMACHAL PRADESH,2007,EXTORTION,0,0,0,0,0,0,0,0,0,0,0,0,0,0,0
HIMACHAL PRADESH,2007,RIOTS,0,0,0,0,0,0,0,0,0,0,0,0,0,0,0
HIMACHAL PRADESH,2007,ARSON,0,0,0,0,0,0,0,0,0,0,0,0,0,0,0
HIMACHAL PRADESH,2007,CRIMINAL BREACH OF TRUST,0,0,0,0,0,0,1,0,1,0,0,0,1,0,1
HIMACHAL PRADESH,2007,CHEATING,0,0,0,0,0,0,3,0,3,0,0,0,3,0,3
HIMACHAL PRADESH,2007,COUNTER FEITING,0,0,0,0,0,0,0,0,0,0,0,0,0,0,0
HIMACHAL PRADESH,2007,DOWRY DEATHS,0,0,0,0,0,0,1,0,1,0,0,0,1,0,1
HIMACHAL PRADESH,2007,MOLESTATION,0,0,0,0,0,0,0,0,0,0,0,0,0,0,0
HIMACHAL PRADESH,2007,EVE-TEASING,0,0,0,0,0,0,0,0,0,0,0,0,0,0,0
HIMACHAL PRADESH,2007,CRUELTY BY HUSBAND OR RELATIVE OF HUSBAND,0,0,0,0,0,0,1,0,1,0,0,0,1,0,1
HIMACHAL PRADESH,2007,OTHER IPC CRIMES,0,0,0,9,0,9,29,1,30,6,0,6,44,1,45
HIMACHAL PRADESH,2007,TOTAL IPC,0,0,0,251,5,256,337,14,351,63,4,67,651,23,674
HIMACHAL PRADESH,2008,MURDER,0,0,0,109,8,117,165,9,174,56,5,61,330,22,352
HIMACHAL PRADESH,2008,ATTEMPT TO COMMIT MURDER,0,0,0,17,0,17,17,0,17,7,0,7,41,0,41
HIMACHAL PRADESH,2008,C.H. NOT AMOUNTING TO MURDER,0,0,0,6,0,6,15,1,16,3,1,4,24,2,26
HIMACHAL PRADESH,2008,RAPE,0,0,0,62,0,62,70,0,70,15,0,15,147,0,147
HIMACHAL PRADESH,2008,KIDNAPPING AND ABDUCTION,0,0,0,2,0,2,0,0,0,1,0,1,3,0,3
HIMACHAL PRADESH,2008,DACOITY,0,0,0,4,0,4,11,0,11,0,0,0,15,0,15
HIMACHAL PRADESH,2008,PREP. AND ASSEMBLY FOR DACOITY,0,0,0,0,0,0,0,0,0,0,0,0,0,0,0
HIMACHAL PRADESH,2008,ROBBERY,0,0,0,18,0,18,2,0,2,0,0,0,20,0,20
HIMACHAL PRADESH,2008,BURGLARY,0,0,0,1,0,1,3,0,3,0,0,0,4,0,4
HIMACHAL PRADESH,2008,THEFTS,0,0,0,19,0,19,4,0,4,1,0,1,24,0,24
HIMACHAL PRADESH,2008,EXTORTION,0,0,0,0,0,0,0,0,0,0,0,0,0,0,0
HIMACHAL PRADESH,2008,RIOTS,0,0,0,0,0,0,0,0,0,0,0,0,0,0,0
HIMACHAL PRADESH,2008,ARSON,0,0,0,0,0,0,2,0,2,0,0,0,2,0,2
HIMACHAL PRADESH,2008,CRIMINAL BREACH OF TRUST,0,0,0,1,0,1,4,0,4,2,0,2,7,0,7
HIMACHAL PRADESH,2008,CHEATING,0,0,0,0,0,0,0,0,0,0,0,0,0,0,0
HIMACHAL PRADESH,2008,COUNTER FEITING,0,0,0,0,0,0,0,0,0,0,0,0,0,0,0
HIMACHAL PRADESH,2008,DOWRY DEATHS,0,0,0,0,0,0,3,0,3,1,1,2,4,1,5
HIMACHAL PRADESH,2008,MOLESTATION,0,0,0,0,0,0,0,0,0,0,0,0,0,0,0
HIMACHAL PRADESH,2008,EVE-TEASING,0,0,0,0,0,0,0,0,0,0,0,0,0,0,0
HIMACHAL PRADESH,2008,CRUELTY BY HUSBAND OR RELATIVE OF HUSBAND,0,0,0,0,0,0,4,0,4,0,0,0,4,0,4
HIMACHAL PRADESH,2008,OTHER IPC CRIMES,0,0,0,1,0,1,12,0,12,0,0,0,13,0,13
HIMACHAL PRADESH,2008,TOTAL IPC,0,0,0,240,8,248,312,10,322,86,7,93,638,25,663
HIMACHAL PRADESH,2009,MURDER,0,0,0,72,5,77,188,9,197,51,4,55,311,18,329
HIMACHAL PRADESH,2009,ATTEMPT TO COMMIT MURDER,0,0,0,7,1,8,9,0,9,5,0,5,21,1,22
HIMACHAL PRADESH,2009,C.H. NOT AMOUNTING TO MURDER,0,0,0,7,0,7,29,1,30,6,1,7,42,2,44
HIMACHAL PRADESH,2009,RAPE,0,0,0,64,0,64,80,0,80,12,0,12,156,0,156
HIMACHAL PRADESH,2009,KIDNAPPING AND ABDUCTION,0,0,0,0,0,0,0,0,0,0,0,0,0,0,0
HIMACHAL PRADESH,2009,DACOITY,0,0,0,7,0,7,4,0,4,0,0,0,11,0,11
HIMACHAL PRADESH,2009,PREP. AND ASSEMBLY FOR DACOITY,0,0,0,0,0,0,0,0,0,0,0,0,0,0,0
HIMACHAL PRADESH,2009,ROBBERY,0,0,0,0,0,0,7,0,7,0,0,0,7,0,7
HIMACHAL PRADESH,2009,BURGLARY,0,0,0,0,0,0,1,0,1,0,0,0,1,0,1
HIMACHAL PRADESH,2009,THEFTS,0,0,0,10,0,10,4,0,4,2,0,2,16,0,16
HIMACHAL PRADESH,2009,EXTORTION,0,0,0,0,0,0,0,0,0,0,0,0,0,0,0
HIMACHAL PRADESH,2009,RIOTS,0,0,0,0,0,0,0,0,0,0,0,0,0,0,0
HIMACHAL PRADESH,2009,ARSON,0,0,0,0,0,0,2,0,2,0,0,0,2,0,2
HIMACHAL PRADESH,2009,CRIMINAL BREACH OF TRUST,0,0,0,0,0,0,1,0,1,0,0,0,1,0,1
HIMACHAL PRADESH,2009,CHEATING,0,0,0,0,0,0,0,0,0,0,0,0,0,0,0
HIMACHAL PRADESH,2009,COUNTER FEITING,0,0,0,3,0,3,0,0,0,0,0,0,3,0,3
HIMACHAL PRADESH,2009,DOWRY DEATHS,0,0,0,0,0,0,2,0,2,0,1,1,2,1,3
HIMACHAL PRADESH,2009,MOLESTATION,0,0,0,1,0,1,0,0,0,0,0,0,1,0,1
HIMACHAL PRADESH,2009,EVE-TEASING,0,0,0,0,0,0,0,0,0,0,0,0,0,0,0
HIMACHAL PRADESH,2009,CRUELTY BY HUSBAND OR RELATIVE OF HUSBAND,0,0,0,1,0,1,1,2,3,0,0,0,2,2,4
HIMACHAL PRADESH,2009,OTHER IPC CRIMES,0,0,0,1,0,1,28,0,28,8,1,9,37,1,38
HIMACHAL PRADESH,2009,TOTAL IPC,0,0,0,173,6,179,356,12,368,84,7,91,613,25,638
HIMACHAL PRADESH,2010,MURDER,0,0,0,78,3,81,181,13,194,76,4,80,335,20,355
HIMACHAL PRADESH,2010,ATTEMPT TO COMMIT MURDER,0,0,0,15,0,15,16,0,16,2,0,2,33,0,33
HIMACHAL PRADESH,2010,C.H. NOT AMOUNTING TO MURDER,0,0,0,16,0,16,34,1,35,4,0,4,54,1,55
HIMACHAL PRADESH,2010,RAPE,0,0,0,76,0,76,56,0,56,10,0,10,142,0,142
HIMACHAL PRADESH,2010,KIDNAPPING AND ABDUCTION,0,0,0,8,0,8,3,0,3,1,0,1,12,0,12
HIMACHAL PRADESH,2010,DACOITY,0,0,0,28,0,28,10,0,10,0,0,0,38,0,38
HIMACHAL PRADESH,2010,PREP. AND ASSEMBLY FOR DACOITY,0,0,0,0,0,0,0,0,0,0,0,0,0,0,0
HIMACHAL PRADESH,2010,ROBBERY,0,0,0,2,0,2,2,0,2,0,0,0,4,0,4
HIMACHAL PRADESH,2010,BURGLARY,0,0,0,0,0,0,1,0,1,0,0,0,1,0,1
HIMACHAL PRADESH,2010,THEFTS,0,0,0,3,0,3,3,0,3,2,0,2,8,0,8
HIMACHAL PRADESH,2010,EXTORTION,0,0,0,0,0,0,0,0,0,0,0,0,0,0,0
HIMACHAL PRADESH,2010,RIOTS,0,0,0,0,0,0,0,0,0,0,0,0,0,0,0
HIMACHAL PRADESH,2010,ARSON,0,0,0,0,0,0,0,0,0,1,0,1,1,0,1
HIMACHAL PRADESH,2010,CRIMINAL BREACH OF TRUST,0,0,0,0,0,0,0,0,0,0,0,0,0,0,0
HIMACHAL PRADESH,2010,CHEATING,0,0,0,0,0,0,0,0,0,0,0,0,0,0,0
HIMACHAL PRADESH,2010,COUNTER FEITING,0,0,0,1,0,1,0,0,0,0,0,0,1,0,1
HIMACHAL PRADESH,2010,DOWRY DEATHS,0,0,0,0,0,0,1,0,1,0,0,0,1,0,1
HIMACHAL PRADESH,2010,MOLESTATION,0,0,0,1,0,1,0,0,0,0,0,0,1,0,1
HIMACHAL PRADESH,2010,EVE-TEASING,0,0,0,0,0,0,0,0,0,0,0,0,0,0,0
HIMACHAL PRADESH,2010,CRUELTY BY HUSBAND OR RELATIVE OF HUSBAND,0,0,0,0,0,0,0,0,0,0,0,0,0,0,0
HIMACHAL PRADESH,2010,OTHER IPC CRIMES,0,0,0,19,0,19,39,0,39,7,0,7,65,0,65
HIMACHAL PRADESH,2010,TOTAL IPC,0,0,0,247,3,250,346,14,360,103,4,107,696,21,717
HIMACHAL PRADESH,2011,MURDER,0,0,0,70,3,73,204,11,215,62,6,68,336,20,356
HIMACHAL PRADESH,2011,ATTEMPT TO COMMIT MURDER,0,0,0,14,0,14,16,0,16,5,0,5,35,0,35
HIMACHAL PRADESH,2011,C.H. NOT AMOUNTING TO MURDER,0,0,0,22,0,22,27,0,27,6,0,6,55,0,55
HIMACHAL PRADESH,2011,RAPE,0,0,0,64,0,64,59,0,59,11,0,11,134,0,134
HIMACHAL PRADESH,2011,KIDNAPPING AND ABDUCTION,0,0,0,2,0,2,0,0,0,0,0,0,2,0,2
HIMACHAL PRADESH,2011,DACOITY,0,0,0,17,0,17,6,0,6,0,0,0,23,0,23
HIMACHAL PRADESH,2011,PREP. AND ASSEMBLY FOR DACOITY,0,0,0,0,0,0,0,0,0,0,0,0,0,0,0
HIMACHAL PRADESH,2011,ROBBERY,0,0,0,3,0,3,1,0,1,0,0,0,4,0,4
HIMACHAL PRADESH,2011,BURGLARY,0,0,0,4,0,4,2,0,2,0,0,0,6,0,6
HIMACHAL PRADESH,2011,THEFTS,0,0,0,7,0,7,3,0,3,1,0,1,11,0,11
HIMACHAL PRADESH,2011,EXTORTION,0,0,0,0,0,0,0,0,0,0,0,0,0,0,0
HIMACHAL PRADESH,2011,RIOTS,0,0,0,0,0,0,0,0,0,0,0,0,0,0,0
HIMACHAL PRADESH,2011,ARSON,0,0,0,0,0,0,1,0,1,0,0,0,1,0,1
HIMACHAL PRADESH,2011,CRIMINAL BREACH OF TRUST,0,0,0,0,0,0,2,0,2,2,0,2,4,0,4
HIMACHAL PRADESH,2011,CHEATING,0,0,0,2,0,2,0,0,0,1,0,1,3,0,3
HIMACHAL PRADESH,2011,COUNTER FEITING,0,0,0,0,0,0,2,0,2,0,0,0,2,0,2
HIMACHAL PRADESH,2011,DOWRY DEATHS,0,0,0,0,0,0,0,0,0,0,0,0,0,0,0
HIMACHAL PRADESH,2011,MOLESTATION,0,0,0,0,0,0,0,0,0,0,0,0,0,0,0
HIMACHAL PRADESH,2011,EVE-TEASING,0,0,0,0,0,0,0,0,0,0,0,0,0,0,0
HIMACHAL PRADESH,2011,CRUELTY BY HUSBAND OR RELATIVE OF HUSBAND,0,0,0,0,0,0,0,0,0,1,0,1,1,0,1
HIMACHAL PRADESH,2011,OTHER IPC CRIMES,0,0,0,7,0,7,18,0,18,17,0,17,42,0,42
HIMACHAL PRADESH,2011,TOTAL IPC,0,0,0,212,3,215,341,11,352,106,6,112,659,20,679
HIMACHAL PRADESH,2012,MURDER,0,0,0,77,2,79,213,14,227,46,8,54,336,24,360
HIMACHAL PRADESH,2012,ATTEMPT TO COMMIT MURDER,0,0,0,8,0,8,17,1,18,5,0,5,30,1,31
HIMACHAL PRADESH,2012,C.H. NOT AMOUNTING TO MURDER,0,0,0,13,0,13,24,0,24,4,0,4,41,0,41
HIMACHAL PRADESH,2012,RAPE,0,0,0,55,0,55,53,0,53,9,0,9,117,0,117
HIMACHAL PRADESH,2012,KIDNAPPING AND ABDUCTION,0,0,0,0,0,0,0,0,0,0,0,0,0,0,0
HIMACHAL PRADESH,2012,DACOITY,0,0,0,15,0,15,5,0,5,0,0,0,20,0,20
HIMACHAL PRADESH,2012,PREP. AND ASSEMBLY FOR DACOITY,0,0,0,0,0,0,0,0,0,0,0,0,0,0,0
HIMACHAL PRADESH,2012,ROBBERY,0,0,0,4,0,4,1,0,1,0,0,0,5,0,5
HIMACHAL PRADESH,2012,BURGLARY,0,0,0,2,0,2,1,0,1,0,0,0,3,0,3
HIMACHAL PRADESH,2012,THEFTS,0,0,0,10,0,10,6,0,6,1,0,1,17,0,17
HIMACHAL PRADESH,2012,EXTORTION,0,0,0,0,0,0,0,0,0,0,0,0,0,0,0
HIMACHAL PRADESH,2012,RIOTS,0,0,0,0,0,0,0,0,0,0,0,0,0,0,0
HIMACHAL PRADESH,2012,ARSON,0,0,0,0,0,0,0,0,0,0,0,0,0,0,0
HIMACHAL PRADESH,2012,CRIMINAL BREACH OF TRUST,0,0,0,0,0,0,1,0,1,1,0,1,2,0,2
HIMACHAL PRADESH,2012,CHEATING,0,0,0,0,0,0,1,0,1,0,0,0,1,0,1
HIMACHAL PRADESH,2012,COUNTER FEITING,0,0,0,2,0,2,0,0,0,0,0,0,2,0,2
HIMACHAL PRADESH,2012,DOWRY DEATHS,0,0,0,0,0,0,0,0,0,0,0,0,0,0,0
HIMACHAL PRADESH,2012,MOLESTATION,0,0,0,1,0,1,1,0,1,0,0,0,2,0,2
HIMACHAL PRADESH,2012,EVE-TEASING,0,0,0,0,0,0,0,0,0,0,0,0,0,0,0
HIMACHAL PRADESH,2012,CRUELTY BY HUSBAND OR RELATIVE OF HUSBAND,0,0,0,0,0,0,6,0,6,0,1,1,6,1,7
HIMACHAL PRADESH,2012,OTHER IPC CRIMES,0,0,0,23,1,24,37,0,37,11,0,11,71,1,72
HIMACHAL PRADESH,2012,TOTAL IPC,0,0,0,210,3,213,366,15,381,77,9,86,653,27,680
JAMMU & KASHMIR,2001,MURDER,0,0,0,9,1,10,51,1,52,14,1,15,74,3,77
JAMMU & KASHMIR,2001,ATTEMPT TO COMMIT MURDER,0,0,0,2,0,2,2,0,2,0,0,0,4,0,4
JAMMU & KASHMIR,2001,C.H. NOT AMOUNTING TO MURDER,0,0,0,3,0,3,3,0,3,0,1,1,6,1,7
JAMMU & KASHMIR,2001,RAPE,0,0,0,4,0,4,6,0,6,1,0,1,11,0,11
JAMMU & KASHMIR,2001,KIDNAPPING AND ABDUCTION,0,0,0,0,0,0,0,0,0,0,0,0,0,0,0
JAMMU & KASHMIR,2001,DACOITY,0,0,0,0,0,0,0,0,0,0,0,0,0,0,0
JAMMU & KASHMIR,2001,PREP. AND ASSEMBLY FOR DACOITY,0,0,0,0,0,0,0,0,0,0,0,0,0,0,0
JAMMU & KASHMIR,2001,ROBBERY,0,0,0,0,0,0,0,0,0,0,0,0,0,0,0
JAMMU & KASHMIR,2001,BURGLARY,0,0,0,5,0,5,1,0,1,0,0,0,6,0,6
JAMMU & KASHMIR,2001,THEFTS,0,0,0,0,0,0,0,0,0,0,0,0,0,0,0
JAMMU & KASHMIR,2001,EXTORTION,0,0,0,0,0,0,0,0,0,0,0,0,0,0,0
JAMMU & KASHMIR,2001,RIOTS,0,0,0,0,0,0,0,0,0,0,0,0,0,0,0
JAMMU & KASHMIR,2001,ARSON,0,0,0,0,0,0,0,0,0,0,0,0,0,0,0
JAMMU & KASHMIR,2001,CRIMINAL BREACH OF TRUST,0,0,0,0,0,0,0,0,0,0,0,0,0,0,0
JAMMU & KASHMIR,2001,CHEATING,0,0,0,0,0,0,0,0,0,0,0,0,0,0,0
JAMMU & KASHMIR,2001,COUNTER FEITING,0,0,0,0,0,0,0,0,0,0,0,0,0,0,0
JAMMU & KASHMIR,2001,DOWRY DEATHS,0,0,0,0,0,0,0,0,0,0,0,0,0,0,0
JAMMU & KASHMIR,2001,MOLESTATION,0,0,0,0,0,0,0,0,0,0,0,0,0,0,0
JAMMU & KASHMIR,2001,EVE-TEASING,0,0,0,0,0,0,0,0,0,0,0,0,0,0,0
JAMMU & KASHMIR,2001,CRUELTY BY HUSBAND OR RELATIVE OF HUSBAND,0,0,0,0,0,0,0,0,0,0,0,0,0,0,0
JAMMU & KASHMIR,2001,OTHER IPC CRIMES,0,0,0,3,0,3,1,0,1,0,1,1,4,1,5
JAMMU & KASHMIR,2001,TOTAL IPC,0,0,0,26,1,27,64,1,65,15,3,18,105,5,110
JAMMU & KASHMIR,2002,MURDER,0,0,0,21,0,21,42,1,43,7,2,9,70,3,73
JAMMU & KASHMIR,2002,ATTEMPT TO COMMIT MURDER,0,0,0,3,0,3,4,0,4,1,0,1,8,0,8
JAMMU & KASHMIR,2002,C.H. NOT AMOUNTING TO MURDER,0,0,0,0,0,0,0,0,0,0,0,0,0,0,0
JAMMU & KASHMIR,2002,RAPE,0,0,0,9,0,9,0,0,0,0,0,0,9,0,9
JAMMU & KASHMIR,2002,KIDNAPPING AND ABDUCTION,0,0,0,0,0,0,0,0,0,0,0,0,0,0,0
JAMMU & KASHMIR,2002,DACOITY,0,0,0,0,0,0,0,0,0,0,0,0,0,0,0
JAMMU & KASHMIR,2002,PREP. AND ASSEMBLY FOR DACOITY,0,0,0,0,0,0,0,0,0,0,0,0,0,0,0
JAMMU & KASHMIR,2002,ROBBERY,0,0,0,0,0,0,0,0,0,0,0,0,0,0,0
JAMMU & KASHMIR,2002,BURGLARY,0,0,0,0,0,0,0,0,0,0,0,0,0,0,0
JAMMU & KASHMIR,2002,THEFTS,0,0,0,7,0,7,8,0,8,3,0,3,18,0,18
JAMMU & KASHMIR,2002,EXTORTION,0,0,0,0,0,0,0,0,0,0,0,0,0,0,0
JAMMU & KASHMIR,2002,RIOTS,0,0,0,0,0,0,0,0,0,0,0,0,0,0,0
JAMMU & KASHMIR,2002,ARSON,0,0,0,0,0,0,0,0,0,0,0,0,0,0,0
JAMMU & KASHMIR,2002,CRIMINAL BREACH OF TRUST,0,0,0,0,0,0,0,0,0,0,0,0,0,0,0
JAMMU & KASHMIR,2002,CHEATING,0,0,0,0,0,0,0,0,0,0,0,0,0,0,0
JAMMU & KASHMIR,2002,COUNTER FEITING,0,0,0,0,0,0,0,0,0,0,0,0,0,0,0
JAMMU & KASHMIR,2002,DOWRY DEATHS,0,0,0,6,0,6,9,0,9,1,0,1,16,0,16
JAMMU & KASHMIR,2002,MOLESTATION,0,0,0,0,0,0,0,0,0,0,0,0,0,0,0
JAMMU & KASHMIR,2002,EVE-TEASING,0,0,0,0,0,0,0,0,0,0,0,0,0,0,0
JAMMU & KASHMIR,2002,CRUELTY BY HUSBAND OR RELATIVE OF HUSBAND,0,0,0,2,0,2,3,0,3,0,0,0,5,0,5
JAMMU & KASHMIR,2002,OTHER IPC CRIMES,0,0,0,0,0,0,0,0,0,0,0,0,0,0,0
JAMMU & KASHMIR,2002,TOTAL IPC,0,0,0,48,0,48,66,1,67,12,2,14,126,3,129
JAMMU & KASHMIR,2003,MURDER,0,0,0,12,1,13,34,0,34,6,0,6,52,1,53
JAMMU & KASHMIR,2003,ATTEMPT TO COMMIT MURDER,0,0,0,3,0,3,11,0,11,3,0,3,17,0,17
JAMMU & KASHMIR,2003,C.H. NOT AMOUNTING TO MURDER,0,0,0,6,0,6,0,0,0,1,0,1,7,0,7
JAMMU & KASHMIR,2003,RAPE,0,0,0,5,0,5,10,0,10,0,0,0,15,0,15
JAMMU & KASHMIR,2003,KIDNAPPING AND ABDUCTION,0,0,0,0,0,0,0,0,0,0,0,0,0,0,0
JAMMU & KASHMIR,2003,DACOITY,0,0,0,0,0,0,0,0,0,0,0,0,0,0,0
JAMMU & KASHMIR,2003,PREP. AND ASSEMBLY FOR DACOITY,0,0,0,0,0,0,0,0,0,0,0,0,0,0,0
JAMMU & KASHMIR,2003,ROBBERY,0,0,0,4,0,4,2,0,2,0,0,0,6,0,6
JAMMU & KASHMIR,2003,BURGLARY,0,0,0,2,0,2,0,0,0,0,0,0,2,0,2
JAMMU & KASHMIR,2003,THEFTS,0,0,0,3,0,3,3,0,3,2,0,2,8,0,8
JAMMU & KASHMIR,2003,EXTORTION,0,0,0,0,0,0,0,0,0,0,0,0,0,0,0
JAMMU & KASHMIR,2003,RIOTS,0,0,0,0,0,0,0,0,0,0,0,0,0,0,0
JAMMU & KASHMIR,2003,ARSON,0,0,0,0,0,0,0,0,0,0,0,0,0,0,0
JAMMU & KASHMIR,2003,CRIMINAL BREACH OF TRUST,0,0,0,1,0,1,0,0,0,1,0,1,2,0,2
JAMMU & KASHMIR,2003,CHEATING,0,0,0,0,0,0,0,0,0,1,0,1,1,0,1
JAMMU & KASHMIR,2003,COUNTER FEITING,0,0,0,0,0,0,0,0,0,0,0,0,0,0,0
JAMMU & KASHMIR,2003,DOWRY DEATHS,0,0,0,0,0,0,0,0,0,0,0,0,0,0,0
JAMMU & KASHMIR,2003,MOLESTATION,0,0,0,0,0,0,0,0,0,0,0,0,0,0,0
JAMMU & KASHMIR,2003,EVE-TEASING,0,0,0,0,0,0,0,0,0,0,0,0,0,0,0
JAMMU & KASHMIR,2003,CRUELTY BY HUSBAND OR RELATIVE OF HUSBAND,0,0,0,1,0,1,0,0,0,0,0,0,1,0,1
JAMMU & KASHMIR,2003,OTHER IPC CRIMES,0,0,0,0,0,0,4,0,4,0,0,0,4,0,4
JAMMU & KASHMIR,2003,TOTAL IPC,0,0,0,37,1,38,64,0,64,14,0,14,115,1,116
JAMMU & KASHMIR,2004,MURDER,0,0,0,17,0,17,60,0,60,6,1,7,83,1,84
JAMMU & KASHMIR,2004,ATTEMPT TO COMMIT MURDER,0,0,0,2,0,2,4,0,4,0,0,0,6,0,6
JAMMU & KASHMIR,2004,C.H. NOT AMOUNTING TO MURDER,0,0,0,5,0,5,5,0,5,4,0,4,14,0,14
JAMMU & KASHMIR,2004,RAPE,0,0,0,5,0,5,9,0,9,0,0,0,14,0,14
JAMMU & KASHMIR,2004,KIDNAPPING AND ABDUCTION,0,0,0,0,0,0,0,0,0,0,0,0,0,0,0
JAMMU & KASHMIR,2004,DACOITY,0,0,0,0,0,0,0,0,0,0,0,0,0,0,0
JAMMU & KASHMIR,2004,PREP. AND ASSEMBLY FOR DACOITY,0,0,0,0,0,0,0,0,0,0,0,0,0,0,0
JAMMU & KASHMIR,2004,ROBBERY,0,0,0,0,0,0,2,0,2,0,0,0,2,0,2
JAMMU & KASHMIR,2004,BURGLARY,0,0,0,3,0,3,1,0,1,0,0,0,4,0,4
JAMMU & KASHMIR,2004,THEFTS,0,0,0,5,0,5,0,0,0,0,0,0,5,0,5
JAMMU & KASHMIR,2004,EXTORTION,0,0,0,6,0,6,0,0,0,0,0,0,6,0,6
JAMMU & KASHMIR,2004,RIOTS,0,0,0,0,0,0,0,2,2,2,1,3,2,3,5
JAMMU & KASHMIR,2004,ARSON,0,0,0,0,0,0,0,0,0,0,0,0,0,0,0
JAMMU & KASHMIR,2004,CRIMINAL BREACH OF TRUST,0,0,0,0,0,0,0,0,0,0,0,0,0,0,0
JAMMU & KASHMIR,2004,CHEATING,0,0,0,0,0,0,0,0,0,0,0,0,0,0,0
JAMMU & KASHMIR,2004,COUNTER FEITING,0,0,0,0,0,0,0,0,0,0,0,0,0,0,0
JAMMU & KASHMIR,2004,DOWRY DEATHS,0,0,0,0,0,0,1,0,1,0,0,0,1,0,1
JAMMU & KASHMIR,2004,MOLESTATION,0,0,0,0,0,0,0,0,0,0,0,0,0,0,0
JAMMU & KASHMIR,2004,EVE-TEASING,0,0,0,0,0,0,0,0,0,0,0,0,0,0,0
JAMMU & KASHMIR,2004,CRUELTY BY HUSBAND OR RELATIVE OF HUSBAND,0,0,0,0,0,0,0,0,0,0,0,0,0,0,0
JAMMU & KASHMIR,2004,OTHER IPC CRIMES,0,0,0,4,0,4,2,0,2,2,0,2,8,0,8
JAMMU & KASHMIR,2004,TOTAL IPC,0,0,0,47,0,47,84,2,86,14,2,16,145,4,149
JAMMU & KASHMIR,2005,MURDER,0,0,0,30,1,31,64,1,65,13,5,18,107,7,114
JAMMU & KASHMIR,2005,ATTEMPT TO COMMIT MURDER,0,0,0,1,0,1,1,0,1,0,0,0,2,0,2
JAMMU & KASHMIR,2005,C.H. NOT AMOUNTING TO MURDER,0,0,0,2,0,2,2,0,2,3,0,3,7,0,7
JAMMU & KASHMIR,2005,RAPE,0,0,0,4,0,4,10,0,10,2,0,2,16,0,16
JAMMU & KASHMIR,2005,KIDNAPPING AND ABDUCTION,0,0,0,0,0,0,0,0,0,0,0,0,0,0,0
JAMMU & KASHMIR,2005,DACOITY,0,0,0,0,0,0,1,0,1,0,0,0,1,0,1
JAMMU & KASHMIR,2005,PREP. AND ASSEMBLY FOR DACOITY,0,0,0,0,0,0,0,0,0,0,0,0,0,0,0
JAMMU & KASHMIR,2005,ROBBERY,0,0,0,0,0,0,2,0,2,0,0,0,2,0,2
JAMMU & KASHMIR,2005,BURGLARY,0,0,0,3,0,3,1,0,1,0,0,0,4,0,4
JAMMU & KASHMIR,2005,THEFTS,0,0,0,6,0,6,1,0,1,0,0,0,7,0,7
JAMMU & KASHMIR,2005,EXTORTION,0,0,0,0,0,0,0,0,0,0,0,0,0,0,0
JAMMU & KASHMIR,2005,RIOTS,0,0,0,0,0,0,0,0,0,0,0,0,0,0,0
JAMMU & KASHMIR,2005,ARSON,0,0,0,0,0,0,0,0,0,0,0,0,0,0,0
JAMMU & KASHMIR,2005,CRIMINAL BREACH OF TRUST,0,0,0,0,0,0,0,0,0,0,0,0,0,0,0
JAMMU & KASHMIR,2005,CHEATING,0,0,0,0,0,0,0,0,0,0,0,0,0,0,0
JAMMU & KASHMIR,2005,COUNTER FEITING,0,0,0,0,0,0,0,0,0,0,0,0,0,0,0
JAMMU & KASHMIR,2005,DOWRY DEATHS,0,0,0,0,0,0,0,0,0,0,0,0,0,0,0
JAMMU & KASHMIR,2005,MOLESTATION,0,0,0,2,0,2,0,0,0,0,0,0,2,0,2
JAMMU & KASHMIR,2005,EVE-TEASING,0,0,0,0,0,0,0,0,0,0,0,0,0,0,0
JAMMU & KASHMIR,2005,CRUELTY BY HUSBAND OR RELATIVE OF HUSBAND,0,0,0,0,0,0,0,0,0,0,0,0,0,0,0
JAMMU & KASHMIR,2005,OTHER IPC CRIMES,0,0,0,6,0,6,11,0,11,2,0,2,19,0,19
JAMMU & KASHMIR,2005,TOTAL IPC,0,0,0,54,1,55,93,1,94,20,5,25,167,7,174
JAMMU & KASHMIR,2006,MURDER,0,0,0,34,0,34,57,3,60,20,4,24,111,7,118
JAMMU & KASHMIR,2006,ATTEMPT TO COMMIT MURDER,0,0,0,0,0,0,0,1,1,0,0,0,0,1,1
JAMMU & KASHMIR,2006,C.H. NOT AMOUNTING TO MURDER,0,0,0,0,0,0,6,0,6,4,0,4,10,0,10
JAMMU & KASHMIR,2006,RAPE,0,0,0,10,0,10,15,0,15,2,0,2,27,0,27
JAMMU & KASHMIR,2006,KIDNAPPING AND ABDUCTION,0,0,0,0,0,0,0,0,0,0,0,0,0,0,0
JAMMU & KASHMIR,2006,DACOITY,0,0,0,0,0,0,0,0,0,0,0,0,0,0,0
JAMMU & KASHMIR,2006,PREP. AND ASSEMBLY FOR DACOITY,0,0,0,0,0,0,0,0,0,0,0,0,0,0,0
JAMMU & KASHMIR,2006,ROBBERY,0,0,0,0,0,0,0,0,0,0,0,0,0,0,0
JAMMU & KASHMIR,2006,BURGLARY,0,0,0,3,0,3,2,0,2,0,0,0,5,0,5
JAMMU & KASHMIR,2006,THEFTS,0,0,0,5,0,5,3,0,3,0,0,0,8,0,8
JAMMU & KASHMIR,2006,EXTORTION,0,0,0,0,0,0,0,0,0,0,0,0,0,0,0
JAMMU & KASHMIR,2006,RIOTS,0,0,0,0,0,0,5,0,5,0,0,0,5,0,5
JAMMU & KASHMIR,2006,ARSON,0,0,0,0,0,0,0,0,0,0,0,0,0,0,0
JAMMU & KASHMIR,2006,CRIMINAL BREACH OF TRUST,0,0,0,0,0,0,0,0,0,0,0,0,0,0,0
JAMMU & KASHMIR,2006,CHEATING,0,0,0,0,0,0,0,0,0,1,0,1,1,0,1
JAMMU & KASHMIR,2006,COUNTER FEITING,0,0,0,0,0,0,0,0,0,0,0,0,0,0,0
JAMMU & KASHMIR,2006,DOWRY DEATHS,0,0,0,0,0,0,0,0,0,0,0,0,0,0,0
JAMMU & KASHMIR,2006,MOLESTATION,0,0,0,0,0,0,0,0,0,0,0,0,0,0,0
JAMMU & KASHMIR,2006,EVE-TEASING,0,0,0,0,0,0,0,0,0,0,0,0,0,0,0
JAMMU & KASHMIR,2006,CRUELTY BY HUSBAND OR RELATIVE OF HUSBAND,0,0,0,0,0,0,0,0,0,0,0,0,0,0,0
JAMMU & KASHMIR,2006,OTHER IPC CRIMES,0,0,0,3,0,3,6,0,6,3,0,3,12,0,12
JAMMU & KASHMIR,2006,TOTAL IPC,0,0,0,55,0,55,94,4,98,30,4,34,179,8,187
JAMMU & KASHMIR,2007,MURDER,0,0,0,26,1,27,55,0,55,17,5,22,98,6,104
JAMMU & KASHMIR,2007,ATTEMPT TO COMMIT MURDER,0,0,0,0,0,0,4,0,4,0,0,0,4,0,4
JAMMU & KASHMIR,2007,C.H. NOT AMOUNTING TO MURDER,0,0,0,5,0,5,10,0,10,1,0,1,16,0,16
JAMMU & KASHMIR,2007,RAPE,0,0,0,7,0,7,6,0,6,5,0,5,18,0,18
JAMMU & KASHMIR,2007,KIDNAPPING AND ABDUCTION,0,0,0,2,0,2,4,0,4,0,0,0,6,0,6
JAMMU & KASHMIR,2007,DACOITY,0,0,0,0,0,0,0,0,0,0,0,0,0,0,0
JAMMU & KASHMIR,2007,PREP. AND ASSEMBLY FOR DACOITY,0,0,0,0,0,0,0,0,0,0,0,0,0,0,0
JAMMU & KASHMIR,2007,ROBBERY,0,0,0,0,0,0,0,0,0,0,0,0,0,0,0
JAMMU & KASHMIR,2007,BURGLARY,0,0,0,2,0,2,0,0,0,0,0,0,2,0,2
JAMMU & KASHMIR,2007,THEFTS,2,0,2,7,0,7,5,0,5,0,0,0,14,0,14
JAMMU & KASHMIR,2007,EXTORTION,0,0,0,0,0,0,0,0,0,0,0,0,0,0,0
JAMMU & KASHMIR,2007,RIOTS,0,0,0,0,0,0,4,0,4,0,0,0,4,0,4
JAMMU & KASHMIR,2007,ARSON,0,0,0,0,0,0,0,0,0,0,0,0,0,0,0
JAMMU & KASHMIR,2007,CRIMINAL BREACH OF TRUST,0,0,0,0,0,0,0,0,0,0,0,0,0,0,0
JAMMU & KASHMIR,2007,CHEATING,0,0,0,0,0,0,0,0,0,1,0,1,1,0,1
JAMMU & KASHMIR,2007,COUNTER FEITING,0,0,0,0,0,0,0,0,0,0,0,0,0,0,0
JAMMU & KASHMIR,2007,DOWRY DEATHS,0,0,0,1,0,1,0,0,0,0,0,0,1,0,1
JAMMU & KASHMIR,2007,MOLESTATION,0,0,0,0,0,0,0,0,0,0,0,0,0,0,0
JAMMU & KASHMIR,2007,EVE-TEASING,0,0,0,0,0,0,0,0,0,0,0,0,0,0,0
JAMMU & KASHMIR,2007,CRUELTY BY HUSBAND OR RELATIVE OF HUSBAND,0,0,0,0,0,0,1,0,1,0,0,0,1,0,1
JAMMU & KASHMIR,2007,OTHER IPC CRIMES,0,0,0,3,0,3,0,0,0,0,0,0,3,0,3
JAMMU & KASHMIR,2007,TOTAL IPC,2,0,2,53,1,54,89,0,89,24,5,29,168,6,174
JAMMU & KASHMIR,2008,MURDER,0,0,0,48,1,49,57,2,59,26,5,31,131,8,139
JAMMU & KASHMIR,2008,ATTEMPT TO COMMIT MURDER,0,0,0,0,0,0,0,0,0,0,0,0,0,0,0
JAMMU & KASHMIR,2008,C.H. NOT AMOUNTING TO MURDER,0,0,0,1,0,1,3,0,3,2,0,2,6,0,6
JAMMU & KASHMIR,2008,RAPE,0,0,0,21,0,21,30,0,30,2,0,2,53,0,53
JAMMU & KASHMIR,2008,KIDNAPPING AND ABDUCTION,0,0,0,0,0,0,2,0,2,0,0,0,2,0,2
JAMMU & KASHMIR,2008,DACOITY,0,0,0,1,0,1,0,0,0,0,0,0,1,0,1
JAMMU & KASHMIR,2008,PREP. AND ASSEMBLY FOR DACOITY,0,0,0,0,0,0,0,0,0,0,0,0,0,0,0
JAMMU & KASHMIR,2008,ROBBERY,0,0,0,0,0,0,0,0,0,0,0,0,0,0,0
JAMMU & KASHMIR,2008,BURGLARY,0,0,0,0,0,0,0,0,0,0,0,0,0,0,0
JAMMU & KASHMIR,2008,THEFTS,0,0,0,13,0,13,4,0,4,0,0,0,17,0,17
JAMMU & KASHMIR,2008,EXTORTION,0,0,0,0,0,0,0,0,0,0,0,0,0,0,0
JAMMU & KASHMIR,2008,RIOTS,0,0,0,0,0,0,1,0,1,0,0,0,1,0,1
JAMMU & KASHMIR,2008,ARSON,0,0,0,0,0,0,0,0,0,0,0,0,0,0,0
JAMMU & KASHMIR,2008,CRIMINAL BREACH OF TRUST,0,0,0,0,0,0,0,0,0,0,0,0,0,0,0
JAMMU & KASHMIR,2008,CHEATING,0,0,0,0,0,0,0,0,0,0,0,0,0,0,0
JAMMU & KASHMIR,2008,COUNTER FEITING,0,0,0,0,0,0,0,0,0,0,0,0,0,0,0
JAMMU & KASHMIR,2008,DOWRY DEATHS,0,0,0,0,0,0,0,0,0,0,0,0,0,0,0
JAMMU & KASHMIR,2008,MOLESTATION,0,0,0,0,0,0,0,0,0,0,0,0,0,0,0
JAMMU & KASHMIR,2008,EVE-TEASING,0,0,0,0,0,0,0,0,0,0,0,0,0,0,0
JAMMU & KASHMIR,2008,CRUELTY BY HUSBAND OR RELATIVE OF HUSBAND,0,0,0,1,0,1,0,0,0,0,0,0,1,0,1
JAMMU & KASHMIR,2008,OTHER IPC CRIMES,0,0,0,0,0,0,0,0,0,0,0,0,0,0,0
JAMMU & KASHMIR,2008,TOTAL IPC,0,0,0,85,1,86,97,2,99,30,5,35,212,8,220
JAMMU & KASHMIR,2009,MURDER,0,0,0,37,0,37,80,2,82,17,5,22,134,7,141
JAMMU & KASHMIR,2009,ATTEMPT TO COMMIT MURDER,0,0,0,1,0,1,4,0,4,0,0,0,5,0,5
JAMMU & KASHMIR,2009,C.H. NOT AMOUNTING TO MURDER,0,0,0,3,0,3,5,0,5,0,0,0,8,0,8
JAMMU & KASHMIR,2009,RAPE,0,0,0,4,0,4,17,0,17,0,0,0,21,0,21
JAMMU & KASHMIR,2009,KIDNAPPING AND ABDUCTION,0,0,0,7,0,7,10,0,10,0,0,0,17,0,17
JAMMU & KASHMIR,2009,DACOITY,0,0,0,0,0,0,0,0,0,0,0,0,0,0,0
JAMMU & KASHMIR,2009,PREP. AND ASSEMBLY FOR DACOITY,0,0,0,0,0,0,0,0,0,0,0,0,0,0,0
JAMMU & KASHMIR,2009,ROBBERY,0,0,0,0,0,0,0,0,0,0,0,0,0,0,0
JAMMU & KASHMIR,2009,BURGLARY,0,0,0,0,0,0,3,0,3,0,0,0,3,0,3
JAMMU & KASHMIR,2009,THEFTS,0,0,0,3,0,3,3,0,3,0,0,0,6,0,6
JAMMU & KASHMIR,2009,EXTORTION,0,0,0,0,0,0,0,0,0,0,0,0,0,0,0
JAMMU & KASHMIR,2009,RIOTS,0,0,0,0,0,0,0,0,0,0,0,0,0,0,0
JAMMU & KASHMIR,2009,ARSON,0,0,0,0,0,0,0,0,0,0,0,0,0,0,0
JAMMU & KASHMIR,2009,CRIMINAL BREACH OF TRUST,0,0,0,0,1,1,0,0,0,0,0,0,0,1,1
JAMMU & KASHMIR,2009,CHEATING,0,0,0,0,0,0,0,0,0,2,0,2,2,0,2
JAMMU & KASHMIR,2009,COUNTER FEITING,0,0,0,0,0,0,0,0,0,0,0,0,0,0,0
JAMMU & KASHMIR,2009,DOWRY DEATHS,0,0,0,0,0,0,0,0,0,0,0,0,0,0,0
JAMMU & KASHMIR,2009,MOLESTATION,0,0,0,0,0,0,1,0,1,0,0,0,1,0,1
JAMMU & KASHMIR,2009,EVE-TEASING,0,0,0,0,0,0,1,0,1,0,0,0,1,0,1
JAMMU & KASHMIR,2009,CRUELTY BY HUSBAND OR RELATIVE OF HUSBAND,0,0,0,2,0,2,10,0,10,0,0,0,12,0,12
JAMMU & KASHMIR,2009,OTHER IPC CRIMES,0,0,0,13,0,13,0,0,0,0,1,1,13,1,14
JAMMU & KASHMIR,2009,TOTAL IPC,0,0,0,70,1,71,134,2,136,19,6,25,223,9,232
JAMMU & KASHMIR,2010,MURDER,0,0,0,59,2,61,131,3,134,11,2,13,201,7,208
JAMMU & KASHMIR,2010,ATTEMPT TO COMMIT MURDER,0,0,0,3,0,3,4,0,4,2,0,2,9,0,9
JAMMU & KASHMIR,2010,C.H. NOT AMOUNTING TO MURDER,0,0,0,0,0,0,0,0,0,0,0,0,0,0,0
JAMMU & KASHMIR,2010,RAPE,0,0,0,18,0,18,0,0,0,0,0,0,18,0,18
JAMMU & KASHMIR,2010,KIDNAPPING AND ABDUCTION,0,0,0,0,0,0,0,0,0,0,0,0,0,0,0
JAMMU & KASHMIR,2010,DACOITY,0,0,0,0,0,0,0,0,0,0,0,0,0,0,0
JAMMU & KASHMIR,2010,PREP. AND ASSEMBLY FOR DACOITY,0,0,0,0,0,0,0,0,0,0,0,0,0,0,0
JAMMU & KASHMIR,2010,ROBBERY,0,0,0,0,0,0,0,0,0,0,0,0,0,0,0
JAMMU & KASHMIR,2010,BURGLARY,0,0,0,0,0,0,0,0,0,0,0,0,0,0,0
JAMMU & KASHMIR,2010,THEFTS,0,0,0,0,0,0,3,0,3,0,0,0,3,0,3
JAMMU & KASHMIR,2010,EXTORTION,0,0,0,0,0,0,0,0,0,0,0,0,0,0,0
JAMMU & KASHMIR,2010,RIOTS,0,0,0,0,0,0,0,0,0,0,0,0,0,0,0
JAMMU & KASHMIR,2010,ARSON,0,0,0,0,0,0,0,0,0,0,0,0,0,0,0
JAMMU & KASHMIR,2010,CRIMINAL BREACH OF TRUST,0,0,0,0,0,0,0,0,0,0,0,0,0,0,0
JAMMU & KASHMIR,2010,CHEATING,0,0,0,0,0,0,0,0,0,0,0,0,0,0,0
JAMMU & KASHMIR,2010,COUNTER FEITING,0,0,0,0,0,0,0,0,0,0,0,0,0,0,0
JAMMU & KASHMIR,2010,DOWRY DEATHS,0,0,0,0,0,0,0,0,0,0,0,0,0,0,0
JAMMU & KASHMIR,2010,MOLESTATION,0,0,0,0,0,0,0,0,0,0,0,0,0,0,0
JAMMU & KASHMIR,2010,EVE-TEASING,0,0,0,0,0,0,0,0,0,0,0,0,0,0,0
JAMMU & KASHMIR,2010,CRUELTY BY HUSBAND OR RELATIVE OF HUSBAND,0,0,0,0,0,0,0,0,0,0,0,0,0,0,0
JAMMU & KASHMIR,2010,OTHER IPC CRIMES,0,0,0,0,0,0,0,0,0,0,0,0,0,0,0
JAMMU & KASHMIR,2010,TOTAL IPC,0,0,0,80,2,82,138,3,141,13,2,15,231,7,238
JAMMU & KASHMIR,2011,MURDER,0,0,0,41,1,42,66,3,69,54,6,60,161,10,171
JAMMU & KASHMIR,2011,ATTEMPT TO COMMIT MURDER,0,0,0,0,0,0,0,0,0,0,0,0,0,0,0
JAMMU & KASHMIR,2011,C.H. NOT AMOUNTING TO MURDER,0,0,0,9,0,9,6,0,6,3,0,3,18,0,18
JAMMU & KASHMIR,2011,RAPE,0,0,0,0,0,0,23,0,23,5,0,5,28,0,28
JAMMU & KASHMIR,2011,KIDNAPPING AND ABDUCTION,0,0,0,0,0,0,0,0,0,0,0,0,0,0,0
JAMMU & KASHMIR,2011,DACOITY,0,0,0,0,0,0,0,0,0,0,0,0,0,0,0
JAMMU & KASHMIR,2011,PREP. AND ASSEMBLY FOR DACOITY,0,0,0,0,0,0,0,0,0,0,0,0,0,0,0
JAMMU & KASHMIR,2011,ROBBERY,0,0,0,0,0,0,0,0,0,0,0,0,0,0,0
JAMMU & KASHMIR,2011,BURGLARY,0,0,0,0,0,0,4,0,4,0,0,0,4,0,4
JAMMU & KASHMIR,2011,THEFTS,0,0,0,4,0,4,0,0,0,0,0,0,4,0,4
JAMMU & KASHMIR,2011,EXTORTION,0,0,0,0,0,0,0,0,0,0,0,0,0,0,0
JAMMU & KASHMIR,2011,RIOTS,0,0,0,0,0,0,0,0,0,0,0,0,0,0,0
JAMMU & KASHMIR,2011,ARSON,0,0,0,0,0,0,0,0,0,0,0,0,0,0,0
JAMMU & KASHMIR,2011,CRIMINAL BREACH OF TRUST,0,0,0,0,0,0,0,0,0,0,0,0,0,0,0
JAMMU & KASHMIR,2011,CHEATING,0,0,0,8,0,8,2,0,2,0,0,0,10,0,10
JAMMU & KASHMIR,2011,COUNTER FEITING,0,0,0,0,0,0,0,0,0,0,0,0,0,0,0
JAMMU & KASHMIR,2011,DOWRY DEATHS,0,0,0,0,0,0,0,0,0,0,0,0,0,0,0
JAMMU & KASHMIR,2011,MOLESTATION,0,0,0,0,0,0,0,0,0,0,0,0,0,0,0
JAMMU & KASHMIR,2011,EVE-TEASING,0,0,0,0,0,0,0,0,0,0,0,0,0,0,0
JAMMU & KASHMIR,2011,CRUELTY BY HUSBAND OR RELATIVE OF HUSBAND,0,0,0,0,0,0,0,0,0,0,0,0,0,0,0
JAMMU & KASHMIR,2011,OTHER IPC CRIMES,0,0,0,0,0,0,0,0,0,0,0,0,0,0,0
JAMMU & KASHMIR,2011,TOTAL IPC,0,0,0,62,1,63,101,3,104,62,6,68,225,10,235
JAMMU & KASHMIR,2012,MURDER,0,0,0,47,1,48,107,7,114,34,5,39,188,13,201
JAMMU & KASHMIR,2012,ATTEMPT TO COMMIT MURDER,0,0,0,2,0,2,2,0,2,1,0,1,5,0,5
JAMMU & KASHMIR,2012,C.H. NOT AMOUNTING TO MURDER,0,0,0,5,0,5,11,0,11,4,0,4,20,0,20
JAMMU & KASHMIR,2012,RAPE,0,0,0,17,0,17,23,0,23,3,0,3,43,0,43
JAMMU & KASHMIR,2012,KIDNAPPING AND ABDUCTION,0,0,0,0,0,0,0,0,0,0,0,0,0,0,0
JAMMU & KASHMIR,2012,DACOITY,0,0,0,0,0,0,0,0,0,0,0,0,0,0,0
JAMMU & KASHMIR,2012,PREP. AND ASSEMBLY FOR DACOITY,0,0,0,3,0,3,1,0,1,0,0,0,4,0,4
JAMMU & KASHMIR,2012,ROBBERY,0,0,0,0,0,0,0,0,0,0,0,0,0,0,0
JAMMU & KASHMIR,2012,BURGLARY,0,0,0,2,0,2,2,0,2,1,0,1,5,0,5
JAMMU & KASHMIR,2012,THEFTS,0,0,0,3,0,3,1,0,1,0,0,0,4,0,4
JAMMU & KASHMIR,2012,EXTORTION,0,0,0,0,0,0,0,0,0,0,0,0,0,0,0
JAMMU & KASHMIR,2012,RIOTS,0,0,0,5,0,5,0,0,0,0,0,0,5,0,5
JAMMU & KASHMIR,2012,ARSON,0,0,0,0,0,0,0,0,0,0,0,0,0,0,0
JAMMU & KASHMIR,2012,CRIMINAL BREACH OF TRUST,0,0,0,0,0,0,0,0,0,0,0,0,0,0,0
JAMMU & KASHMIR,2012,CHEATING,0,0,0,0,0,0,1,0,1,0,0,0,1,0,1
JAMMU & KASHMIR,2012,COUNTER FEITING,0,0,0,0,0,0,0,0,0,0,0,0,0,0,0
JAMMU & KASHMIR,2012,DOWRY DEATHS,0,0,0,0,0,0,0,0,0,0,0,0,0,0,0
JAMMU & KASHMIR,2012,MOLESTATION,0,0,0,0,0,0,0,0,0,0,0,0,0,0,0
JAMMU & KASHMIR,2012,EVE-TEASING,0,0,0,0,0,0,0,0,0,0,0,0,0,0,0
JAMMU & KASHMIR,2012,CRUELTY BY HUSBAND OR RELATIVE OF HUSBAND,0,0,0,0,0,0,0,0,0,0,0,0,0,0,0
JAMMU & KASHMIR,2012,OTHER IPC CRIMES,0,0,0,2,0,2,4,0,4,0,0,0,6,0,6
JAMMU & KASHMIR,2012,TOTAL IPC,0,0,0,86,1,87,152,7,159,43,5,48,281,13,294
JHARKHAND,2001,MURDER,11,0,11,500,9,509,700,10,710,126,2,128,1337,21,1358
JHARKHAND,2001,ATTEMPT TO COMMIT MURDER,1,0,1,20,0,20,43,0,43,9,0,9,73,0,73
JHARKHAND,2001,C.H. NOT AMOUNTING TO MURDER,0,0,0,14,0,14,19,6,25,40,2,42,73,8,81
JHARKHAND,2001,RAPE,2,0,2,84,0,84,139,0,139,16,0,16,241,0,241
JHARKHAND,2001,KIDNAPPING AND ABDUCTION,1,0,1,4,0,4,23,1,24,6,0,6,34,1,35
JHARKHAND,2001,DACOITY,0,0,0,9,1,10,44,0,44,19,0,19,72,1,73
JHARKHAND,2001,PREP. AND ASSEMBLY FOR DACOITY,0,0,0,7,0,7,16,0,16,0,0,0,23,0,23
JHARKHAND,2001,ROBBERY,1,0,1,2,0,2,27,0,27,3,0,3,33,0,33
JHARKHAND,2001,BURGLARY,0,0,0,2,0,2,6,0,6,0,0,0,8,0,8
JHARKHAND,2001,THEFTS,0,0,0,8,0,8,6,2,8,5,0,5,19,2,21
JHARKHAND,2001,EXTORTION,0,0,0,0,0,0,2,0,2,0,0,0,2,0,2
JHARKHAND,2001,RIOTS,0,0,0,0,0,0,0,0,0,0,0,0,0,0,0
JHARKHAND,2001,ARSON,0,0,0,0,0,0,7,0,7,8,0,8,15,0,15
JHARKHAND,2001,CRIMINAL BREACH OF TRUST,0,0,0,0,0,0,0,0,0,0,0,0,0,0,0
JHARKHAND,2001,CHEATING,0,0,0,0,0,0,0,0,0,2,0,2,2,0,2
JHARKHAND,2001,COUNTER FEITING,0,0,0,0,0,0,0,0,0,0,0,0,0,0,0
JHARKHAND,2001,DOWRY DEATHS,0,0,0,18,3,21,194,8,202,105,3,108,317,14,331
JHARKHAND,2001,MOLESTATION,0,0,0,0,0,0,0,0,0,1,0,1,1,0,1
JHARKHAND,2001,EVE-TEASING,0,0,0,0,0,0,8,0,8,0,0,0,8,0,8
JHARKHAND,2001,CRUELTY BY HUSBAND OR RELATIVE OF HUSBAND,0,0,0,0,0,0,1,0,1,0,0,0,1,0,1
JHARKHAND,2001,OTHER IPC CRIMES,0,0,0,21,0,21,2,0,2,0,0,0,23,0,23
JHARKHAND,2001,TOTAL IPC,16,0,16,689,13,702,1237,27,1264,340,7,347,2282,47,2329
JHARKHAND,2002,MURDER,7,0,7,549,11,560,1027,16,1043,242,2,244,1825,29,1854
JHARKHAND,2002,ATTEMPT TO COMMIT MURDER,7,0,7,49,2,51,50,1,51,85,1,86,191,4,195
JHARKHAND,2002,C.H. NOT AMOUNTING TO MURDER,0,0,0,24,2,26,26,1,27,32,0,32,82,3,85
JHARKHAND,2002,RAPE,0,0,0,75,0,75,65,0,65,6,0,6,146,0,146
JHARKHAND,2002,KIDNAPPING AND ABDUCTION,0,0,0,22,0,22,24,4,28,1,0,1,47,4,51
JHARKHAND,2002,DACOITY,0,0,0,39,0,39,34,0,34,1,0,1,74,0,74
JHARKHAND,2002,PREP. AND ASSEMBLY FOR DACOITY,0,0,0,7,0,7,8,0,8,0,0,0,15,0,15
JHARKHAND,2002,ROBBERY,0,0,0,19,0,19,12,0,12,0,0,0,31,0,31
JHARKHAND,2002,BURGLARY,0,0,0,3,0,3,0,0,0,0,0,0,3,0,3
JHARKHAND,2002,THEFTS,2,0,2,38,0,38,25,1,26,0,0,0,65,1,66
JHARKHAND,2002,EXTORTION,0,0,0,0,0,0,0,0,0,0,0,0,0,0,0
JHARKHAND,2002,RIOTS,0,0,0,0,0,0,0,0,0,0,0,0,0,0,0
JHARKHAND,2002,ARSON,0,0,0,0,0,0,0,0,0,0,0,0,0,0,0
JHARKHAND,2002,CRIMINAL BREACH OF TRUST,0,0,0,0,0,0,1,0,1,2,0,2,3,0,3
JHARKHAND,2002,CHEATING,0,0,0,20,1,21,12,0,12,20,0,20,52,1,53
JHARKHAND,2002,COUNTER FEITING,0,0,0,0,0,0,0,0,0,0,0,0,0,0,0
JHARKHAND,2002,DOWRY DEATHS,0,0,0,67,8,75,98,16,114,12,4,16,177,28,205
JHARKHAND,2002,MOLESTATION,0,0,0,0,0,0,0,0,0,0,0,0,0,0,0
JHARKHAND,2002,EVE-TEASING,0,0,0,0,0,0,0,0,0,0,0,0,0,0,0
JHARKHAND,2002,CRUELTY BY HUSBAND OR RELATIVE OF HUSBAND,0,0,0,10,0,10,12,0,12,0,0,0,22,0,22
JHARKHAND,2002,OTHER IPC CRIMES,0,0,0,2,0,2,0,0,0,0,0,0,2,0,2
JHARKHAND,2002,TOTAL IPC,16,0,16,924,24,948,1394,39,1433,401,7,408,2735,70,2805
JHARKHAND,2003,MURDER,0,0,0,550,8,558,1229,27,1256,433,4,437,2212,39,2251
JHARKHAND,2003,ATTEMPT TO COMMIT MURDER,0,0,0,91,5,96,87,5,92,22,0,22,200,10,210
JHARKHAND,2003,C.H. NOT AMOUNTING TO MURDER,0,0,0,75,1,76,49,5,54,14,0,14,138,6,144
JHARKHAND,2003,RAPE,2,0,2,208,0,208,164,1,165,29,0,29,403,1,404
JHARKHAND,2003,KIDNAPPING AND ABDUCTION,0,0,0,38,1,39,50,2,52,6,0,6,94,3,97
JHARKHAND,2003,DACOITY,7,0,7,106,0,106,144,0,144,5,0,5,262,0,262
JHARKHAND,2003,PREP. AND ASSEMBLY FOR DACOITY,0,0,0,37,0,37,1,0,1,0,0,0,38,0,38
JHARKHAND,2003,ROBBERY,5,0,5,64,0,64,15,2,17,2,0,2,86,2,88
JHARKHAND,2003,BURGLARY,0,0,0,6,0,6,2,0,2,0,0,0,8,0,8
JHARKHAND,2003,THEFTS,8,0,8,56,0,56,32,2,34,5,0,5,101,2,103
JHARKHAND,2003,EXTORTION,0,0,0,2,0,2,3,0,3,1,0,1,6,0,6
JHARKHAND,2003,RIOTS,0,0,0,0,0,0,1,0,1,0,0,0,1,0,1
JHARKHAND,2003,ARSON,0,0,0,0,0,0,3,0,3,3,0,3,6,0,6
JHARKHAND,2003,CRIMINAL BREACH OF TRUST,0,0,0,0,0,0,0,0,0,0,0,0,0,0,0
JHARKHAND,2003,CHEATING,0,0,0,0,0,0,0,0,0,0,0,0,0,0,0
JHARKHAND,2003,COUNTER FEITING,0,0,0,0,0,0,3,0,3,1,0,1,4,0,4
JHARKHAND,2003,DOWRY DEATHS,0,0,0,212,19,231,98,29,127,80,15,95,390,63,453
JHARKHAND,2003,MOLESTATION,0,0,0,1,0,1,0,0,0,0,0,0,1,0,1
JHARKHAND,2003,EVE-TEASING,0,0,0,0,0,0,0,0,0,0,0,0,0,0,0
JHARKHAND,2003,CRUELTY BY HUSBAND OR RELATIVE OF HUSBAND,0,0,0,2,0,2,9,0,9,4,0,4,15,0,15
JHARKHAND,2003,OTHER IPC CRIMES,0,0,0,6,0,6,12,0,12,1,0,1,19,0,19
JHARKHAND,2003,TOTAL IPC,22,0,22,1454,34,1488,1902,73,1975,606,19,625,3984,126,4110
JHARKHAND,2004,MURDER,0,0,0,850,30,880,1869,43,1912,686,10,696,3405,83,3488
JHARKHAND,2004,ATTEMPT TO COMMIT MURDER,0,0,0,81,3,84,106,2,108,24,1,25,211,6,217
JHARKHAND,2004,C.H. NOT AMOUNTING TO MURDER,0,0,0,41,1,42,43,0,43,4,0,4,88,1,89
JHARKHAND,2004,RAPE,0,0,0,166,0,166,211,1,212,58,0,58,435,1,436
JHARKHAND,2004,KIDNAPPING AND ABDUCTION,0,0,0,37,1,38,34,3,37,5,1,6,76,5,81
JHARKHAND,2004,DACOITY,0,0,0,64,0,64,45,0,45,12,0,12,121,0,121
JHARKHAND,2004,PREP. AND ASSEMBLY FOR DACOITY,0,0,0,12,0,12,9,0,9,0,0,0,21,0,21
JHARKHAND,2004,ROBBERY,0,0,0,27,0,27,18,0,18,4,0,4,49,0,49
JHARKHAND,2004,BURGLARY,0,0,0,8,0,8,5,0,5,2,0,2,15,0,15
JHARKHAND,2004,THEFTS,0,0,0,32,1,33,28,0,28,9,0,9,69,1,70
JHARKHAND,2004,EXTORTION,0,0,0,0,0,0,17,0,17,0,0,0,17,0,17
JHARKHAND,2004,RIOTS,0,0,0,0,0,0,0,0,0,0,0,0,0,0,0
JHARKHAND,2004,ARSON,0,0,0,0,0,0,1,0,1,0,0,0,1,0,1
JHARKHAND,2004,CRIMINAL BREACH OF TRUST,0,0,0,0,0,0,4,0,4,0,0,0,4,0,4
JHARKHAND,2004,CHEATING,0,0,0,0,0,0,5,0,5,4,0,4,9,0,9
JHARKHAND,2004,COUNTER FEITING,0,0,0,0,0,0,0,0,0,0,0,0,0,0,0
JHARKHAND,2004,DOWRY DEATHS,0,0,0,45,7,52,84,20,104,55,7,62,184,34,218
JHARKHAND,2004,MOLESTATION,0,0,0,0,0,0,0,0,0,0,0,0,0,0,0
JHARKHAND,2004,EVE-TEASING,0,0,0,0,0,0,0,0,0,0,0,0,0,0,0
JHARKHAND,2004,CRUELTY BY HUSBAND OR RELATIVE OF HUSBAND,0,0,0,2,0,2,6,0,6,2,0,2,10,0,10
JHARKHAND,2004,OTHER IPC CRIMES,0,0,0,0,0,0,1,0,1,0,0,0,1,0,1
JHARKHAND,2004,TOTAL IPC,0,0,0,1365,43,1408,2486,69,2555,865,19,884,4716,131,4847
JHARKHAND,2005,MURDER,0,0,0,982,17,999,1555,41,1596,796,9,805,3333,67,3400
JHARKHAND,2005,ATTEMPT TO COMMIT MURDER,0,0,0,94,2,96,79,5,84,18,0,18,191,7,198
JHARKHAND,2005,C.H. NOT AMOUNTING TO MURDER,0,0,0,26,5,31,53,2,55,14,1,15,93,8,101
JHARKHAND,2005,RAPE,0,0,0,195,1,196,149,0,149,48,0,48,392,1,393
JHARKHAND,2005,KIDNAPPING AND ABDUCTION,0,0,0,29,3,32,53,2,55,7,1,8,89,6,95
JHARKHAND,2005,DACOITY,0,0,0,90,0,90,96,1,97,25,0,25,211,1,212
JHARKHAND,2005,PREP. AND ASSEMBLY FOR DACOITY,0,0,0,10,0,10,11,0,11,0,0,0,21,0,21
JHARKHAND,2005,ROBBERY,0,0,0,22,0,22,17,0,17,4,0,4,43,0,43
JHARKHAND,2005,BURGLARY,0,0,0,7,0,7,11,0,11,0,0,0,18,0,18
JHARKHAND,2005,THEFTS,0,0,0,96,0,96,79,0,79,16,0,16,191,0,191
JHARKHAND,2005,EXTORTION,0,0,0,10,0,10,13,0,13,2,0,2,25,0,25
JHARKHAND,2005,RIOTS,0,0,0,0,0,0,0,0,0,0,0,0,0,0,0
JHARKHAND,2005,ARSON,0,0,0,0,0,0,0,0,0,0,0,0,0,0,0
JHARKHAND,2005,CRIMINAL BREACH OF TRUST,0,0,0,0,0,0,5,0,5,1,0,1,6,0,6
JHARKHAND,2005,CHEATING,0,0,0,3,0,3,1,0,1,1,0,1,5,0,5
JHARKHAND,2005,COUNTER FEITING,0,0,0,0,0,0,0,0,0,0,0,0,0,0,0
JHARKHAND,2005,DOWRY DEATHS,0,0,0,88,17,105,103,21,124,48,10,58,239,48,287
JHARKHAND,2005,MOLESTATION,0,0,0,0,0,0,0,0,0,0,0,0,0,0,0
JHARKHAND,2005,EVE-TEASING,0,0,0,0,0,0,5,0,5,0,0,0,5,0,5
JHARKHAND,2005,CRUELTY BY HUSBAND OR RELATIVE OF HUSBAND,0,0,0,25,0,25,9,11,20,4,1,5,38,12,50
JHARKHAND,2005,OTHER IPC CRIMES,0,0,0,0,0,0,1,0,1,0,0,0,1,0,1
JHARKHAND,2005,TOTAL IPC,0,0,0,1677,45,1722,2240,83,2323,984,22,1006,4901,150,5051
JHARKHAND,2006,MURDER,0,0,0,1312,29,1341,2738,57,2795,716,11,727,4766,97,4863
JHARKHAND,2006,ATTEMPT TO COMMIT MURDER,0,0,0,135,6,141,138,7,145,18,3,21,291,16,307
JHARKHAND,2006,C.H. NOT AMOUNTING TO MURDER,0,0,0,37,8,45,72,7,79,8,0,8,117,15,132
JHARKHAND,2006,RAPE,0,0,0,284,0,284,241,0,241,46,0,46,571,0,571
JHARKHAND,2006,KIDNAPPING AND ABDUCTION,0,0,0,42,1,43,84,3,87,14,0,14,140,4,144
JHARKHAND,2006,DACOITY,0,0,0,134,0,134,103,0,103,15,0,15,252,0,252
JHARKHAND,2006,PREP. AND ASSEMBLY FOR DACOITY,0,0,0,10,0,10,9,0,9,1,0,1,20,0,20
JHARKHAND,2006,ROBBERY,0,0,0,33,1,34,22,0,22,0,0,0,55,1,56
JHARKHAND,2006,BURGLARY,0,0,0,3,0,3,2,0,2,0,0,0,5,0,5
JHARKHAND,2006,THEFTS,0,0,0,125,0,125,124,0,124,13,0,13,262,0,262
JHARKHAND,2006,EXTORTION,0,0,0,7,0,7,5,0,5,0,0,0,12,0,12
JHARKHAND,2006,RIOTS,0,0,0,0,0,0,0,0,0,0,0,0,0,0,0
JHARKHAND,2006,ARSON,0,0,0,0,0,0,1,0,1,0,0,0,1,0,1
JHARKHAND,2006,CRIMINAL BREACH OF TRUST,0,0,0,4,0,4,5,0,5,0,0,0,9,0,9
JHARKHAND,2006,CHEATING,0,0,0,3,0,3,2,0,2,1,0,1,6,0,6
JHARKHAND,2006,COUNTER FEITING,0,0,0,0,0,0,3,0,3,0,0,0,3,0,3
JHARKHAND,2006,DOWRY DEATHS,0,0,0,93,30,123,186,56,242,47,20,67,326,106,432
JHARKHAND,2006,MOLESTATION,0,0,0,0,0,0,0,0,0,0,0,0,0,0,0
JHARKHAND,2006,EVE-TEASING,0,0,0,0,0,0,0,0,0,0,0,0,0,0,0
JHARKHAND,2006,CRUELTY BY HUSBAND OR RELATIVE OF HUSBAND,0,0,0,51,0,51,29,0,29,8,1,9,88,1,89
JHARKHAND,2006,OTHER IPC CRIMES,0,0,0,4,0,4,7,0,7,0,0,0,11,0,11
JHARKHAND,2006,TOTAL IPC,0,0,0,2277,75,2352,3771,130,3901,887,35,922,6935,240,7175
JHARKHAND,2007,MURDER,0,0,0,1064,27,1091,1992,35,2027,543,24,567,3599,86,3685
JHARKHAND,2007,ATTEMPT TO COMMIT MURDER,0,0,0,100,4,104,138,4,142,50,3,53,288,11,299
JHARKHAND,2007,C.H. NOT AMOUNTING TO MURDER,0,0,0,20,0,20,29,0,29,23,0,23,72,0,72
JHARKHAND,2007,RAPE,0,0,0,131,0,131,148,0,148,31,0,31,310,0,310
JHARKHAND,2007,KIDNAPPING AND ABDUCTION,0,0,0,68,5,73,80,3,83,13,1,14,161,9,170
JHARKHAND,2007,DACOITY,0,0,0,115,1,116,120,0,120,15,0,15,250,1,251
JHARKHAND,2007,PREP. AND ASSEMBLY FOR DACOITY,0,0,0,6,2,8,2,0,2,1,0,1,9,2,11
JHARKHAND,2007,ROBBERY,0,0,0,32,0,32,57,0,57,10,0,10,99,0,99
JHARKHAND,2007,BURGLARY,0,0,0,2,0,2,0,0,0,0,0,0,2,0,2
JHARKHAND,2007,THEFTS,0,0,0,64,3,67,71,3,74,8,0,8,143,6,149
JHARKHAND,2007,EXTORTION,0,0,0,22,0,22,5,0,5,1,0,1,28,0,28
JHARKHAND,2007,RIOTS,0,0,0,0,0,0,0,0,0,0,0,0,0,0,0
JHARKHAND,2007,ARSON,0,0,0,36,0,36,4,1,5,0,0,0,40,1,41
JHARKHAND,2007,CRIMINAL BREACH OF TRUST,0,0,0,0,0,0,0,0,0,1,0,1,1,0,1
JHARKHAND,2007,CHEATING,0,0,0,35,0,35,0,0,0,0,0,0,35,0,35
JHARKHAND,2007,COUNTER FEITING,0,0,0,1,0,1,0,0,0,0,0,0,1,0,1
JHARKHAND,2007,DOWRY DEATHS,0,0,0,133,10,143,125,41,166,94,6,100,352,57,409
JHARKHAND,2007,MOLESTATION,0,0,0,8,0,8,0,0,0,0,0,0,8,0,8
JHARKHAND,2007,EVE-TEASING,0,0,0,0,0,0,0,0,0,0,0,0,0,0,0
JHARKHAND,2007,CRUELTY BY HUSBAND OR RELATIVE OF HUSBAND,0,0,0,12,0,12,8,2,10,3,0,3,23,2,25
JHARKHAND,2007,OTHER IPC CRIMES,0,0,0,0,1,1,11,2,13,2,1,3,13,4,17
JHARKHAND,2007,TOTAL IPC,0,0,0,1849,53,1902,2790,91,2881,795,35,830,5434,179,5613
JHARKHAND,2008,MURDER,0,0,0,1162,14,1176,1922,38,1960,718,13,731,3802,65,3867
JHARKHAND,2008,ATTEMPT TO COMMIT MURDER,0,0,0,85,9,94,181,7,188,32,2,34,298,18,316
JHARKHAND,2008,C.H. NOT AMOUNTING TO MURDER,0,0,0,15,1,16,25,0,25,14,0,14,54,1,55
JHARKHAND,2008,RAPE,0,0,0,162,0,162,184,0,184,46,0,46,392,0,392
JHARKHAND,2008,KIDNAPPING AND ABDUCTION,0,0,0,78,3,81,68,1,69,7,3,10,153,7,160
JHARKHAND,2008,DACOITY,0,0,0,78,3,81,96,1,97,16,3,19,190,7,197
JHARKHAND,2008,PREP. AND ASSEMBLY FOR DACOITY,0,0,0,2,0,2,3,0,3,0,0,0,5,0,5
JHARKHAND,2008,ROBBERY,0,0,0,20,1,21,39,0,39,4,2,6,63,3,66
JHARKHAND,2008,BURGLARY,0,0,0,5,0,5,4,0,4,0,0,0,9,0,9
JHARKHAND,2008,THEFTS,0,0,0,38,4,42,31,0,31,8,2,10,77,6,83
JHARKHAND,2008,EXTORTION,0,0,0,0,0,0,0,0,0,0,2,2,0,2,2
JHARKHAND,2008,RIOTS,0,0,0,0,0,0,0,0,0,0,0,0,0,0,0
JHARKHAND,2008,ARSON,0,0,0,0,0,0,6,0,6,0,0,0,6,0,6
JHARKHAND,2008,CRIMINAL BREACH OF TRUST,0,0,0,0,0,0,8,0,8,0,0,0,8,0,8
JHARKHAND,2008,CHEATING,0,0,0,1,0,1,4,0,4,0,0,0,5,0,5
JHARKHAND,2008,COUNTER FEITING,0,0,0,0,0,0,4,0,4,0,0,0,4,0,4
JHARKHAND,2008,DOWRY DEATHS,0,0,0,72,19,91,77,22,99,50,8,58,199,49,248
JHARKHAND,2008,MOLESTATION,0,0,0,0,0,0,0,0,0,0,0,0,0,0,0
JHARKHAND,2008,EVE-TEASING,0,0,0,0,0,0,0,0,0,0,0,0,0,0,0
JHARKHAND,2008,CRUELTY BY HUSBAND OR RELATIVE OF HUSBAND,0,0,0,10,3,13,9,2,11,8,0,8,27,5,32
JHARKHAND,2008,OTHER IPC CRIMES,0,0,0,8,0,8,16,0,16,1,0,1,25,0,25
JHARKHAND,2008,TOTAL IPC,0,0,0,1736,57,1793,2677,71,2748,904,35,939,5317,163,5480
JHARKHAND,2009,MURDER,0,0,0,1129,28,1157,2007,72,2079,762,17,779,3898,117,4015
JHARKHAND,2009,ATTEMPT TO COMMIT MURDER,0,0,0,86,0,86,60,0,60,32,0,32,178,0,178
JHARKHAND,2009,C.H. NOT AMOUNTING TO MURDER,0,0,0,2,0,2,14,0,14,9,0,9,25,0,25
JHARKHAND,2009,RAPE,0,0,0,178,0,178,111,0,111,27,0,27,316,0,316
JHARKHAND,2009,KIDNAPPING AND ABDUCTION,0,0,0,98,0,98,58,1,59,10,0,10,166,1,167
JHARKHAND,2009,DACOITY,0,0,0,88,0,88,44,0,44,9,0,9,141,0,141
JHARKHAND,2009,PREP. AND ASSEMBLY FOR DACOITY,0,0,0,4,0,4,2,0,2,0,0,0,6,0,6
JHARKHAND,2009,ROBBERY,0,0,0,47,0,47,20,0,20,1,0,1,68,0,68
JHARKHAND,2009,BURGLARY,0,0,0,0,0,0,0,0,0,0,0,0,0,0,0
JHARKHAND,2009,THEFTS,0,0,0,55,0,55,29,0,29,11,0,11,95,0,95
JHARKHAND,2009,EXTORTION,0,0,0,8,0,8,1,0,1,1,0,1,10,0,10
JHARKHAND,2009,RIOTS,0,0,0,0,0,0,0,0,0,0,0,0,0,0,0
JHARKHAND,2009,ARSON,0,0,0,0,0,0,2,0,2,0,0,0,2,0,2
JHARKHAND,2009,CRIMINAL BREACH OF TRUST,0,0,0,1,0,1,1,0,1,2,0,2,4,0,4
JHARKHAND,2009,CHEATING,0,0,0,0,0,0,3,0,3,2,0,2,5,0,5
JHARKHAND,2009,COUNTER FEITING,0,0,0,0,0,0,0,0,0,0,0,0,0,0,0
JHARKHAND,2009,DOWRY DEATHS,0,0,0,76,11,87,79,18,97,41,18,59,196,47,243
JHARKHAND,2009,MOLESTATION,0,0,0,0,0,0,0,0,0,0,0,0,0,0,0
JHARKHAND,2009,EVE-TEASING,0,0,0,0,0,0,0,0,0,0,0,0,0,0,0
JHARKHAND,2009,CRUELTY BY HUSBAND OR RELATIVE OF HUSBAND,0,0,0,16,0,16,20,1,21,3,0,3,39,1,40
JHARKHAND,2009,OTHER IPC CRIMES,0,0,0,5,0,5,19,0,19,0,0,0,24,0,24
JHARKHAND,2009,TOTAL IPC,0,0,0,1793,39,1832,2470,92,2562,910,35,945,5173,166,5339
JHARKHAND,2010,MURDER,0,0,0,1164,20,1184,1852,52,1904,658,14,672,3674,86,3760
JHARKHAND,2010,ATTEMPT TO COMMIT MURDER,0,0,0,61,2,63,64,3,67,50,4,54,175,9,184
JHARKHAND,2010,C.H. NOT AMOUNTING TO MURDER,0,0,0,34,0,34,17,0,17,13,0,13,64,0,64
JHARKHAND,2010,RAPE,0,0,0,118,0,118,110,0,110,31,0,31,259,0,259
JHARKHAND,2010,KIDNAPPING AND ABDUCTION,0,0,0,81,1,82,46,3,49,11,0,11,138,4,142
JHARKHAND,2010,DACOITY,0,0,0,36,0,36,33,0,33,5,0,5,74,0,74
JHARKHAND,2010,PREP. AND ASSEMBLY FOR DACOITY,0,0,0,38,0,38,5,0,5,0,0,0,43,0,43
JHARKHAND,2010,ROBBERY,0,0,0,20,0,20,26,0,26,2,0,2,48,0,48
JHARKHAND,2010,BURGLARY,0,0,0,21,0,21,3,0,3,0,0,0,24,0,24
JHARKHAND,2010,THEFTS,0,0,0,25,0,25,25,0,25,5,0,5,55,0,55
JHARKHAND,2010,EXTORTION,0,0,0,3,0,3,2,0,2,0,0,0,5,0,5
JHARKHAND,2010,RIOTS,0,0,0,0,0,0,0,0,0,0,0,0,0,0,0
JHARKHAND,2010,ARSON,0,0,0,0,0,0,4,1,5,0,0,0,4,1,5
JHARKHAND,2010,CRIMINAL BREACH OF TRUST,0,0,0,0,1,1,1,0,1,1,0,1,2,1,3
JHARKHAND,2010,CHEATING,0,0,0,0,0,0,3,0,3,0,0,0,3,0,3
JHARKHAND,2010,COUNTER FEITING,0,0,0,0,0,0,0,0,0,0,0,0,0,0,0
JHARKHAND,2010,DOWRY DEATHS,0,0,0,65,10,75,72,37,109,47,10,57,184,57,241
JHARKHAND,2010,MOLESTATION,0,0,0,0,0,0,0,0,0,0,0,0,0,0,0
JHARKHAND,2010,EVE-TEASING,0,0,0,0,0,0,0,0,0,0,0,0,0,0,0
JHARKHAND,2010,CRUELTY BY HUSBAND OR RELATIVE OF HUSBAND,0,0,0,15,0,15,16,0,16,4,0,4,35,0,35
JHARKHAND,2010,OTHER IPC CRIMES,0,0,0,1,0,1,19,0,19,0,0,0,20,0,20
JHARKHAND,2010,TOTAL IPC,0,0,0,1682,34,1716,2298,96,2394,827,28,855,4807,158,4965
JHARKHAND,2011,MURDER,0,0,0,793,18,811,1639,40,1679,460,21,481,2892,79,2971
JHARKHAND,2011,ATTEMPT TO COMMIT MURDER,0,0,0,45,1,46,83,2,85,32,3,35,160,6,166
JHARKHAND,2011,C.H. NOT AMOUNTING TO MURDER,0,0,0,22,0,22,4,0,4,3,0,3,29,0,29
JHARKHAND,2011,RAPE,0,0,0,102,0,102,94,0,94,12,0,12,208,0,208
JHARKHAND,2011,KIDNAPPING AND ABDUCTION,0,0,0,59,2,61,62,2,64,14,1,15,135,5,140
JHARKHAND,2011,DACOITY,0,0,0,46,0,46,60,0,60,10,0,10,116,0,116
JHARKHAND,2011,PREP. AND ASSEMBLY FOR DACOITY,0,0,0,22,0,22,8,0,8,2,0,2,32,0,32
JHARKHAND,2011,ROBBERY,0,0,0,18,0,18,10,0,10,2,0,2,30,0,30
JHARKHAND,2011,BURGLARY,0,0,0,17,0,17,8,0,8,4,0,4,29,0,29
JHARKHAND,2011,THEFTS,0,0,0,44,1,45,47,2,49,3,1,4,94,4,98
JHARKHAND,2011,EXTORTION,0,0,0,1,0,1,4,0,4,0,0,0,5,0,5
JHARKHAND,2011,RIOTS,0,0,0,0,0,0,0,0,0,0,0,0,0,0,0
JHARKHAND,2011,ARSON,0,0,0,0,0,0,6,0,6,0,0,0,6,0,6
JHARKHAND,2011,CRIMINAL BREACH OF TRUST,0,0,0,0,0,0,1,0,1,0,0,0,1,0,1
JHARKHAND,2011,CHEATING,0,0,0,2,0,2,5,1,6,0,0,0,7,1,8
JHARKHAND,2011,COUNTER FEITING,0,0,0,1,0,1,5,0,5,2,0,2,8,0,8
JHARKHAND,2011,DOWRY DEATHS,0,0,0,61,6,67,77,19,96,35,12,47,173,37,210
JHARKHAND,2011,MOLESTATION,0,0,0,0,0,0,0,0,0,0,0,0,0,0,0
JHARKHAND,2011,EVE-TEASING,0,0,0,0,0,0,0,0,0,0,0,0,0,0,0
JHARKHAND,2011,CRUELTY BY HUSBAND OR RELATIVE OF HUSBAND,0,0,0,8,0,8,30,0,30,0,0,0,38,0,38
JHARKHAND,2011,OTHER IPC CRIMES,0,0,0,0,1,1,7,0,7,0,0,0,7,1,8
JHARKHAND,2011,TOTAL IPC,0,0,0,1241,29,1270,2150,66,2216,579,38,617,3970,133,4103
JHARKHAND,2012,MURDER,0,0,0,773,13,786,1492,51,1543,469,14,483,2734,78,2812
JHARKHAND,2012,ATTEMPT TO COMMIT MURDER,0,0,0,45,2,47,101,3,104,52,2,54,198,7,205
JHARKHAND,2012,C.H. NOT AMOUNTING TO MURDER,0,0,0,2,0,2,12,1,13,4,0,4,18,1,19
JHARKHAND,2012,RAPE,0,0,0,76,0,76,102,0,102,21,0,21,199,0,199
JHARKHAND,2012,KIDNAPPING AND ABDUCTION,0,0,0,34,1,35,58,0,58,19,0,19,111,1,112
JHARKHAND,2012,DACOITY,0,0,0,46,0,46,72,0,72,11,0,11,129,0,129
JHARKHAND,2012,PREP. AND ASSEMBLY FOR DACOITY,0,0,0,5,0,5,7,0,7,0,0,0,12,0,12
JHARKHAND,2012,ROBBERY,0,0,0,12,0,12,18,0,18,10,0,10,40,0,40
JHARKHAND,2012,BURGLARY,0,0,0,3,0,3,1,0,1,0,0,0,4,0,4
JHARKHAND,2012,THEFTS,0,0,0,43,0,43,48,1,49,8,0,8,99,1,100
JHARKHAND,2012,EXTORTION,0,0,0,6,0,6,17,0,17,0,0,0,23,0,23
JHARKHAND,2012,RIOTS,0,0,0,0,0,0,0,0,0,0,0,0,0,0,0
JHARKHAND,2012,ARSON,0,0,0,0,0,0,1,0,1,0,0,0,1,0,1
JHARKHAND,2012,CRIMINAL BREACH OF TRUST,0,0,0,2,0,2,7,0,7,0,0,0,9,0,9
JHARKHAND,2012,CHEATING,0,0,0,6,0,6,18,0,18,0,0,0,24,0,24
JHARKHAND,2012,COUNTER FEITING,0,0,0,0,0,0,0,0,0,0,0,0,0,0,0
JHARKHAND,2012,DOWRY DEATHS,0,0,0,50,11,61,86,24,110,56,19,75,192,54,246
JHARKHAND,2012,MOLESTATION,0,0,0,0,0,0,1,0,1,0,0,0,1,0,1
JHARKHAND,2012,EVE-TEASING,0,0,0,1,0,1,0,0,0,0,0,0,1,0,1
JHARKHAND,2012,CRUELTY BY HUSBAND OR RELATIVE OF HUSBAND,0,0,0,8,0,8,29,1,30,1,0,1,38,1,39
JHARKHAND,2012,OTHER IPC CRIMES,0,0,0,3,0,3,7,0,7,0,0,0,10,0,10
JHARKHAND,2012,TOTAL IPC,0,0,0,1115,27,1142,2077,81,2158,651,35,686,3843,143,3986
KARNATAKA,2001,MURDER,0,0,0,663,9,672,481,26,507,42,0,42,1186,35,1221
KARNATAKA,2001,ATTEMPT TO COMMIT MURDER,0,0,0,17,0,17,12,0,12,2,0,2,31,0,31
KARNATAKA,2001,C.H. NOT AMOUNTING TO MURDER,0,0,0,0,0,0,6,0,6,2,0,2,8,0,8
KARNATAKA,2001,RAPE,3,0,3,18,0,18,24,0,24,0,0,0,45,0,45
KARNATAKA,2001,KIDNAPPING AND ABDUCTION,0,0,0,7,0,7,3,0,3,0,0,0,10,0,10
KARNATAKA,2001,DACOITY,0,0,0,13,0,13,15,0,15,1,0,1,29,0,29
KARNATAKA,2001,PREP. AND ASSEMBLY FOR DACOITY,0,0,0,0,0,0,5,0,5,0,0,0,5,0,5
KARNATAKA,2001,ROBBERY,3,0,3,5,0,5,3,0,3,2,0,2,13,0,13
KARNATAKA,2001,BURGLARY,7,0,7,21,2,23,11,0,11,12,0,12,51,2,53
KARNATAKA,2001,THEFTS,7,0,7,10,0,10,10,0,10,1,0,1,28,0,28
KARNATAKA,2001,EXTORTION,3,0,3,11,0,11,9,0,9,0,0,0,23,0,23
KARNATAKA,2001,RIOTS,0,0,0,0,0,0,0,0,0,3,0,3,3,0,3
KARNATAKA,2001,ARSON,1,0,1,7,0,7,3,0,3,1,0,1,12,0,12
KARNATAKA,2001,CRIMINAL BREACH OF TRUST,0,0,0,0,0,0,0,0,0,2,0,2,2,0,2
KARNATAKA,2001,CHEATING,0,0,0,11,0,11,3,1,4,4,0,4,18,1,19
KARNATAKA,2001,COUNTER FEITING,0,0,0,0,0,0,0,0,0,0,0,0,0,0,0
KARNATAKA,2001,DOWRY DEATHS,0,0,0,8,0,8,12,0,12,2,1,3,22,1,23
KARNATAKA,2001,MOLESTATION,0,0,0,2,0,2,1,0,1,0,0,0,3,0,3
KARNATAKA,2001,EVE-TEASING,0,0,0,6,0,6,3,0,3,0,0,0,9,0,9
KARNATAKA,2001,CRUELTY BY HUSBAND OR RELATIVE OF HUSBAND,0,0,0,4,0,4,9,0,9,0,0,0,13,0,13
KARNATAKA,2001,OTHER IPC CRIMES,2,0,2,9,0,9,8,0,8,15,0,15,34,0,34
KARNATAKA,2001,TOTAL IPC,26,0,26,812,11,823,618,27,645,89,1,90,1545,39,1584
KARNATAKA,2002,MURDER,0,0,0,878,18,896,405,23,428,68,1,69,1351,42,1393
KARNATAKA,2002,ATTEMPT TO COMMIT MURDER,0,0,0,11,0,11,34,0,34,6,0,6,51,0,51
KARNATAKA,2002,C.H. NOT AMOUNTING TO MURDER,0,0,0,0,0,0,0,0,0,4,0,4,4,0,4
KARNATAKA,2002,RAPE,3,0,3,17,0,17,9,0,9,0,0,0,29,0,29
KARNATAKA,2002,KIDNAPPING AND ABDUCTION,0,0,0,15,0,15,17,0,17,0,0,0,32,0,32
KARNATAKA,2002,DACOITY,0,0,0,38,0,38,9,0,9,0,0,0,47,0,47
KARNATAKA,2002,PREP. AND ASSEMBLY FOR DACOITY,0,0,0,0,0,0,6,0,6,0,0,0,6,0,6
KARNATAKA,2002,ROBBERY,0,0,0,33,0,33,7,0,7,2,0,2,42,0,42
KARNATAKA,2002,BURGLARY,0,0,0,7,0,7,11,0,11,2,0,2,20,0,20
KARNATAKA,2002,THEFTS,7,0,7,52,8,60,41,0,41,9,0,9,109,8,117
KARNATAKA,2002,EXTORTION,0,0,0,0,0,0,0,0,0,0,0,0,0,0,0
KARNATAKA,2002,RIOTS,0,0,0,0,0,0,6,0,6,0,0,0,6,0,6
KARNATAKA,2002,ARSON,0,0,0,0,0,0,0,0,0,0,0,0,0,0,0
KARNATAKA,2002,CRIMINAL BREACH OF TRUST,0,0,0,0,0,0,8,0,8,0,0,0,8,0,8
KARNATAKA,2002,CHEATING,0,0,0,39,3,42,34,6,40,3,0,3,76,9,85
KARNATAKA,2002,COUNTER FEITING,0,0,0,0,0,0,2,0,2,0,0,0,2,0,2
KARNATAKA,2002,DOWRY DEATHS,0,0,0,6,0,6,12,4,16,8,0,8,26,4,30
KARNATAKA,2002,MOLESTATION,0,0,0,0,0,0,0,0,0,0,0,0,0,0,0
KARNATAKA,2002,EVE-TEASING,0,0,0,0,0,0,0,0,0,0,0,0,0,0,0
KARNATAKA,2002,CRUELTY BY HUSBAND OR RELATIVE OF HUSBAND,0,0,0,6,0,6,8,0,8,2,0,2,16,0,16
KARNATAKA,2002,OTHER IPC CRIMES,7,0,7,32,3,35,52,1,53,28,0,28,119,4,123
KARNATAKA,2002,TOTAL IPC,17,0,17,1134,32,1166,661,34,695,132,1,133,1944,67,2011
KARNATAKA,2003,MURDER,1,0,1,1212,29,1241,506,22,528,91,2,93,1810,53,1863
KARNATAKA,2003,ATTEMPT TO COMMIT MURDER,2,0,2,12,0,12,31,0,31,8,0,8,53,0,53
KARNATAKA,2003,C.H. NOT AMOUNTING TO MURDER,0,0,0,2,0,2,1,0,1,0,0,0,3,0,3
KARNATAKA,2003,RAPE,2,0,2,19,0,19,11,0,11,0,0,0,32,0,32
KARNATAKA,2003,KIDNAPPING AND ABDUCTION,0,0,0,19,0,19,0,0,0,0,0,0,19,0,19
KARNATAKA,2003,DACOITY,1,0,1,0,0,0,0,0,0,0,0,0,1,0,1
KARNATAKA,2003,PREP. AND ASSEMBLY FOR DACOITY,0,0,0,2,0,2,7,0,7,0,0,0,9,0,9
KARNATAKA,2003,ROBBERY,1,0,1,37,0,37,9,0,9,1,0,1,48,0,48
KARNATAKA,2003,BURGLARY,0,0,0,6,0,6,13,0,13,0,0,0,19,0,19
KARNATAKA,2003,THEFTS,3,0,3,57,6,63,43,0,43,6,0,6,109,6,115
KARNATAKA,2003,EXTORTION,0,0,0,0,0,0,0,0,0,0,0,0,0,0,0
KARNATAKA,2003,RIOTS,0,0,0,0,0,0,8,0,8,0,0,0,8,0,8
KARNATAKA,2003,ARSON,0,0,0,0,0,0,0,0,0,0,0,0,0,0,0
KARNATAKA,2003,CRIMINAL BREACH OF TRUST,0,0,0,0,0,0,7,0,7,0,0,0,7,0,7
KARNATAKA,2003,CHEATING,0,0,0,36,3,39,31,1,32,3,0,3,70,4,74
KARNATAKA,2003,COUNTER FEITING,0,0,0,0,0,0,2,0,2,0,0,0,2,0,2
KARNATAKA,2003,DOWRY DEATHS,0,0,0,0,0,0,0,0,0,0,0,0,0,0,0
KARNATAKA,2003,MOLESTATION,0,0,0,0,0,0,0,0,0,0,0,0,0,0,0
KARNATAKA,2003,EVE-TEASING,0,0,0,0,0,0,0,0,0,0,0,0,0,0,0
KARNATAKA,2003,CRUELTY BY HUSBAND OR RELATIVE OF HUSBAND,0,0,0,0,0,0,0,0,0,0,0,0,0,0,0
KARNATAKA,2003,OTHER IPC CRIMES,3,0,3,43,1,44,84,1,85,43,0,43,173,2,175
KARNATAKA,2003,TOTAL IPC,13,0,13,1445,39,1484,753,24,777,152,2,154,2363,65,2428
KARNATAKA,2004,MURDER,1,0,1,1597,29,1626,627,27,654,93,2,95,2318,58,2376
KARNATAKA,2004,ATTEMPT TO COMMIT MURDER,2,0,2,13,0,13,37,0,37,7,0,7,59,0,59
KARNATAKA,2004,C.H. NOT AMOUNTING TO MURDER,0,0,0,2,0,2,1,0,1,0,0,0,3,0,3
KARNATAKA,2004,RAPE,2,0,2,31,0,31,13,0,13,0,0,0,46,0,46
KARNATAKA,2004,KIDNAPPING AND ABDUCTION,3,0,3,27,0,27,3,0,3,0,0,0,33,0,33
KARNATAKA,2004,DACOITY,1,0,1,3,0,3,2,0,2,0,0,0,6,0,6
KARNATAKA,2004,PREP. AND ASSEMBLY FOR DACOITY,0,0,0,3,0,3,8,0,8,0,0,0,11,0,11
KARNATAKA,2004,ROBBERY,1,0,1,51,0,51,11,0,11,1,0,1,64,0,64
KARNATAKA,2004,BURGLARY,3,0,3,13,0,13,19,0,19,0,0,0,35,0,35
KARNATAKA,2004,THEFTS,3,0,3,61,8,69,47,0,47,4,0,4,115,8,123
KARNATAKA,2004,EXTORTION,0,0,0,0,0,0,0,0,0,0,0,0,0,0,0
KARNATAKA,2004,RIOTS,0,0,0,2,0,2,1,0,1,0,0,0,3,0,3
KARNATAKA,2004,ARSON,0,0,0,0,0,0,0,0,0,0,0,0,0,0,0
KARNATAKA,2004,CRIMINAL BREACH OF TRUST,0,0,0,0,0,0,3,0,3,0,0,0,3,0,3
KARNATAKA,2004,CHEATING,0,0,0,39,2,41,37,3,40,2,0,2,78,5,83
KARNATAKA,2004,COUNTER FEITING,0,0,0,0,0,0,1,0,1,0,0,0,1,0,1
KARNATAKA,2004,DOWRY DEATHS,0,0,0,0,0,0,0,0,0,0,0,0,0,0,0
KARNATAKA,2004,MOLESTATION,0,0,0,0,0,0,0,0,0,0,0,0,0,0,0
KARNATAKA,2004,EVE-TEASING,0,0,0,0,0,0,0,0,0,0,0,0,0,0,0
KARNATAKA,2004,CRUELTY BY HUSBAND OR RELATIVE OF HUSBAND,0,0,0,0,0,0,0,0,0,0,0,0,0,0,0
KARNATAKA,2004,OTHER IPC CRIMES,1,0,1,37,2,39,63,1,64,37,0,37,138,3,141
KARNATAKA,2004,TOTAL IPC,17,0,17,1879,41,1920,873,31,904,144,2,146,2913,74,2987
KARNATAKA,2005,MURDER,0,0,0,1656,51,1707,876,27,903,155,1,156,2687,79,2766
KARNATAKA,2005,ATTEMPT TO COMMIT MURDER,0,0,0,22,0,22,62,0,62,6,0,6,90,0,90
KARNATAKA,2005,C.H. NOT AMOUNTING TO MURDER,0,0,0,3,0,3,1,0,1,0,0,0,4,0,4
KARNATAKA,2005,RAPE,0,0,0,53,0,53,21,0,21,0,0,0,74,0,74
KARNATAKA,2005,KIDNAPPING AND ABDUCTION,0,0,0,37,0,37,2,0,2,0,0,0,39,0,39
KARNATAKA,2005,DACOITY,0,0,0,4,0,4,2,0,2,0,0,0,6,0,6
KARNATAKA,2005,PREP. AND ASSEMBLY FOR DACOITY,0,0,0,3,0,3,10,0,10,0,0,0,13,0,13
KARNATAKA,2005,ROBBERY,0,0,0,74,0,74,11,0,11,0,0,0,85,0,85
KARNATAKA,2005,BURGLARY,0,0,0,14,0,14,16,0,16,0,0,0,30,0,30
KARNATAKA,2005,THEFTS,0,0,0,81,1,82,71,8,79,3,0,3,155,9,164
KARNATAKA,2005,EXTORTION,0,0,0,0,0,0,0,0,0,0,0,0,0,0,0
KARNATAKA,2005,RIOTS,0,0,0,3,0,3,2,0,2,0,0,0,5,0,5
KARNATAKA,2005,ARSON,0,0,0,0,0,0,0,0,0,0,0,0,0,0,0
KARNATAKA,2005,CRIMINAL BREACH OF TRUST,0,0,0,0,0,0,2,0,2,0,0,0,2,0,2
KARNATAKA,2005,CHEATING,0,0,0,49,1,50,44,2,46,2,0,2,95,3,98
KARNATAKA,2005,COUNTER FEITING,0,0,0,0,0,0,1,0,1,0,0,0,1,0,1
KARNATAKA,2005,DOWRY DEATHS,0,0,0,37,1,38,65,2,67,8,2,10,110,5,115
KARNATAKA,2005,MOLESTATION,0,0,0,0,0,0,0,0,0,0,0,0,0,0,0
KARNATAKA,2005,EVE-TEASING,0,0,0,0,0,0,0,0,0,0,0,0,0,0,0
KARNATAKA,2005,CRUELTY BY HUSBAND OR RELATIVE OF HUSBAND,0,0,0,0,0,0,0,0,0,0,0,0,0,0,0
KARNATAKA,2005,OTHER IPC CRIMES,0,0,0,37,0,37,65,2,67,8,2,10,110,4,114
KARNATAKA,2005,TOTAL IPC,0,0,0,2073,54,2127,1251,41,1292,182,5,187,3506,100,3606
KARNATAKA,2006,MURDER,0,0,0,1632,82,1714,941,46,987,159,5,164,2732,133,2865
KARNATAKA,2006,ATTEMPT TO COMMIT MURDER,0,0,0,19,0,19,67,0,67,5,0,5,91,0,91
KARNATAKA,2006,C.H. NOT AMOUNTING TO MURDER,0,0,0,3,0,3,1,0,1,0,0,0,4,0,4
KARNATAKA,2006,RAPE,0,0,0,39,0,39,27,0,27,0,0,0,66,0,66
KARNATAKA,2006,KIDNAPPING AND ABDUCTION,0,0,0,33,0,33,2,0,2,0,0,0,35,0,35
KARNATAKA,2006,DACOITY,0,0,0,3,0,3,2,0,2,0,0,0,5,0,5
KARNATAKA,2006,PREP. AND ASSEMBLY FOR DACOITY,0,0,0,2,0,2,12,0,12,0,0,0,14,0,14
KARNATAKA,2006,ROBBERY,0,0,0,53,0,53,11,0,11,0,0,0,64,0,64
KARNATAKA,2006,BURGLARY,0,0,0,16,0,16,17,0,17,0,0,0,33,0,33
KARNATAKA,2006,THEFTS,0,0,0,56,1,57,69,8,77,3,0,3,128,9,137
KARNATAKA,2006,EXTORTION,0,0,0,3,0,3,2,0,2,0,0,0,5,0,5
KARNATAKA,2006,RIOTS,0,0,0,0,0,0,0,0,0,0,0,0,0,0,0
KARNATAKA,2006,ARSON,0,0,0,0,0,0,0,0,0,0,0,0,0,0,0
KARNATAKA,2006,CRIMINAL BREACH OF TRUST,0,0,0,0,0,0,1,0,1,0,0,0,1,0,1
KARNATAKA,2006,CHEATING,0,0,0,38,1,39,43,2,45,2,0,2,83,3,86
KARNATAKA,2006,COUNTER FEITING,0,0,0,0,0,0,0,0,0,0,0,0,0,0,0
KARNATAKA,2006,DOWRY DEATHS,0,0,0,33,1,34,63,2,65,6,2,8,102,5,107
KARNATAKA,2006,MOLESTATION,0,0,0,0,0,0,0,0,0,0,0,0,0,0,0
KARNATAKA,2006,EVE-TEASING,0,0,0,0,0,0,0,0,0,0,0,0,0,0,0
KARNATAKA,2006,CRUELTY BY HUSBAND OR RELATIVE OF HUSBAND,0,0,0,0,0,0,0,0,0,0,0,0,0,0,0
KARNATAKA,2006,OTHER IPC CRIMES,0,0,0,16,0,16,8,0,8,3,0,3,27,0,27
KARNATAKA,2006,TOTAL IPC,0,0,0,1946,85,2031,1266,58,1324,178,7,185,3390,150,3540
KARNATAKA,2007,MURDER,0,0,0,1666,79,1745,924,41,965,131,2,133,2721,122,2843
KARNATAKA,2007,ATTEMPT TO COMMIT MURDER,0,0,0,23,0,23,63,0,63,2,0,2,88,0,88
KARNATAKA,2007,C.H. NOT AMOUNTING TO MURDER,0,0,0,1,0,1,1,0,1,0,0,0,2,0,2
KARNATAKA,2007,RAPE,0,0,0,37,0,37,24,0,24,0,0,0,61,0,61
KARNATAKA,2007,KIDNAPPING AND ABDUCTION,0,0,0,34,0,34,2,0,2,0,0,0,36,0,36
KARNATAKA,2007,DACOITY,0,0,0,2,0,2,2,0,2,0,0,0,4,0,4
KARNATAKA,2007,PREP. AND ASSEMBLY FOR DACOITY,0,0,0,2,0,2,11,0,11,0,0,0,13,0,13
KARNATAKA,2007,ROBBERY,0,0,0,57,0,57,13,0,13,0,0,0,70,0,70
KARNATAKA,2007,BURGLARY,0,0,0,17,0,17,16,0,16,0,0,0,33,0,33
KARNATAKA,2007,THEFTS,0,0,0,56,1,57,61,6,67,1,0,1,118,7,125
KARNATAKA,2007,EXTORTION,0,0,0,3,0,3,2,0,2,0,0,0,5,0,5
KARNATAKA,2007,RIOTS,0,0,0,0,0,0,2,0,2,0,0,0,2,0,2
KARNATAKA,2007,ARSON,0,0,0,0,0,0,0,0,0,0,0,0,0,0,0
KARNATAKA,2007,CRIMINAL BREACH OF TRUST,0,0,0,0,0,0,1,0,1,0,0,0,1,0,1
KARNATAKA,2007,CHEATING,0,0,0,39,1,40,41,1,42,2,0,2,82,2,84
KARNATAKA,2007,COUNTER FEITING,0,0,0,0,0,0,0,0,0,0,0,0,0,0,0
KARNATAKA,2007,DOWRY DEATHS,0,0,0,31,1,32,63,1,64,4,2,6,98,4,102
KARNATAKA,2007,MOLESTATION,0,0,0,0,0,0,0,0,0,0,0,0,0,0,0
KARNATAKA,2007,EVE-TEASING,0,0,0,0,0,0,0,0,0,0,0,0,0,0,0
KARNATAKA,2007,CRUELTY BY HUSBAND OR RELATIVE OF HUSBAND,0,0,0,0,0,0,0,0,0,0,0,0,0,0,0
KARNATAKA,2007,OTHER IPC CRIMES,0,0,0,21,0,21,6,0,6,3,0,3,30,0,30
KARNATAKA,2007,TOTAL IPC,0,0,0,1989,82,2071,1232,49,1281,143,4,147,3364,135,3499
KARNATAKA,2008,MURDER,0,0,0,1741,78,1819,931,47,978,133,3,136,2805,128,2933
KARNATAKA,2008,ATTEMPT TO COMMIT MURDER,0,0,0,29,0,29,68,0,68,2,0,2,99,0,99
KARNATAKA,2008,C.H. NOT AMOUNTING TO MURDER,0,0,0,3,0,3,2,0,2,1,0,1,6,0,6
KARNATAKA,2008,RAPE,0,0,0,42,0,42,25,0,25,0,0,0,67,0,67
KARNATAKA,2008,KIDNAPPING AND ABDUCTION,0,0,0,37,0,37,2,0,2,0,0,0,39,0,39
KARNATAKA,2008,DACOITY,0,0,0,2,0,2,2,0,2,0,0,0,4,0,4
KARNATAKA,2008,PREP. AND ASSEMBLY FOR DACOITY,0,0,0,1,0,1,11,0,11,0,0,0,12,0,12
KARNATAKA,2008,ROBBERY,0,0,0,56,0,56,12,0,12,0,0,0,68,0,68
KARNATAKA,2008,BURGLARY,0,0,0,17,0,17,16,0,16,0,0,0,33,0,33
KARNATAKA,2008,THEFTS,0,0,0,56,1,57,62,6,68,1,0,1,119,7,126
KARNATAKA,2008,EXTORTION,0,0,0,4,0,4,2,0,2,0,0,0,6,0,6
KARNATAKA,2008,RIOTS,0,0,0,0,0,0,2,0,2,0,0,0,2,0,2
KARNATAKA,2008,ARSON,0,0,0,0,0,0,0,0,0,0,0,0,0,0,0
KARNATAKA,2008,CRIMINAL BREACH OF TRUST,0,0,0,0,0,0,1,0,1,0,0,0,1,0,1
KARNATAKA,2008,CHEATING,0,0,0,41,1,42,41,1,42,2,0,2,84,2,86
KARNATAKA,2008,COUNTER FEITING,0,0,0,0,0,0,0,0,0,0,0,0,0,0,0
KARNATAKA,2008,DOWRY DEATHS,0,0,0,32,1,33,63,2,65,4,2,6,99,5,104
KARNATAKA,2008,MOLESTATION,0,0,0,0,0,0,0,0,0,0,0,0,0,0,0
KARNATAKA,2008,EVE-TEASING,0,0,0,0,0,0,0,0,0,0,0,0,0,0,0
KARNATAKA,2008,CRUELTY BY HUSBAND OR RELATIVE OF HUSBAND,0,0,0,0,0,0,0,0,0,0,0,0,0,0,0
KARNATAKA,2008,OTHER IPC CRIMES,0,0,0,25,0,25,8,0,8,4,0,4,37,0,37
KARNATAKA,2008,TOTAL IPC,0,0,0,2086,81,2167,1248,56,1304,147,5,152,3481,142,3623
KARNATAKA,2009,MURDER,0,0,0,1591,66,1657,904,35,939,129,2,131,2624,103,2727
KARNATAKA,2009,ATTEMPT TO COMMIT MURDER,0,0,0,31,0,31,67,0,67,2,0,2,100,0,100
KARNATAKA,2009,C.H. NOT AMOUNTING TO MURDER,0,0,0,3,0,3,2,0,2,1,0,1,6,0,6
KARNATAKA,2009,RAPE,0,0,0,44,0,44,23,0,23,0,0,0,67,0,67
KARNATAKA,2009,KIDNAPPING AND ABDUCTION,0,0,0,35,0,35,2,0,2,0,0,0,37,0,37
KARNATAKA,2009,DACOITY,0,0,0,2,0,2,11,0,11,0,0,0,13,0,13
KARNATAKA,2009,PREP. AND ASSEMBLY FOR DACOITY,0,0,0,2,0,2,2,0,2,0,0,0,4,0,4
KARNATAKA,2009,ROBBERY,0,0,0,51,0,51,12,0,12,0,0,0,63,0,63
KARNATAKA,2009,BURGLARY,0,0,0,21,0,21,16,0,16,0,0,0,37,0,37
KARNATAKA,2009,THEFTS,0,0,0,61,1,62,61,7,68,1,0,1,123,8,131
KARNATAKA,2009,EXTORTION,0,0,0,4,0,4,2,0,2,0,0,0,6,0,6
KARNATAKA,2009,RIOTS,0,0,0,0,0,0,2,0,2,0,0,0,2,0,2
KARNATAKA,2009,ARSON,0,0,0,0,0,0,0,0,0,0,0,0,0,0,0
KARNATAKA,2009,CRIMINAL BREACH OF TRUST,0,0,0,0,0,0,1,0,1,0,0,0,1,0,1
KARNATAKA,2009,CHEATING,0,0,0,38,1,39,40,1,41,2,0,2,80,2,82
KARNATAKA,2009,COUNTER FEITING,0,0,0,0,0,0,0,0,0,0,0,0,0,0,0
KARNATAKA,2009,DOWRY DEATHS,0,0,0,29,1,30,71,2,73,4,2,6,104,5,109
KARNATAKA,2009,MOLESTATION,0,0,0,0,0,0,0,0,0,0,0,0,0,0,0
KARNATAKA,2009,EVE-TEASING,0,0,0,0,0,0,0,0,0,0,0,0,0,0,0
KARNATAKA,2009,CRUELTY BY HUSBAND OR RELATIVE OF HUSBAND,0,0,0,0,0,0,0,0,0,0,0,0,0,0,0
KARNATAKA,2009,OTHER IPC CRIMES,0,0,0,11,0,11,8,1,9,4,0,4,23,1,24
KARNATAKA,2009,TOTAL IPC,0,0,0,1923,69,1992,1224,46,1270,143,4,147,3290,119,3409
KARNATAKA,2010,MURDER,0,0,0,1517,77,1594,907,35,942,131,3,134,2555,115,2670
KARNATAKA,2010,ATTEMPT TO COMMIT MURDER,0,0,0,91,0,91,81,0,81,4,0,4,176,0,176
KARNATAKA,2010,C.H. NOT AMOUNTING TO MURDER,0,0,0,5,0,5,3,0,3,1,0,1,9,0,9
KARNATAKA,2010,RAPE,0,0,0,63,0,63,27,0,27,0,0,0,90,0,90
KARNATAKA,2010,KIDNAPPING AND ABDUCTION,0,0,0,41,0,41,8,0,8,0,0,0,49,0,49
KARNATAKA,2010,DACOITY,0,0,0,8,0,8,11,0,11,0,0,0,19,0,19
KARNATAKA,2010,PREP. AND ASSEMBLY FOR DACOITY,0,0,0,7,0,7,9,0,9,0,0,0,16,0,16
KARNATAKA,2010,ROBBERY,0,0,0,71,0,71,13,0,13,0,0,0,84,0,84
KARNATAKA,2010,BURGLARY,0,0,0,31,0,31,17,0,17,0,0,0,48,0,48
KARNATAKA,2010,THEFTS,0,0,0,93,1,94,77,9,86,2,0,2,172,10,182
KARNATAKA,2010,EXTORTION,0,0,0,3,0,3,2,0,2,0,0,0,5,0,5
KARNATAKA,2010,RIOTS,0,0,0,4,0,4,2,0,2,0,0,0,6,0,6
KARNATAKA,2010,ARSON,0,0,0,0,0,0,0,0,0,0,0,0,0,0,0
KARNATAKA,2010,CRIMINAL BREACH OF TRUST,0,0,0,1,0,1,2,0,2,0,0,0,3,0,3
KARNATAKA,2010,CHEATING,0,0,0,47,1,48,41,1,42,2,0,2,90,2,92
KARNATAKA,2010,COUNTER FEITING,0,0,0,0,0,0,0,0,0,0,0,0,0,0,0
KARNATAKA,2010,DOWRY DEATHS,0,0,0,31,1,32,71,3,74,4,2,6,106,6,112
KARNATAKA,2010,MOLESTATION,0,0,0,0,0,0,0,0,0,0,0,0,0,0,0
KARNATAKA,2010,EVE-TEASING,0,0,0,0,0,0,0,0,0,0,0,0,0,0,0
KARNATAKA,2010,CRUELTY BY HUSBAND OR RELATIVE OF HUSBAND,0,0,0,6,0,6,0,0,0,0,0,0,6,0,6
KARNATAKA,2010,OTHER IPC CRIMES,0,0,0,14,0,14,11,2,13,4,0,4,29,2,31
KARNATAKA,2010,TOTAL IPC,0,0,0,2033,80,2113,1282,50,1332,148,5,153,3463,135,3598
KARNATAKA,2011,MURDER,0,0,0,1637,84,1721,958,47,1005,131,3,134,2726,134,2860
KARNATAKA,2011,ATTEMPT TO COMMIT MURDER,0,0,0,103,0,103,97,0,97,4,0,4,204,0,204
KARNATAKA,2011,C.H. NOT AMOUNTING TO MURDER,0,0,0,6,0,6,4,0,4,1,0,1,11,0,11
KARNATAKA,2011,RAPE,0,0,0,67,0,67,31,0,31,0,0,0,98,0,98
KARNATAKA,2011,KIDNAPPING AND ABDUCTION,0,0,0,44,0,44,4,0,4,0,0,0,48,0,48
KARNATAKA,2011,DACOITY,0,0,0,11,0,11,14,0,14,0,0,0,25,0,25
KARNATAKA,2011,PREP. AND ASSEMBLY FOR DACOITY,0,0,0,9,0,9,12,0,12,0,0,0,21,0,21
KARNATAKA,2011,ROBBERY,0,0,0,77,0,77,17,0,17,0,0,0,94,0,94
KARNATAKA,2011,BURGLARY,0,0,0,37,0,37,21,0,21,0,0,0,58,0,58
KARNATAKA,2011,THEFTS,0,0,0,101,1,102,21,11,32,2,0,2,124,12,136
KARNATAKA,2011,EXTORTION,0,0,0,4,0,4,2,0,2,0,0,0,6,0,6
KARNATAKA,2011,RIOTS,0,0,0,7,0,7,2,0,2,0,0,0,9,0,9
KARNATAKA,2011,ARSON,0,0,0,0,0,0,0,0,0,0,0,0,0,0,0
KARNATAKA,2011,CRIMINAL BREACH OF TRUST,0,0,0,3,0,3,2,0,2,0,0,0,5,0,5
KARNATAKA,2011,CHEATING,0,0,0,49,1,50,44,3,47,2,0,2,95,4,99
KARNATAKA,2011,COUNTER FEITING,0,0,0,0,0,0,0,0,0,0,0,0,0,0,0
KARNATAKA,2011,DOWRY DEATHS,0,0,0,37,1,38,76,3,79,4,2,6,117,6,123
KARNATAKA,2011,MOLESTATION,0,0,0,0,0,0,0,0,0,0,0,0,0,0,0
KARNATAKA,2011,EVE-TEASING,0,0,0,0,0,0,0,0,0,0,0,0,0,0,0
KARNATAKA,2011,CRUELTY BY HUSBAND OR RELATIVE OF HUSBAND,0,0,0,9,0,9,0,0,0,0,0,0,9,0,9
KARNATAKA,2011,OTHER IPC CRIMES,0,0,0,17,0,17,17,5,22,4,0,4,38,5,43
KARNATAKA,2011,TOTAL IPC,0,0,0,2218,87,2305,1322,69,1391,148,5,153,3688,161,3849
KARNATAKA,2012,MURDER,0,0,0,1363,79,1442,1143,59,1202,116,4,120,2622,142,2764
KARNATAKA,2012,ATTEMPT TO COMMIT MURDER,0,0,0,109,1,110,93,0,93,5,0,5,207,1,208
KARNATAKA,2012,C.H. NOT AMOUNTING TO MURDER,0,0,0,13,0,13,32,0,32,2,0,2,47,0,47
KARNATAKA,2012,RAPE,0,0,0,73,0,73,44,0,44,0,0,0,117,0,117
KARNATAKA,2012,KIDNAPPING AND ABDUCTION,0,0,0,47,0,47,19,0,19,0,0,0,66,0,66
KARNATAKA,2012,DACOITY,0,0,0,33,0,33,61,0,61,0,0,0,94,0,94
KARNATAKA,2012,PREP. AND ASSEMBLY FOR DACOITY,0,0,0,7,0,7,9,0,9,0,0,0,16,0,16
KARNATAKA,2012,ROBBERY,0,0,0,71,0,71,26,0,26,1,0,1,98,0,98
KARNATAKA,2012,BURGLARY,0,0,0,33,0,33,38,0,38,1,0,1,72,0,72
KARNATAKA,2012,THEFTS,0,0,0,114,3,117,33,13,46,4,0,4,151,16,167
KARNATAKA,2012,EXTORTION,0,0,0,3,0,3,5,0,5,0,0,0,8,0,8
KARNATAKA,2012,RIOTS,0,0,0,11,0,11,7,0,7,1,0,1,19,0,19
KARNATAKA,2012,ARSON,0,0,0,2,0,2,2,0,2,0,0,0,4,0,4
KARNATAKA,2012,CRIMINAL BREACH OF TRUST,0,0,0,3,0,3,3,0,3,0,0,0,6,0,6
KARNATAKA,2012,CHEATING,0,0,0,32,1,33,47,3,50,3,0,3,82,4,86
KARNATAKA,2012,COUNTER FEITING,0,0,0,0,0,0,0,0,0,0,0,0,0,0,0
KARNATAKA,2012,DOWRY DEATHS,0,0,0,33,1,34,71,3,74,6,2,8,110,6,116
KARNATAKA,2012,MOLESTATION,0,0,0,1,0,1,7,0,7,1,0,1,9,0,9
KARNATAKA,2012,EVE-TEASING,0,0,0,3,0,3,2,0,2,0,0,0,5,0,5
KARNATAKA,2012,CRUELTY BY HUSBAND OR RELATIVE OF HUSBAND,0,0,0,7,0,7,13,2,15,1,1,2,21,3,24
KARNATAKA,2012,OTHER IPC CRIMES,0,0,0,13,6,19,11,3,14,1,0,1,25,9,34
KARNATAKA,2012,TOTAL IPC,0,0,0,1971,91,2062,1666,83,1749,142,7,149,3779,181,3960
KERALA,2001,MURDER,0,0,0,146,3,149,204,7,211,22,1,23,372,11,383
KERALA,2001,ATTEMPT TO COMMIT MURDER,0,0,0,105,0,105,176,21,197,14,0,14,295,21,316
KERALA,2001,C.H. NOT AMOUNTING TO MURDER,0,0,0,16,0,16,12,0,12,0,0,0,28,0,28
KERALA,2001,RAPE,0,0,0,20,0,20,8,0,8,0,0,0,28,0,28
KERALA,2001,KIDNAPPING AND ABDUCTION,0,0,0,42,0,42,5,0,5,8,1,9,55,1,56
KERALA,2001,DACOITY,0,0,0,6,0,6,3,0,3,22,0,22,31,0,31
KERALA,2001,PREP. AND ASSEMBLY FOR DACOITY,0,0,0,0,0,0,0,0,0,0,0,0,0,0,0
KERALA,2001,ROBBERY,0,0,0,51,2,53,48,0,48,0,0,0,99,2,101
KERALA,2001,BURGLARY,0,0,0,31,0,31,63,0,63,0,0,0,94,0,94
KERALA,2001,THEFTS,0,0,0,96,4,100,38,2,40,48,1,49,182,7,189
KERALA,2001,EXTORTION,0,0,0,0,0,0,0,0,0,0,0,0,0,0,0
KERALA,2001,RIOTS,0,0,0,9,0,9,2,0,2,0,0,0,11,0,11
KERALA,2001,ARSON,0,0,0,39,0,39,7,0,7,0,0,0,46,0,46
KERALA,2001,CRIMINAL BREACH OF TRUST,0,0,0,0,0,0,0,0,0,0,0,0,0,0,0
KERALA,2001,CHEATING,0,0,0,83,0,83,11,0,11,0,0,0,94,0,94
KERALA,2001,COUNTER FEITING,0,0,0,2,0,2,1,0,1,0,0,0,3,0,3
KERALA,2001,DOWRY DEATHS,0,0,0,0,0,0,0,0,0,0,0,0,0,0,0
KERALA,2001,MOLESTATION,0,0,0,0,0,0,0,0,0,0,0,0,0,0,0
KERALA,2001,EVE-TEASING,0,0,0,0,0,0,0,0,0,0,0,0,0,0,0
KERALA,2001,CRUELTY BY HUSBAND OR RELATIVE OF HUSBAND,0,0,0,0,0,0,0,0,0,0,0,0,0,0,0
KERALA,2001,OTHER IPC CRIMES,0,0,0,7,0,7,3,0,3,31,0,31,41,0,41
KERALA,2001,TOTAL IPC,0,0,0,653,9,662,581,30,611,145,3,148,1379,42,1421
KERALA,2002,MURDER,0,0,0,206,1,207,156,2,158,21,1,22,383,4,387
KERALA,2002,ATTEMPT TO COMMIT MURDER,0,0,0,74,0,74,120,0,120,15,0,15,209,0,209
KERALA,2002,C.H. NOT AMOUNTING TO MURDER,0,0,0,12,0,12,13,0,13,2,0,2,27,0,27
KERALA,2002,RAPE,0,0,0,4,0,4,4,0,4,7,0,7,15,0,15
KERALA,2002,KIDNAPPING AND ABDUCTION,0,0,0,8,0,8,3,0,3,5,0,5,16,0,16
KERALA,2002,DACOITY,0,0,0,47,0,47,35,0,35,12,0,12,94,0,94
KERALA,2002,PREP. AND ASSEMBLY FOR DACOITY,0,0,0,10,0,10,5,0,5,1,0,1,16,0,16
KERALA,2002,ROBBERY,0,0,0,30,3,33,46,4,50,7,0,7,83,7,90
KERALA,2002,BURGLARY,0,0,0,13,0,13,57,0,57,3,0,3,73,0,73
KERALA,2002,THEFTS,0,0,0,66,6,72,54,0,54,43,2,45,163,8,171
KERALA,2002,EXTORTION,0,0,0,0,0,0,0,0,0,0,0,0,0,0,0
KERALA,2002,RIOTS,0,0,0,3,0,3,2,0,2,0,0,0,5,0,5
KERALA,2002,ARSON,0,0,0,0,0,0,0,0,0,0,0,0,0,0,0
KERALA,2002,CRIMINAL BREACH OF TRUST,0,0,0,5,0,5,4,0,4,0,0,0,9,0,9
KERALA,2002,CHEATING,0,0,0,76,0,76,10,3,13,1,0,1,87,3,90
KERALA,2002,COUNTER FEITING,0,0,0,2,0,2,2,1,3,0,0,0,4,1,5
KERALA,2002,DOWRY DEATHS,0,0,0,0,0,0,0,0,0,0,0,0,0,0,0
KERALA,2002,MOLESTATION,0,0,0,0,0,0,0,0,0,0,0,0,0,0,0
KERALA,2002,EVE-TEASING,0,0,0,0,0,0,0,0,0,0,0,0,0,0,0
KERALA,2002,CRUELTY BY HUSBAND OR RELATIVE OF HUSBAND,0,0,0,0,0,0,4,0,4,0,0,0,4,0,4
KERALA,2002,OTHER IPC CRIMES,0,0,0,19,2,21,25,0,25,8,2,10,52,4,56
KERALA,2002,TOTAL IPC,0,0,0,575,12,587,540,10,550,125,5,130,1240,27,1267
KERALA,2003,MURDER,0,0,0,226,1,227,185,5,190,59,3,62,470,9,479
KERALA,2003,ATTEMPT TO COMMIT MURDER,0,0,0,79,0,79,123,0,123,17,0,17,219,0,219
KERALA,2003,C.H. NOT AMOUNTING TO MURDER,0,0,0,13,0,13,15,0,15,2,0,2,30,0,30
KERALA,2003,RAPE,0,0,0,12,0,12,20,0,20,8,0,8,40,0,40
KERALA,2003,KIDNAPPING AND ABDUCTION,0,0,0,13,0,13,15,0,15,6,0,6,34,0,34
KERALA,2003,DACOITY,0,0,0,62,0,62,47,0,47,16,0,16,125,0,125
KERALA,2003,PREP. AND ASSEMBLY FOR DACOITY,0,0,0,11,0,11,4,0,4,0,0,0,15,0,15
KERALA,2003,ROBBERY,0,0,0,47,4,51,68,6,74,12,0,12,127,10,137
KERALA,2003,BURGLARY,0,0,0,28,0,28,73,0,73,5,0,5,106,0,106
KERALA,2003,THEFTS,0,0,0,116,9,125,88,0,88,37,0,37,241,9,250
KERALA,2003,EXTORTION,0,0,0,0,0,0,0,0,0,0,0,0,0,0,0
KERALA,2003,RIOTS,0,0,0,5,0,5,3,0,3,0,0,0,8,0,8
KERALA,2003,ARSON,0,0,0,0,0,0,0,0,0,0,0,0,0,0,0
KERALA,2003,CRIMINAL BREACH OF TRUST,0,0,0,7,0,7,6,0,6,0,0,0,13,0,13
KERALA,2003,CHEATING,0,0,0,97,0,97,51,4,55,13,0,13,161,4,165
KERALA,2003,COUNTER FEITING,0,0,0,3,0,3,2,1,3,0,0,0,5,1,6
KERALA,2003,DOWRY DEATHS,0,0,0,2,0,2,5,0,5,2,0,2,9,0,9
KERALA,2003,MOLESTATION,0,0,0,0,0,0,0,0,0,0,0,0,0,0,0
KERALA,2003,EVE-TEASING,0,0,0,0,0,0,0,0,0,0,0,0,0,0,0
KERALA,2003,CRUELTY BY HUSBAND OR RELATIVE OF HUSBAND,0,0,0,0,0,0,5,0,5,0,0,0,5,0,5
KERALA,2003,OTHER IPC CRIMES,0,0,0,21,3,24,27,0,27,11,2,13,59,5,64
KERALA,2003,TOTAL IPC,0,0,0,742,17,759,737,16,753,188,5,193,1667,38,1705
KERALA,2004,MURDER,0,0,0,473,1,474,468,9,477,89,8,97,1030,18,1048
KERALA,2004,ATTEMPT TO COMMIT MURDER,0,0,0,86,0,86,53,0,53,47,0,47,186,0,186
KERALA,2004,C.H. NOT AMOUNTING TO MURDER,0,0,0,6,0,6,7,0,7,2,0,2,15,0,15
KERALA,2004,RAPE,0,0,0,0,0,0,0,0,0,0,0,0,0,0,0
KERALA,2004,KIDNAPPING AND ABDUCTION,0,0,0,0,0,0,0,0,0,0,0,0,0,0,0
KERALA,2004,DACOITY,0,0,0,0,0,0,0,0,0,0,0,0,0,0,0
KERALA,2004,PREP. AND ASSEMBLY FOR DACOITY,0,0,0,0,0,0,0,0,0,0,0,0,0,0,0
KERALA,2004,ROBBERY,0,0,0,0,0,0,0,0,0,0,0,0,0,0,0
KERALA,2004,BURGLARY,0,0,0,0,0,0,0,0,0,0,0,0,0,0,0
KERALA,2004,THEFTS,0,0,0,88,0,88,39,0,39,9,0,9,136,0,136
KERALA,2004,EXTORTION,0,0,0,0,0,0,0,0,0,0,0,0,0,0,0
KERALA,2004,RIOTS,0,0,0,0,0,0,0,0,0,0,0,0,0,0,0
KERALA,2004,ARSON,0,0,0,0,0,0,0,0,0,0,0,0,0,0,0
KERALA,2004,CRIMINAL BREACH OF TRUST,0,0,0,0,0,0,0,0,0,0,0,0,0,0,0
KERALA,2004,CHEATING,0,0,0,26,1,27,28,1,29,4,1,5,58,3,61
KERALA,2004,COUNTER FEITING,0,0,0,0,0,0,0,0,0,0,0,0,0,0,0
KERALA,2004,DOWRY DEATHS,0,0,0,0,0,0,0,1,1,0,1,1,0,2,2
KERALA,2004,MOLESTATION,0,0,0,0,0,0,0,0,0,0,0,0,0,0,0
KERALA,2004,EVE-TEASING,0,0,0,0,0,0,0,0,0,0,0,0,0,0,0
KERALA,2004,CRUELTY BY HUSBAND OR RELATIVE OF HUSBAND,0,0,0,25,0,25,18,0,18,2,0,2,45,0,45
KERALA,2004,OTHER IPC CRIMES,0,0,0,94,6,100,103,9,112,26,3,29,223,18,241
KERALA,2004,TOTAL IPC,0,0,0,798,8,806,716,20,736,179,13,192,1693,41,1734
KERALA,2005,MURDER,0,0,0,175,1,176,490,9,499,96,3,99,761,13,774
KERALA,2005,ATTEMPT TO COMMIT MURDER,0,0,0,88,0,88,156,0,156,89,0,89,333,0,333
KERALA,2005,C.H. NOT AMOUNTING TO MURDER,0,0,0,0,0,0,0,0,0,0,0,0,0,0,0
KERALA,2005,RAPE,0,0,0,0,0,0,0,0,0,0,0,0,0,0,0
KERALA,2005,KIDNAPPING AND ABDUCTION,0,0,0,0,0,0,0,0,0,0,0,0,0,0,0
KERALA,2005,DACOITY,0,0,0,0,0,0,0,0,0,0,0,0,0,0,0
KERALA,2005,PREP. AND ASSEMBLY FOR DACOITY,0,0,0,0,0,0,0,0,0,0,0,0,0,0,0
KERALA,2005,ROBBERY,0,0,0,0,0,0,0,0,0,0,0,0,0,0,0
KERALA,2005,BURGLARY,0,0,0,0,0,0,0,0,0,0,0,0,0,0,0
KERALA,2005,THEFTS,0,0,0,68,8,76,241,12,253,39,0,39,348,20,368
KERALA,2005,EXTORTION,0,0,0,0,0,0,0,0,0,0,0,0,0,0,0
KERALA,2005,RIOTS,0,0,0,0,0,0,0,0,0,0,0,0,0,0,0
KERALA,2005,ARSON,0,0,0,0,0,0,0,0,0,0,0,0,0,0,0
KERALA,2005,CRIMINAL BREACH OF TRUST,0,0,0,0,0,0,0,0,0,0,0,0,0,0,0
KERALA,2005,CHEATING,0,0,0,6,1,7,29,1,30,6,0,6,41,2,43
KERALA,2005,COUNTER FEITING,0,0,0,0,0,0,0,0,0,0,0,0,0,0,0
KERALA,2005,DOWRY DEATHS,0,0,0,0,0,0,0,0,0,0,0,0,0,0,0
KERALA,2005,MOLESTATION,0,0,0,0,0,0,0,0,0,0,0,0,0,0,0
KERALA,2005,EVE-TEASING,0,0,0,0,0,0,0,0,0,0,0,0,0,0,0
KERALA,2005,CRUELTY BY HUSBAND OR RELATIVE OF HUSBAND,0,0,0,9,0,9,16,0,16,2,0,2,27,0,27
KERALA,2005,OTHER IPC CRIMES,0,0,0,98,8,106,198,0,198,94,0,94,390,8,398
KERALA,2005,TOTAL IPC,0,0,0,444,18,462,1130,22,1152,326,3,329,1900,43,1943
KERALA,2006,MURDER,0,0,0,353,10,363,651,12,663,300,0,300,1304,22,1326
KERALA,2006,ATTEMPT TO COMMIT MURDER,0,0,0,26,0,26,47,0,47,10,0,10,83,0,83
KERALA,2006,C.H. NOT AMOUNTING TO MURDER,0,0,0,24,0,24,24,0,24,8,0,8,56,0,56
KERALA,2006,RAPE,0,0,0,19,0,19,18,0,18,12,0,12,49,0,49
KERALA,2006,KIDNAPPING AND ABDUCTION,0,0,0,17,1,18,13,0,13,1,0,1,31,1,32
KERALA,2006,DACOITY,0,0,0,23,0,23,14,0,14,8,0,8,45,0,45
KERALA,2006,PREP. AND ASSEMBLY FOR DACOITY,0,0,0,18,0,18,9,0,9,1,0,1,28,0,28
KERALA,2006,ROBBERY,0,0,0,26,0,26,41,0,41,21,0,21,88,0,88
KERALA,2006,BURGLARY,0,0,0,24,0,24,17,0,17,1,0,1,42,0,42
KERALA,2006,THEFTS,0,0,0,130,4,134,137,1,138,29,0,29,296,5,301
KERALA,2006,EXTORTION,0,0,0,0,0,0,2,0,2,0,0,0,2,0,2
KERALA,2006,RIOTS,0,0,0,12,0,12,7,0,7,2,0,2,21,0,21
KERALA,2006,ARSON,0,0,0,7,0,7,9,0,9,3,0,3,19,0,19
KERALA,2006,CRIMINAL BREACH OF TRUST,0,0,0,3,0,3,6,0,6,2,0,2,11,0,11
KERALA,2006,CHEATING,0,0,0,10,0,10,39,0,39,10,0,10,59,0,59
KERALA,2006,COUNTER FEITING,0,0,0,3,0,3,9,0,9,3,0,3,15,0,15
KERALA,2006,DOWRY DEATHS,0,0,0,0,0,0,8,0,8,2,4,6,10,4,14
KERALA,2006,MOLESTATION,0,0,0,2,0,2,8,0,8,4,0,4,14,0,14
KERALA,2006,EVE-TEASING,0,0,0,0,0,0,0,0,0,0,0,0,0,0,0
KERALA,2006,CRUELTY BY HUSBAND OR RELATIVE OF HUSBAND,0,0,0,5,0,5,11,0,11,16,0,16,32,0,32
KERALA,2006,OTHER IPC CRIMES,0,0,0,19,1,20,19,2,21,22,0,22,60,3,63
KERALA,2006,TOTAL IPC,0,0,0,721,16,737,1089,15,1104,455,4,459,2265,35,2300
KERALA,2007,MURDER,0,0,0,397,6,403,654,12,666,300,0,300,1351,18,1369
KERALA,2007,ATTEMPT TO COMMIT MURDER,0,0,0,26,0,26,47,0,47,10,0,10,83,0,83
KERALA,2007,C.H. NOT AMOUNTING TO MURDER,0,0,0,24,0,24,24,0,24,8,0,8,56,0,56
KERALA,2007,RAPE,0,0,0,19,0,19,18,0,18,7,0,7,44,0,44
KERALA,2007,KIDNAPPING AND ABDUCTION,0,0,0,17,0,17,13,0,13,1,0,1,31,0,31
KERALA,2007,DACOITY,0,0,0,23,0,23,14,0,14,8,0,8,45,0,45
KERALA,2007,PREP. AND ASSEMBLY FOR DACOITY,0,0,0,18,0,18,9,0,9,1,0,1,28,0,28
KERALA,2007,ROBBERY,0,0,0,26,0,26,41,0,41,11,0,11,78,0,78
KERALA,2007,BURGLARY,0,0,0,34,0,34,27,0,27,8,0,8,69,0,69
KERALA,2007,THEFTS,0,0,0,90,2,92,137,1,138,29,0,29,256,3,259
KERALA,2007,EXTORTION,0,0,0,0,0,0,0,0,0,0,0,0,0,0,0
KERALA,2007,RIOTS,0,0,0,12,0,12,7,0,7,2,0,2,21,0,21
KERALA,2007,ARSON,0,0,0,7,0,7,9,0,9,3,0,3,19,0,19
KERALA,2007,CRIMINAL BREACH OF TRUST,0,0,0,3,0,3,6,0,6,2,0,2,11,0,11
KERALA,2007,CHEATING,0,0,0,10,0,10,39,0,39,10,0,10,59,0,59
KERALA,2007,COUNTER FEITING,0,0,0,3,0,3,9,0,9,3,0,3,15,0,15
KERALA,2007,DOWRY DEATHS,0,0,0,0,0,0,8,0,8,2,4,6,10,4,14
KERALA,2007,MOLESTATION,0,0,0,2,0,2,8,0,8,4,0,4,14,0,14
KERALA,2007,EVE-TEASING,0,0,0,0,0,0,0,0,0,0,0,0,0,0,0
KERALA,2007,CRUELTY BY HUSBAND OR RELATIVE OF HUSBAND,0,0,0,5,0,5,11,0,11,16,0,16,32,0,32
KERALA,2007,OTHER IPC CRIMES,0,0,0,19,1,20,19,5,24,12,0,12,50,6,56
KERALA,2007,TOTAL IPC,0,0,0,735,9,744,1100,18,1118,437,4,441,2272,31,2303
KERALA,2008,MURDER,0,0,0,328,2,330,641,17,658,257,6,263,1226,25,1251
KERALA,2008,ATTEMPT TO COMMIT MURDER,0,0,0,29,1,30,88,2,90,35,0,35,152,3,155
KERALA,2008,C.H. NOT AMOUNTING TO MURDER,0,0,0,9,0,9,9,0,9,0,0,0,18,0,18
KERALA,2008,RAPE,0,0,0,33,0,33,38,0,38,10,0,10,81,0,81
KERALA,2008,KIDNAPPING AND ABDUCTION,0,0,0,11,0,11,13,0,13,1,0,1,25,0,25
KERALA,2008,DACOITY,0,0,0,21,0,21,21,0,21,3,0,3,45,0,45
KERALA,2008,PREP. AND ASSEMBLY FOR DACOITY,0,0,0,17,0,17,21,0,21,2,0,2,40,0,40
KERALA,2008,ROBBERY,0,0,0,65,0,65,71,0,71,19,0,19,155,0,155
KERALA,2008,BURGLARY,0,0,0,20,0,20,20,1,21,3,0,3,43,1,44
KERALA,2008,THEFTS,0,0,0,98,3,101,102,5,107,66,2,68,266,10,276
KERALA,2008,EXTORTION,0,0,0,20,0,20,32,1,33,7,0,7,59,1,60
KERALA,2008,RIOTS,0,0,0,6,0,6,6,0,6,1,0,1,13,0,13
KERALA,2008,ARSON,0,0,0,7,0,7,4,0,4,0,0,0,11,0,11
KERALA,2008,CRIMINAL BREACH OF TRUST,0,0,0,2,0,2,5,0,5,0,0,0,7,0,7
KERALA,2008,CHEATING,0,0,0,12,0,12,25,1,26,15,0,15,52,1,53
KERALA,2008,COUNTER FEITING,0,0,0,3,0,3,0,0,0,2,0,2,5,0,5
KERALA,2008,DOWRY DEATHS,0,0,0,3,0,3,8,0,8,2,1,3,13,1,14
KERALA,2008,MOLESTATION,0,0,0,0,0,0,0,0,0,0,0,0,0,0,0
KERALA,2008,EVE-TEASING,0,0,0,0,0,0,0,0,0,0,0,0,0,0,0
KERALA,2008,CRUELTY BY HUSBAND OR RELATIVE OF HUSBAND,0,0,0,9,0,9,18,0,18,4,0,4,31,0,31
KERALA,2008,OTHER IPC CRIMES,0,0,0,10,0,10,12,0,12,4,0,4,26,0,26
KERALA,2008,TOTAL IPC,0,0,0,703,6,709,1134,27,1161,431,9,440,2268,42,2310
KERALA,2009,MURDER,0,0,0,431,3,434,711,19,730,199,2,201,1341,24,1365
KERALA,2009,ATTEMPT TO COMMIT MURDER,0,0,0,33,0,33,61,0,61,28,0,28,122,0,122
KERALA,2009,C.H. NOT AMOUNTING TO MURDER,0,0,0,9,0,9,18,0,18,10,0,10,37,0,37
KERALA,2009,RAPE,0,0,0,17,0,17,31,1,32,0,0,0,48,1,49
KERALA,2009,KIDNAPPING AND ABDUCTION,0,0,0,2,0,2,0,0,0,0,0,0,2,0,2
KERALA,2009,DACOITY,0,0,0,9,0,9,16,0,16,15,0,15,40,0,40
KERALA,2009,PREP. AND ASSEMBLY FOR DACOITY,0,0,0,6,0,6,13,0,13,0,0,0,19,0,19
KERALA,2009,ROBBERY,0,0,0,64,0,64,29,0,29,53,0,53,146,0,146
KERALA,2009,BURGLARY,0,0,0,52,0,52,35,0,35,39,0,39,126,0,126
KERALA,2009,THEFTS,0,0,0,111,4,115,116,1,117,29,0,29,256,5,261
KERALA,2009,EXTORTION,0,0,0,0,1,1,0,1,1,0,0,0,0,2,2
KERALA,2009,RIOTS,0,0,0,41,0,41,22,0,22,11,0,11,74,0,74
KERALA,2009,ARSON,0,0,0,1,0,1,1,0,1,0,0,0,2,0,2
KERALA,2009,CRIMINAL BREACH OF TRUST,0,0,0,8,0,8,2,0,2,4,0,4,14,0,14
KERALA,2009,CHEATING,0,0,0,7,0,7,29,1,30,2,0,2,38,1,39
KERALA,2009,COUNTER FEITING,0,0,0,3,0,3,2,0,2,4,0,4,9,0,9
KERALA,2009,DOWRY DEATHS,0,0,0,3,0,3,6,0,6,6,0,6,15,0,15
KERALA,2009,MOLESTATION,0,0,0,0,0,0,10,0,10,6,0,6,16,0,16
KERALA,2009,EVE-TEASING,0,0,0,0,0,0,0,0,0,0,0,0,0,0,0
KERALA,2009,CRUELTY BY HUSBAND OR RELATIVE OF HUSBAND,0,0,0,11,0,11,10,0,10,6,0,6,27,0,27
KERALA,2009,OTHER IPC CRIMES,0,0,0,25,0,25,43,2,45,11,4,15,79,6,85
KERALA,2009,TOTAL IPC,0,0,0,833,8,841,1155,25,1180,423,6,429,2411,39,2450
KERALA,2010,MURDER,0,0,0,569,7,576,783,19,802,231,3,234,1583,29,1612
KERALA,2010,ATTEMPT TO COMMIT MURDER,0,0,0,33,0,33,45,1,46,48,0,48,126,1,127
KERALA,2010,C.H. NOT AMOUNTING TO MURDER,0,0,0,4,0,4,11,0,11,23,0,23,38,0,38
KERALA,2010,RAPE,0,0,0,8,0,8,15,0,15,0,0,0,23,0,23
KERALA,2010,KIDNAPPING AND ABDUCTION,0,0,0,0,0,0,0,0,0,0,0,0,0,0,0
KERALA,2010,DACOITY,0,0,0,9,0,9,4,0,4,15,0,15,28,0,28
KERALA,2010,PREP. AND ASSEMBLY FOR DACOITY,0,0,0,6,0,6,9,0,9,0,0,0,15,0,15
KERALA,2010,ROBBERY,0,0,0,21,0,21,18,0,18,53,0,53,92,0,92
KERALA,2010,BURGLARY,0,0,0,31,0,31,22,0,22,41,0,41,94,0,94
KERALA,2010,THEFTS,0,0,0,52,2,54,72,1,73,36,0,36,160,3,163
KERALA,2010,EXTORTION,0,0,0,0,0,0,0,0,0,0,0,0,0,0,0
KERALA,2010,RIOTS,0,0,0,20,0,20,12,0,12,11,0,11,43,0,43
KERALA,2010,ARSON,0,0,0,1,0,1,1,0,1,0,0,0,2,0,2
KERALA,2010,CRIMINAL BREACH OF TRUST,0,0,0,8,0,8,2,0,2,4,0,4,14,0,14
KERALA,2010,CHEATING,0,0,0,7,0,7,13,0,13,2,0,2,22,0,22
KERALA,2010,COUNTER FEITING,0,0,0,1,0,1,2,0,2,4,0,4,7,0,7
KERALA,2010,DOWRY DEATHS,0,0,0,3,0,3,6,0,6,6,0,6,15,0,15
KERALA,2010,MOLESTATION,0,0,0,0,0,0,6,0,6,6,0,6,12,0,12
KERALA,2010,EVE-TEASING,0,0,0,0,0,0,0,0,0,0,0,0,0,0,0
KERALA,2010,CRUELTY BY HUSBAND OR RELATIVE OF HUSBAND,0,0,0,5,0,5,4,0,4,6,0,6,15,0,15
KERALA,2010,OTHER IPC CRIMES,0,0,0,10,0,10,35,0,35,11,4,15,56,4,60
KERALA,2010,TOTAL IPC,0,0,0,788,9,797,1060,21,1081,497,7,504,2345,37,2382
KERALA,2011,MURDER,0,0,0,449,1,450,616,19,635,167,4,171,1232,24,1256
KERALA,2011,ATTEMPT TO COMMIT MURDER,0,0,0,36,0,36,55,1,56,35,0,35,126,1,127
KERALA,2011,C.H. NOT AMOUNTING TO MURDER,0,0,0,6,0,6,11,0,11,20,0,20,37,0,37
KERALA,2011,RAPE,0,0,0,8,0,8,35,0,35,0,0,0,43,0,43
KERALA,2011,KIDNAPPING AND ABDUCTION,0,0,0,0,0,0,0,0,0,0,0,0,0,0,0
KERALA,2011,DACOITY,0,0,0,9,0,9,4,0,4,15,0,15,28,0,28
KERALA,2011,PREP. AND ASSEMBLY FOR DACOITY,0,0,0,8,0,8,9,0,9,0,0,0,17,0,17
KERALA,2011,ROBBERY,0,0,0,24,0,24,18,0,18,43,0,43,85,0,85
KERALA,2011,BURGLARY,0,0,0,32,0,32,22,0,22,41,0,41,95,0,95
KERALA,2011,THEFTS,0,0,0,40,5,45,77,7,84,28,0,28,145,12,157
KERALA,2011,EXTORTION,0,0,0,0,0,0,0,0,0,0,0,0,0,0,0
KERALA,2011,RIOTS,0,0,0,21,0,21,12,0,12,11,0,11,44,0,44
KERALA,2011,ARSON,0,0,0,1,0,1,1,0,1,0,0,0,2,0,2
KERALA,2011,CRIMINAL BREACH OF TRUST,0,0,0,5,0,5,3,0,3,4,0,4,12,0,12
KERALA,2011,CHEATING,0,0,0,8,0,8,11,0,11,2,0,2,21,0,21
KERALA,2011,COUNTER FEITING,0,0,0,3,0,3,3,0,3,4,0,4,10,0,10
KERALA,2011,DOWRY DEATHS,0,0,0,2,0,2,4,0,4,5,0,5,11,0,11
KERALA,2011,MOLESTATION,0,0,0,2,0,2,8,0,8,7,0,7,17,0,17
KERALA,2011,EVE-TEASING,0,0,0,0,0,0,1,0,1,0,0,0,1,0,1
KERALA,2011,CRUELTY BY HUSBAND OR RELATIVE OF HUSBAND,0,0,0,4,0,4,3,0,3,6,0,6,13,0,13
KERALA,2011,OTHER IPC CRIMES,0,0,0,10,0,10,40,0,40,11,4,15,61,4,65
KERALA,2011,TOTAL IPC,0,0,0,668,6,674,933,27,960,399,8,407,2000,41,2041
KERALA,2012,MURDER,0,0,0,451,4,455,758,20,778,230,5,235,1439,29,1468
KERALA,2012,ATTEMPT TO COMMIT MURDER,0,0,0,37,0,37,58,2,60,38,0,38,133,2,135
KERALA,2012,C.H. NOT AMOUNTING TO MURDER,0,0,0,7,0,7,15,0,15,21,0,21,43,0,43
KERALA,2012,RAPE,0,0,0,0,0,0,0,0,0,0,0,0,0,0,0
KERALA,2012,KIDNAPPING AND ABDUCTION,0,0,0,0,0,0,0,0,0,0,0,0,0,0,0
KERALA,2012,DACOITY,0,0,0,11,0,11,6,0,6,18,0,18,35,0,35
KERALA,2012,PREP. AND ASSEMBLY FOR DACOITY,0,0,0,11,0,11,15,0,15,0,0,0,26,0,26
KERALA,2012,ROBBERY,0,0,0,27,0,27,21,0,21,53,0,53,101,0,101
KERALA,2012,BURGLARY,0,0,0,35,0,35,26,0,26,52,0,52,113,0,113
KERALA,2012,THEFTS,0,0,0,44,7,51,81,4,85,39,0,39,164,11,175
KERALA,2012,EXTORTION,0,0,0,0,0,0,0,0,0,0,0,0,0,0,0
KERALA,2012,RIOTS,0,0,0,23,0,23,15,0,15,12,0,12,50,0,50
KERALA,2012,ARSON,0,0,0,9,0,9,4,0,4,6,0,6,19,0,19
KERALA,2012,CRIMINAL BREACH OF TRUST,0,0,0,9,0,9,15,0,15,3,0,3,27,0,27
KERALA,2012,CHEATING,0,0,0,1,0,1,3,0,3,5,0,5,9,0,9
KERALA,2012,COUNTER FEITING,0,0,0,4,0,4,7,0,7,7,0,7,18,0,18
KERALA,2012,DOWRY DEATHS,0,0,0,0,0,0,7,0,7,7,0,7,14,0,14
KERALA,2012,MOLESTATION,0,0,0,0,0,0,0,0,0,0,0,0,0,0,0
KERALA,2012,EVE-TEASING,0,0,0,0,0,0,0,0,0,0,0,0,0,0,0
KERALA,2012,CRUELTY BY HUSBAND OR RELATIVE OF HUSBAND,0,0,0,6,0,6,5,0,5,7,0,7,18,0,18
KERALA,2012,OTHER IPC CRIMES,0,0,0,11,0,11,40,0,40,12,0,12,63,0,63
KERALA,2012,TOTAL IPC,0,0,0,686,11,697,1076,26,1102,510,5,515,2272,42,2314
MADHYA PRADESH,2001,MURDER,13,0,13,3403,62,3465,3224,103,3327,975,22,997,7615,187,7802
MADHYA PRADESH,2001,ATTEMPT TO COMMIT MURDER,5,0,5,340,0,340,170,0,170,39,0,39,554,0,554
MADHYA PRADESH,2001,C.H. NOT AMOUNTING TO MURDER,7,0,7,285,4,289,138,8,146,42,3,45,472,15,487
MADHYA PRADESH,2001,RAPE,0,0,0,533,1,534,299,3,302,38,0,38,870,4,874
MADHYA PRADESH,2001,KIDNAPPING AND ABDUCTION,0,0,0,80,3,83,53,2,55,3,2,5,136,7,143
MADHYA PRADESH,2001,DACOITY,2,0,2,107,0,107,82,0,82,16,0,16,207,0,207
MADHYA PRADESH,2001,PREP. AND ASSEMBLY FOR DACOITY,0,0,0,23,0,23,15,0,15,3,0,3,41,0,41
MADHYA PRADESH,2001,ROBBERY,0,0,0,69,0,69,39,0,39,8,0,8,116,0,116
MADHYA PRADESH,2001,BURGLARY,0,0,0,50,0,50,19,0,19,6,0,6,75,0,75
MADHYA PRADESH,2001,THEFTS,2,0,2,104,0,104,61,1,62,12,1,13,179,2,181
MADHYA PRADESH,2001,EXTORTION,0,0,0,3,0,3,1,0,1,0,0,0,4,0,4
MADHYA PRADESH,2001,RIOTS,0,0,0,0,0,0,0,0,0,0,0,0,0,0,0
MADHYA PRADESH,2001,ARSON,0,0,0,7,0,7,4,0,4,1,0,1,12,0,12
MADHYA PRADESH,2001,CRIMINAL BREACH OF TRUST,0,0,0,8,0,8,6,0,6,2,0,2,16,0,16
MADHYA PRADESH,2001,CHEATING,0,0,0,7,0,7,10,0,10,2,0,2,19,0,19
MADHYA PRADESH,2001,COUNTER FEITING,0,0,0,4,0,4,1,0,1,1,0,1,6,0,6
MADHYA PRADESH,2001,DOWRY DEATHS,0,0,0,54,0,54,37,4,41,14,3,17,105,7,112
MADHYA PRADESH,2001,MOLESTATION,0,0,0,2,0,2,4,0,4,0,0,0,6,0,6
MADHYA PRADESH,2001,EVE-TEASING,0,0,0,1,0,1,0,0,0,1,0,1,2,0,2
MADHYA PRADESH,2001,CRUELTY BY HUSBAND OR RELATIVE OF HUSBAND,0,0,0,18,0,18,8,2,10,6,1,7,32,3,35
MADHYA PRADESH,2001,OTHER IPC CRIMES,6,0,6,190,3,193,162,2,164,25,2,27,383,7,390
MADHYA PRADESH,2001,TOTAL IPC,35,0,35,5288,73,5361,4333,125,4458,1194,34,1228,10850,232,11082
MADHYA PRADESH,2002,MURDER,15,0,15,2000,43,2043,3449,73,3522,602,24,626,6066,140,6206
MADHYA PRADESH,2002,ATTEMPT TO COMMIT MURDER,3,0,3,297,0,297,198,6,204,62,0,62,560,6,566
MADHYA PRADESH,2002,C.H. NOT AMOUNTING TO MURDER,0,0,0,222,3,225,167,2,169,67,4,71,456,9,465
MADHYA PRADESH,2002,RAPE,3,0,3,443,2,445,220,2,222,31,3,34,697,7,704
MADHYA PRADESH,2002,KIDNAPPING AND ABDUCTION,4,0,4,206,2,208,71,1,72,12,1,13,293,4,297
MADHYA PRADESH,2002,DACOITY,0,0,0,143,0,143,82,0,82,17,0,17,242,0,242
MADHYA PRADESH,2002,PREP. AND ASSEMBLY FOR DACOITY,0,0,0,49,0,49,60,0,60,5,0,5,114,0,114
MADHYA PRADESH,2002,ROBBERY,3,0,3,135,0,135,79,0,79,11,0,11,228,0,228
MADHYA PRADESH,2002,BURGLARY,3,0,3,109,0,109,111,3,114,12,0,12,235,3,238
MADHYA PRADESH,2002,THEFTS,0,0,0,205,2,207,163,3,166,30,0,30,398,5,403
MADHYA PRADESH,2002,EXTORTION,0,0,0,5,0,5,2,0,2,0,0,0,7,0,7
MADHYA PRADESH,2002,RIOTS,0,0,0,20,0,20,12,0,12,3,0,3,35,0,35
MADHYA PRADESH,2002,ARSON,0,0,0,9,0,9,6,0,6,2,0,2,17,0,17
MADHYA PRADESH,2002,CRIMINAL BREACH OF TRUST,0,0,0,6,0,6,4,0,4,4,0,4,14,0,14
MADHYA PRADESH,2002,CHEATING,0,0,0,10,0,10,13,0,13,0,0,0,23,0,23
MADHYA PRADESH,2002,COUNTER FEITING,0,0,0,12,0,12,17,2,19,5,0,5,34,2,36
MADHYA PRADESH,2002,DOWRY DEATHS,0,0,0,61,3,64,39,5,44,18,8,26,118,16,134
MADHYA PRADESH,2002,MOLESTATION,0,0,0,21,0,21,16,0,16,1,0,1,38,0,38
MADHYA PRADESH,2002,EVE-TEASING,0,0,0,1,0,1,1,0,1,0,0,0,2,0,2
MADHYA PRADESH,2002,CRUELTY BY HUSBAND OR RELATIVE OF HUSBAND,0,0,0,37,2,39,19,3,22,8,0,8,64,5,69
MADHYA PRADESH,2002,OTHER IPC CRIMES,4,0,4,303,3,306,287,5,292,65,2,67,659,10,669
MADHYA PRADESH,2002,TOTAL IPC,35,0,35,4294,60,4354,5016,105,5121,955,42,997,10300,207,10507
MADHYA PRADESH,2003,MURDER,2,0,2,2801,71,2872,3261,124,3385,619,31,650,6683,226,6909
MADHYA PRADESH,2003,ATTEMPT TO COMMIT MURDER,0,0,0,327,3,330,410,6,416,94,11,105,831,20,851
MADHYA PRADESH,2003,C.H. NOT AMOUNTING TO MURDER,0,0,0,190,12,202,171,6,177,46,1,47,407,19,426
MADHYA PRADESH,2003,RAPE,0,0,0,388,2,390,308,14,322,60,0,60,756,16,772
MADHYA PRADESH,2003,KIDNAPPING AND ABDUCTION,2,0,2,132,5,137,125,1,126,52,0,52,311,6,317
MADHYA PRADESH,2003,DACOITY,0,0,0,54,0,54,83,0,83,29,0,29,166,0,166
MADHYA PRADESH,2003,PREP. AND ASSEMBLY FOR DACOITY,0,0,0,32,0,32,38,0,38,4,0,4,74,0,74
MADHYA PRADESH,2003,ROBBERY,0,0,0,104,0,104,124,0,124,34,0,34,262,0,262
MADHYA PRADESH,2003,BURGLARY,0,0,0,48,0,48,60,0,60,27,0,27,135,0,135
MADHYA PRADESH,2003,THEFTS,0,0,0,125,6,131,143,1,144,16,0,16,284,7,291
MADHYA PRADESH,2003,EXTORTION,0,0,0,3,0,3,33,0,33,0,0,0,36,0,36
MADHYA PRADESH,2003,RIOTS,0,0,0,4,0,4,5,0,5,4,0,4,13,0,13
MADHYA PRADESH,2003,ARSON,0,0,0,9,0,9,10,0,10,10,0,10,29,0,29
MADHYA PRADESH,2003,CRIMINAL BREACH OF TRUST,0,0,0,5,0,5,16,0,16,2,0,2,23,0,23
MADHYA PRADESH,2003,CHEATING,0,0,0,29,8,37,19,0,19,0,0,0,48,8,56
MADHYA PRADESH,2003,COUNTER FEITING,0,0,0,15,0,15,1,0,1,0,0,0,16,0,16
MADHYA PRADESH,2003,DOWRY DEATHS,0,0,0,86,7,93,79,17,96,33,13,46,198,37,235
MADHYA PRADESH,2003,MOLESTATION,0,0,0,14,0,14,24,0,24,0,0,0,38,0,38
MADHYA PRADESH,2003,EVE-TEASING,0,0,0,0,0,0,0,0,0,0,0,0,0,0,0
MADHYA PRADESH,2003,CRUELTY BY HUSBAND OR RELATIVE OF HUSBAND,0,0,0,22,0,22,32,1,33,12,1,13,66,2,68
MADHYA PRADESH,2003,OTHER IPC CRIMES,0,0,0,153,4,157,212,3,215,50,0,50,415,7,422
MADHYA PRADESH,2003,TOTAL IPC,4,0,4,4541,118,4659,5154,173,5327,1092,57,1149,10791,348,11139
MADHYA PRADESH,2004,MURDER,0,0,0,2405,56,2461,4297,84,4381,1026,16,1042,7728,156,7884
MADHYA PRADESH,2004,ATTEMPT TO COMMIT MURDER,0,0,0,270,9,279,380,5,385,70,2,72,720,16,736
MADHYA PRADESH,2004,C.H. NOT AMOUNTING TO MURDER,0,0,0,138,3,141,182,13,195,40,2,42,360,18,378
MADHYA PRADESH,2004,RAPE,0,0,0,436,1,437,318,1,319,43,0,43,797,2,799
MADHYA PRADESH,2004,KIDNAPPING AND ABDUCTION,0,0,0,87,4,91,113,3,116,29,2,31,229,9,238
MADHYA PRADESH,2004,DACOITY,0,0,0,63,0,63,101,0,101,26,0,26,190,0,190
MADHYA PRADESH,2004,PREP. AND ASSEMBLY FOR DACOITY,0,0,0,17,0,17,26,0,26,8,0,8,51,0,51
MADHYA PRADESH,2004,ROBBERY,0,0,0,87,0,87,146,0,146,31,0,31,264,0,264
MADHYA PRADESH,2004,BURGLARY,0,0,0,36,0,36,44,0,44,10,0,10,90,0,90
MADHYA PRADESH,2004,THEFTS,0,0,0,89,1,90,53,0,53,19,0,19,161,1,162
MADHYA PRADESH,2004,EXTORTION,0,0,0,2,0,2,6,0,6,2,0,2,10,0,10
MADHYA PRADESH,2004,RIOTS,0,0,0,8,0,8,9,0,9,0,0,0,17,0,17
MADHYA PRADESH,2004,ARSON,0,0,0,6,0,6,8,0,8,0,0,0,14,0,14
MADHYA PRADESH,2004,CRIMINAL BREACH OF TRUST,0,0,0,9,0,9,16,0,16,7,0,7,32,0,32
MADHYA PRADESH,2004,CHEATING,0,0,0,9,0,9,14,0,14,7,0,7,30,0,30
MADHYA PRADESH,2004,COUNTER FEITING,0,0,0,2,0,2,9,0,9,1,0,1,12,0,12
MADHYA PRADESH,2004,DOWRY DEATHS,0,0,0,86,1,87,109,9,118,29,6,35,224,16,240
MADHYA PRADESH,2004,MOLESTATION,0,0,0,9,0,9,17,0,17,2,0,2,28,0,28
MADHYA PRADESH,2004,EVE-TEASING,0,0,0,1,0,1,1,0,1,0,0,0,2,0,2
MADHYA PRADESH,2004,CRUELTY BY HUSBAND OR RELATIVE OF HUSBAND,0,0,0,31,0,31,76,3,79,8,7,15,115,10,125
MADHYA PRADESH,2004,OTHER IPC CRIMES,0,0,0,106,0,106,165,1,166,11,0,11,282,1,283
MADHYA PRADESH,2004,TOTAL IPC,0,0,0,3897,75,3972,6090,119,6209,1369,35,1404,11356,229,11585
MADHYA PRADESH,2005,MURDER,0,0,0,3196,57,3253,3851,81,3932,1077,21,1098,8124,159,8283
MADHYA PRADESH,2005,ATTEMPT TO COMMIT MURDER,0,0,0,447,8,455,279,4,283,105,3,108,831,15,846
MADHYA PRADESH,2005,C.H. NOT AMOUNTING TO MURDER,0,0,0,159,4,163,146,3,149,48,3,51,353,10,363
MADHYA PRADESH,2005,RAPE,0,0,0,412,0,412,296,0,296,39,0,39,747,0,747
MADHYA PRADESH,2005,KIDNAPPING AND ABDUCTION,0,0,0,126,5,131,113,2,115,38,1,39,277,8,285
MADHYA PRADESH,2005,DACOITY,0,0,0,142,0,142,108,0,108,23,0,23,273,0,273
MADHYA PRADESH,2005,PREP. AND ASSEMBLY FOR DACOITY,0,0,0,38,0,38,33,0,33,11,0,11,82,0,82
MADHYA PRADESH,2005,ROBBERY,0,0,0,92,0,92,71,0,71,22,0,22,185,0,185
MADHYA PRADESH,2005,BURGLARY,0,0,0,43,0,43,38,0,38,10,0,10,91,0,91
MADHYA PRADESH,2005,THEFTS,0,0,0,156,1,157,60,0,60,23,0,23,239,1,240
MADHYA PRADESH,2005,EXTORTION,0,0,0,4,0,4,3,0,3,0,0,0,7,0,7
MADHYA PRADESH,2005,RIOTS,0,0,0,17,0,17,20,0,20,6,0,6,43,0,43
MADHYA PRADESH,2005,ARSON,0,0,0,6,0,6,10,0,10,1,0,1,17,0,17
MADHYA PRADESH,2005,CRIMINAL BREACH OF TRUST,0,0,0,11,0,11,14,0,14,5,0,5,30,0,30
MADHYA PRADESH,2005,CHEATING,0,0,0,20,0,20,26,1,27,9,1,10,55,2,57
MADHYA PRADESH,2005,COUNTER FEITING,0,0,0,22,0,22,6,0,6,0,0,0,28,0,28
MADHYA PRADESH,2005,DOWRY DEATHS,0,0,0,74,6,80,104,15,119,29,5,34,207,26,233
MADHYA PRADESH,2005,MOLESTATION,0,0,0,48,0,48,9,0,9,2,0,2,59,0,59
MADHYA PRADESH,2005,EVE-TEASING,0,0,0,5,0,5,0,0,0,0,0,0,5,0,5
MADHYA PRADESH,2005,CRUELTY BY HUSBAND OR RELATIVE OF HUSBAND,0,0,0,30,1,31,35,9,44,9,3,12,74,13,87
MADHYA PRADESH,2005,OTHER IPC CRIMES,0,0,0,223,7,230,250,7,257,90,0,90,563,14,577
MADHYA PRADESH,2005,TOTAL IPC,0,0,0,5271,89,5360,5472,122,5594,1547,37,1584,12290,248,12538
MADHYA PRADESH,2006,MURDER,0,0,0,3465,65,3530,4265,102,4367,1208,19,1227,8938,186,9124
MADHYA PRADESH,2006,ATTEMPT TO COMMIT MURDER,0,0,0,359,5,364,278,14,292,104,2,106,741,21,762
MADHYA PRADESH,2006,C.H. NOT AMOUNTING TO MURDER,0,0,0,163,6,169,180,13,193,64,1,65,407,20,427
MADHYA PRADESH,2006,RAPE,0,0,0,481,0,481,354,0,354,44,0,44,879,0,879
MADHYA PRADESH,2006,KIDNAPPING AND ABDUCTION,0,0,0,132,5,137,107,2,109,34,0,34,273,7,280
MADHYA PRADESH,2006,DACOITY,0,0,0,102,0,102,76,0,76,24,0,24,202,0,202
MADHYA PRADESH,2006,PREP. AND ASSEMBLY FOR DACOITY,0,0,0,35,0,35,25,0,25,8,0,8,68,0,68
MADHYA PRADESH,2006,ROBBERY,0,0,0,138,2,140,69,2,71,25,0,25,232,4,236
MADHYA PRADESH,2006,BURGLARY,0,0,0,31,0,31,30,0,30,5,0,5,66,0,66
MADHYA PRADESH,2006,THEFTS,0,0,0,149,2,151,79,0,79,20,0,20,248,2,250
MADHYA PRADESH,2006,EXTORTION,0,0,0,6,0,6,9,0,9,0,0,0,15,0,15
MADHYA PRADESH,2006,RIOTS,0,0,0,9,0,9,10,0,10,2,0,2,21,0,21
MADHYA PRADESH,2006,ARSON,0,0,0,7,0,7,9,0,9,2,0,2,18,0,18
MADHYA PRADESH,2006,CRIMINAL BREACH OF TRUST,0,0,0,5,0,5,9,0,9,4,0,4,18,0,18
MADHYA PRADESH,2006,CHEATING,0,0,0,23,1,24,28,1,29,8,0,8,59,2,61
MADHYA PRADESH,2006,COUNTER FEITING,0,0,0,18,0,18,8,0,8,3,0,3,29,0,29
MADHYA PRADESH,2006,DOWRY DEATHS,0,0,0,112,8,120,86,18,104,32,10,42,230,36,266
MADHYA PRADESH,2006,MOLESTATION,0,0,0,17,0,17,6,0,6,1,0,1,24,0,24
MADHYA PRADESH,2006,EVE-TEASING,0,0,0,1,0,1,0,0,0,0,0,0,1,0,1
MADHYA PRADESH,2006,CRUELTY BY HUSBAND OR RELATIVE OF HUSBAND,0,0,0,32,1,33,18,0,18,8,1,9,58,2,60
MADHYA PRADESH,2006,OTHER IPC CRIMES,0,0,0,231,3,234,235,5,240,82,0,82,548,8,556
MADHYA PRADESH,2006,TOTAL IPC,0,0,0,5516,98,5614,5881,157,6038,1678,33,1711,13075,288,13363
MADHYA PRADESH,2007,MURDER,0,0,0,3403,28,3431,4871,123,4994,1278,21,1299,9552,172,9724
MADHYA PRADESH,2007,ATTEMPT TO COMMIT MURDER,0,0,0,264,11,275,365,18,383,105,0,105,734,29,763
MADHYA PRADESH,2007,C.H. NOT AMOUNTING TO MURDER,0,0,0,147,7,154,178,4,182,81,6,87,406,17,423
MADHYA PRADESH,2007,RAPE,0,0,0,421,3,424,319,2,321,40,0,40,780,5,785
MADHYA PRADESH,2007,KIDNAPPING AND ABDUCTION,0,0,0,81,4,85,120,2,122,24,0,24,225,6,231
MADHYA PRADESH,2007,DACOITY,0,0,0,104,2,106,109,3,112,29,0,29,242,5,247
MADHYA PRADESH,2007,PREP. AND ASSEMBLY FOR DACOITY,0,0,0,32,0,32,31,0,31,9,0,9,72,0,72
MADHYA PRADESH,2007,ROBBERY,0,0,0,97,3,100,70,1,71,21,0,21,188,4,192
MADHYA PRADESH,2007,BURGLARY,0,0,0,30,0,30,35,0,35,6,0,6,71,0,71
MADHYA PRADESH,2007,THEFTS,0,0,0,140,3,143,127,3,130,29,1,30,296,7,303
MADHYA PRADESH,2007,EXTORTION,0,0,0,17,0,17,8,0,8,0,0,0,25,0,25
MADHYA PRADESH,2007,RIOTS,0,0,0,8,0,8,5,0,5,1,0,1,14,0,14
MADHYA PRADESH,2007,ARSON,0,0,0,5,0,5,8,0,8,1,0,1,14,0,14
MADHYA PRADESH,2007,CRIMINAL BREACH OF TRUST,0,0,0,4,0,4,11,0,11,1,0,1,16,0,16
MADHYA PRADESH,2007,CHEATING,0,0,0,10,2,12,25,0,25,7,0,7,42,2,44
MADHYA PRADESH,2007,COUNTER FEITING,0,0,0,13,0,13,13,0,13,1,0,1,27,0,27
MADHYA PRADESH,2007,DOWRY DEATHS,0,0,0,100,6,106,125,19,144,44,10,54,269,35,304
MADHYA PRADESH,2007,MOLESTATION,0,0,0,17,0,17,10,0,10,3,0,3,30,0,30
MADHYA PRADESH,2007,EVE-TEASING,0,0,0,0,0,0,1,0,1,0,0,0,1,0,1
MADHYA PRADESH,2007,CRUELTY BY HUSBAND OR RELATIVE OF HUSBAND,0,0,0,29,7,36,45,5,50,15,0,15,89,12,101
MADHYA PRADESH,2007,OTHER IPC CRIMES,0,0,0,488,8,496,293,7,300,78,2,80,859,17,876
MADHYA PRADESH,2007,TOTAL IPC,0,0,0,5410,84,5494,6769,187,6956,1773,40,1813,13952,311,14263
MADHYA PRADESH,2008,MURDER,0,0,0,3275,53,3328,5268,109,5377,853,24,877,9396,186,9582
MADHYA PRADESH,2008,ATTEMPT TO COMMIT MURDER,0,0,0,275,9,284,324,13,337,57,1,58,656,23,679
MADHYA PRADESH,2008,C.H. NOT AMOUNTING TO MURDER,0,0,0,141,7,148,218,5,223,44,6,50,403,18,421
MADHYA PRADESH,2008,RAPE,0,0,0,397,2,399,365,1,366,35,0,35,797,3,800
MADHYA PRADESH,2008,KIDNAPPING AND ABDUCTION,0,0,0,95,1,96,121,4,125,24,2,26,240,7,247
MADHYA PRADESH,2008,DACOITY,0,0,0,111,2,113,116,0,116,26,0,26,253,2,255
MADHYA PRADESH,2008,PREP. AND ASSEMBLY FOR DACOITY,0,0,0,34,0,34,59,0,59,11,0,11,104,0,104
MADHYA PRADESH,2008,ROBBERY,0,0,0,114,3,117,93,1,94,17,0,17,224,4,228
MADHYA PRADESH,2008,BURGLARY,0,0,0,41,0,41,30,0,30,4,0,4,75,0,75
MADHYA PRADESH,2008,THEFTS,0,0,0,146,6,152,129,5,134,24,5,29,299,16,315
MADHYA PRADESH,2008,EXTORTION,0,0,0,2,0,2,2,0,2,0,0,0,4,0,4
MADHYA PRADESH,2008,RIOTS,0,0,0,6,0,6,7,0,7,0,0,0,13,0,13
MADHYA PRADESH,2008,ARSON,0,0,0,7,0,7,17,0,17,1,0,1,25,0,25
MADHYA PRADESH,2008,CRIMINAL BREACH OF TRUST,0,0,0,3,0,3,8,0,8,0,0,0,11,0,11
MADHYA PRADESH,2008,CHEATING,0,0,0,14,2,16,19,1,20,6,0,6,39,3,42
MADHYA PRADESH,2008,COUNTER FEITING,0,0,0,5,0,5,10,0,10,1,0,1,16,0,16
MADHYA PRADESH,2008,DOWRY DEATHS,0,0,0,96,4,100,114,30,144,33,12,45,243,46,289
MADHYA PRADESH,2008,MOLESTATION,0,0,0,19,0,19,21,0,21,2,0,2,42,0,42
MADHYA PRADESH,2008,EVE-TEASING,0,0,0,0,0,0,1,0,1,0,0,0,1,0,1
MADHYA PRADESH,2008,CRUELTY BY HUSBAND OR RELATIVE OF HUSBAND,0,0,0,24,6,30,29,9,38,6,0,6,59,15,74
MADHYA PRADESH,2008,OTHER IPC CRIMES,0,0,0,459,7,466,213,5,218,73,3,76,745,15,760
MADHYA PRADESH,2008,TOTAL IPC,0,0,0,5264,102,5366,7164,183,7347,1217,53,1270,13645,338,13983
MADHYA PRADESH,2009,MURDER,0,0,0,3085,50,3135,4741,108,4849,1019,29,1048,8845,187,9032
MADHYA PRADESH,2009,ATTEMPT TO COMMIT MURDER,0,0,0,239,3,242,364,16,380,55,0,55,658,19,677
MADHYA PRADESH,2009,C.H. NOT AMOUNTING TO MURDER,0,0,0,144,3,147,197,19,216,63,3,66,404,25,429
MADHYA PRADESH,2009,RAPE,0,0,0,393,0,393,279,1,280,39,0,39,711,1,712
MADHYA PRADESH,2009,KIDNAPPING AND ABDUCTION,0,0,0,87,7,94,114,4,118,30,0,30,231,11,242
MADHYA PRADESH,2009,DACOITY,0,0,0,101,1,102,105,1,106,35,0,35,241,2,243
MADHYA PRADESH,2009,PREP. AND ASSEMBLY FOR DACOITY,0,0,0,25,0,25,33,0,33,8,0,8,66,0,66
MADHYA PRADESH,2009,ROBBERY,0,0,0,111,0,111,92,1,93,13,0,13,216,1,217
MADHYA PRADESH,2009,BURGLARY,0,0,0,30,0,30,28,0,28,7,0,7,65,0,65
MADHYA PRADESH,2009,THEFTS,0,0,0,143,3,146,143,4,147,18,0,18,304,7,311
MADHYA PRADESH,2009,EXTORTION,0,0,0,4,0,4,2,0,2,0,0,0,6,0,6
MADHYA PRADESH,2009,RIOTS,0,0,0,6,0,6,11,0,11,0,0,0,17,0,17
MADHYA PRADESH,2009,ARSON,0,0,0,10,0,10,7,0,7,0,0,0,17,0,17
MADHYA PRADESH,2009,CRIMINAL BREACH OF TRUST,0,0,0,5,0,5,8,0,8,0,0,0,13,0,13
MADHYA PRADESH,2009,CHEATING,0,0,0,18,1,19,21,2,23,7,0,7,46,3,49
MADHYA PRADESH,2009,COUNTER FEITING,0,0,0,14,0,14,11,0,11,0,0,0,25,0,25
MADHYA PRADESH,2009,DOWRY DEATHS,0,0,0,94,11,105,169,28,197,56,10,66,319,49,368
MADHYA PRADESH,2009,MOLESTATION,0,0,0,7,0,7,12,0,12,1,0,1,20,0,20
MADHYA PRADESH,2009,EVE-TEASING,0,0,0,3,0,3,6,0,6,0,0,0,9,0,9
MADHYA PRADESH,2009,CRUELTY BY HUSBAND OR RELATIVE OF HUSBAND,0,0,0,27,4,31,31,5,36,9,1,10,67,10,77
MADHYA PRADESH,2009,OTHER IPC CRIMES,0,0,0,453,6,459,252,6,258,79,4,83,784,16,800
MADHYA PRADESH,2009,TOTAL IPC,0,0,0,4999,89,5088,6626,195,6821,1439,47,1486,13064,331,13395
MADHYA PRADESH,2010,MURDER,0,0,0,3962,77,4039,4357,121,4478,1052,35,1087,9371,233,9604
MADHYA PRADESH,2010,ATTEMPT TO COMMIT MURDER,0,0,0,207,3,210,185,6,191,69,2,71,461,11,472
MADHYA PRADESH,2010,C.H. NOT AMOUNTING TO MURDER,0,0,0,116,2,118,105,5,110,34,0,34,255,7,262
MADHYA PRADESH,2010,RAPE,0,0,0,237,0,237,191,1,192,26,0,26,454,1,455
MADHYA PRADESH,2010,KIDNAPPING AND ABDUCTION,0,0,0,107,5,112,106,2,108,43,1,44,256,8,264
MADHYA PRADESH,2010,DACOITY,0,0,0,88,0,88,59,0,59,13,0,13,160,0,160
MADHYA PRADESH,2010,PREP. AND ASSEMBLY FOR DACOITY,0,0,0,38,0,38,24,0,24,2,0,2,64,0,64
MADHYA PRADESH,2010,ROBBERY,0,0,0,73,0,73,65,0,65,9,0,9,147,0,147
MADHYA PRADESH,2010,BURGLARY,0,0,0,31,0,31,24,0,24,0,0,0,55,0,55
MADHYA PRADESH,2010,THEFTS,0,0,0,107,2,109,136,4,140,17,1,18,260,7,267
MADHYA PRADESH,2010,EXTORTION,0,0,0,9,0,9,2,0,2,0,0,0,11,0,11
MADHYA PRADESH,2010,RIOTS,0,0,0,5,0,5,5,0,5,0,0,0,10,0,10
MADHYA PRADESH,2010,ARSON,0,0,0,3,0,3,3,0,3,3,0,3,9,0,9
MADHYA PRADESH,2010,CRIMINAL BREACH OF TRUST,0,0,0,4,0,4,3,0,3,3,0,3,10,0,10
MADHYA PRADESH,2010,CHEATING,0,0,0,12,2,14,26,3,29,11,0,11,49,5,54
MADHYA PRADESH,2010,COUNTER FEITING,0,0,0,20,0,20,13,0,13,8,0,8,41,0,41
MADHYA PRADESH,2010,DOWRY DEATHS,0,0,0,86,11,97,98,23,121,72,11,83,256,45,301
MADHYA PRADESH,2010,MOLESTATION,0,0,0,13,0,13,9,0,9,2,0,2,24,0,24
MADHYA PRADESH,2010,EVE-TEASING,0,0,0,2,0,2,1,0,1,0,0,0,3,0,3
MADHYA PRADESH,2010,CRUELTY BY HUSBAND OR RELATIVE OF HUSBAND,0,0,0,32,1,33,38,2,40,13,1,14,83,4,87
MADHYA PRADESH,2010,OTHER IPC CRIMES,0,0,0,328,5,333,225,11,236,82,2,84,635,18,653
MADHYA PRADESH,2010,TOTAL IPC,0,0,0,5480,108,5588,5675,178,5853,1459,53,1512,12614,339,12953
MADHYA PRADESH,2011,MURDER,0,0,0,3899,90,3989,5231,149,5380,1032,38,1070,10162,277,10439
MADHYA PRADESH,2011,ATTEMPT TO COMMIT MURDER,0,0,0,425,5,430,371,5,376,44,0,44,840,10,850
MADHYA PRADESH,2011,C.H. NOT AMOUNTING TO MURDER,0,0,0,198,1,199,129,9,138,33,2,35,360,12,372
MADHYA PRADESH,2011,RAPE,0,0,0,332,2,334,214,1,215,31,0,31,577,3,580
MADHYA PRADESH,2011,KIDNAPPING AND ABDUCTION,0,0,0,111,3,114,77,5,82,25,0,25,213,8,221
MADHYA PRADESH,2011,DACOITY,0,0,0,138,0,138,61,0,61,6,0,6,205,0,205
MADHYA PRADESH,2011,PREP. AND ASSEMBLY FOR DACOITY,0,0,0,21,0,21,24,0,24,8,0,8,53,0,53
MADHYA PRADESH,2011,ROBBERY,0,0,0,160,0,160,67,0,67,3,0,3,230,0,230
MADHYA PRADESH,2011,BURGLARY,0,0,0,49,3,52,26,1,27,5,0,5,80,4,84
MADHYA PRADESH,2011,THEFTS,0,0,0,146,0,146,102,0,102,9,0,9,257,0,257
MADHYA PRADESH,2011,EXTORTION,0,0,0,2,1,3,6,0,6,0,0,0,8,1,9
MADHYA PRADESH,2011,RIOTS,0,0,0,10,0,10,13,0,13,3,0,3,26,0,26
MADHYA PRADESH,2011,ARSON,0,0,0,9,0,9,10,1,11,3,0,3,22,1,23
MADHYA PRADESH,2011,CRIMINAL BREACH OF TRUST,0,0,0,4,0,4,19,6,25,3,1,4,26,7,33
MADHYA PRADESH,2011,CHEATING,0,0,0,4,0,4,26,2,28,8,0,8,38,2,40
MADHYA PRADESH,2011,COUNTER FEITING,0,0,0,11,0,11,7,0,7,0,0,0,18,0,18
MADHYA PRADESH,2011,DOWRY DEATHS,0,0,0,97,8,105,87,14,101,49,10,59,233,32,265
MADHYA PRADESH,2011,MOLESTATION,0,0,0,14,0,14,11,0,11,1,0,1,26,0,26
MADHYA PRADESH,2011,EVE-TEASING,0,0,0,8,0,8,3,1,4,0,0,0,11,1,12
MADHYA PRADESH,2011,CRUELTY BY HUSBAND OR RELATIVE OF HUSBAND,0,0,0,24,3,27,15,2,17,7,0,7,46,5,51
MADHYA PRADESH,2011,OTHER IPC CRIMES,0,0,0,347,10,357,187,12,199,80,4,84,614,26,640
MADHYA PRADESH,2011,TOTAL IPC,0,0,0,6009,126,6135,6686,208,6894,1350,55,1405,14045,389,14434
MADHYA PRADESH,2012,MURDER,0,0,0,3608,76,3684,5144,177,5321,1351,58,1409,10103,311,10414
MADHYA PRADESH,2012,ATTEMPT TO COMMIT MURDER,0,0,0,304,3,307,256,5,261,54,3,57,614,11,625
MADHYA PRADESH,2012,C.H. NOT AMOUNTING TO MURDER,0,0,0,142,2,144,178,8,186,74,3,77,394,13,407
MADHYA PRADESH,2012,RAPE,0,0,0,479,5,484,302,3,305,51,0,51,832,8,840
MADHYA PRADESH,2012,KIDNAPPING AND ABDUCTION,0,0,0,111,3,114,121,5,126,26,0,26,258,8,266
MADHYA PRADESH,2012,DACOITY,0,0,0,103,0,103,72,0,72,15,0,15,190,0,190
MADHYA PRADESH,2012,PREP. AND ASSEMBLY FOR DACOITY,0,0,0,40,0,40,25,0,25,4,0,4,69,0,69
MADHYA PRADESH,2012,ROBBERY,0,0,0,193,0,193,97,0,97,15,0,15,305,0,305
MADHYA PRADESH,2012,BURGLARY,0,0,0,29,3,32,34,2,36,2,0,2,65,5,70
MADHYA PRADESH,2012,THEFTS,0,0,0,130,1,131,119,0,119,10,0,10,259,1,260
MADHYA PRADESH,2012,EXTORTION,0,0,0,1,0,1,12,0,12,0,0,0,13,0,13
MADHYA PRADESH,2012,RIOTS,0,0,0,0,0,0,0,0,0,0,0,0,0,0,0
MADHYA PRADESH,2012,ARSON,0,0,0,9,0,9,8,0,8,0,0,0,17,0,17
MADHYA PRADESH,2012,CRIMINAL BREACH OF TRUST,0,0,0,4,0,4,15,0,15,3,1,4,22,1,23
MADHYA PRADESH,2012,CHEATING,0,0,0,9,1,10,31,2,33,7,0,7,47,3,50
MADHYA PRADESH,2012,COUNTER FEITING,0,0,0,12,0,12,15,0,15,1,0,1,28,0,28
MADHYA PRADESH,2012,DOWRY DEATHS,0,0,0,129,18,147,127,28,155,42,13,55,298,59,357
MADHYA PRADESH,2012,MOLESTATION,0,0,0,14,0,14,25,0,25,1,0,1,40,0,40
MADHYA PRADESH,2012,EVE-TEASING,0,0,0,0,0,0,2,1,3,0,0,0,2,1,3
MADHYA PRADESH,2012,CRUELTY BY HUSBAND OR RELATIVE OF HUSBAND,0,0,0,17,1,18,17,1,18,4,0,4,38,2,40
MADHYA PRADESH,2012,OTHER IPC CRIMES,0,0,0,341,9,350,211,13,224,65,5,70,617,27,644
MADHYA PRADESH,2012,TOTAL IPC,0,0,0,5675,122,5797,6811,245,7056,1725,83,1808,14211,450,14661
MAHARASHTRA,2001,MURDER,0,0,0,1337,40,1377,1637,96,1733,474,29,503,3448,165,3613
MAHARASHTRA,2001,ATTEMPT TO COMMIT MURDER,0,0,0,56,4,60,60,3,63,15,0,15,131,7,138
MAHARASHTRA,2001,C.H. NOT AMOUNTING TO MURDER,0,0,0,70,0,70,58,0,58,10,0,10,138,0,138
MAHARASHTRA,2001,RAPE,0,0,0,114,0,114,87,0,87,13,0,13,214,0,214
MAHARASHTRA,2001,KIDNAPPING AND ABDUCTION,0,0,0,24,2,26,7,0,7,0,0,0,31,2,33
MAHARASHTRA,2001,DACOITY,0,0,0,66,2,68,38,1,39,7,0,7,111,3,114
MAHARASHTRA,2001,PREP. AND ASSEMBLY FOR DACOITY,0,0,0,18,1,19,8,1,9,2,0,2,28,2,30
MAHARASHTRA,2001,ROBBERY,0,0,0,41,0,41,24,0,24,6,0,6,71,0,71
MAHARASHTRA,2001,BURGLARY,0,0,0,55,0,55,26,0,26,5,0,5,86,0,86
MAHARASHTRA,2001,THEFTS,0,0,0,100,1,101,71,0,71,11,0,11,182,1,183
MAHARASHTRA,2001,EXTORTION,0,0,0,0,0,0,0,0,0,0,0,0,0,0,0
MAHARASHTRA,2001,RIOTS,0,0,0,18,0,18,15,0,15,0,0,0,33,0,33
MAHARASHTRA,2001,ARSON,0,0,0,0,0,0,0,0,0,0,0,0,0,0,0
MAHARASHTRA,2001,CRIMINAL BREACH OF TRUST,0,0,0,1,0,1,3,0,3,1,0,1,5,0,5
MAHARASHTRA,2001,CHEATING,0,0,0,14,1,15,26,1,27,6,0,6,46,2,48
MAHARASHTRA,2001,COUNTER FEITING,0,0,0,0,0,0,0,0,0,0,0,0,0,0,0
MAHARASHTRA,2001,DOWRY DEATHS,0,0,0,0,0,0,0,0,0,0,0,0,0,0,0
MAHARASHTRA,2001,MOLESTATION,0,0,0,0,0,0,0,0,0,0,0,0,0,0,0
MAHARASHTRA,2001,EVE-TEASING,0,0,0,0,0,0,0,0,0,0,0,0,0,0,0
MAHARASHTRA,2001,CRUELTY BY HUSBAND OR RELATIVE OF HUSBAND,0,0,0,0,0,0,0,0,0,0,0,0,0,0,0
MAHARASHTRA,2001,OTHER IPC CRIMES,0,0,0,292,2,294,225,24,249,12,4,16,529,30,559
MAHARASHTRA,2001,TOTAL IPC,0,0,0,2206,53,2259,2285,126,2411,562,33,595,5053,212,5265
MAHARASHTRA,2002,MURDER,0,0,0,1222,45,1267,2061,79,2140,438,37,475,3721,161,3882
MAHARASHTRA,2002,ATTEMPT TO COMMIT MURDER,0,0,0,93,2,95,104,3,107,26,0,26,223,5,228
MAHARASHTRA,2002,C.H. NOT AMOUNTING TO MURDER,0,0,0,66,0,66,79,3,82,26,0,26,171,3,174
MAHARASHTRA,2002,RAPE,0,0,0,97,0,97,75,0,75,12,0,12,184,0,184
MAHARASHTRA,2002,KIDNAPPING AND ABDUCTION,0,0,0,11,0,11,12,1,13,4,0,4,27,1,28
MAHARASHTRA,2002,DACOITY,0,0,0,58,0,58,48,0,48,5,0,5,111,0,111
MAHARASHTRA,2002,PREP. AND ASSEMBLY FOR DACOITY,0,0,0,24,0,24,13,0,13,1,0,1,38,0,38
MAHARASHTRA,2002,ROBBERY,0,0,0,47,0,47,43,0,43,5,0,5,95,0,95
MAHARASHTRA,2002,BURGLARY,0,0,0,57,0,57,42,0,42,15,0,15,114,0,114
MAHARASHTRA,2002,THEFTS,3,0,3,130,2,132,84,0,84,14,0,14,231,2,233
MAHARASHTRA,2002,EXTORTION,0,0,0,7,0,7,5,0,5,2,0,2,14,0,14
MAHARASHTRA,2002,RIOTS,0,0,0,19,0,19,10,0,10,5,0,5,34,0,34
MAHARASHTRA,2002,ARSON,0,0,0,6,0,6,1,0,1,0,0,0,7,0,7
MAHARASHTRA,2002,CRIMINAL BREACH OF TRUST,0,0,0,4,6,10,6,2,8,1,0,1,11,8,19
MAHARASHTRA,2002,CHEATING,0,0,0,5,2,7,8,1,9,0,0,0,13,3,16
MAHARASHTRA,2002,COUNTER FEITING,0,0,0,4,0,4,6,1,7,0,0,0,10,1,11
MAHARASHTRA,2002,DOWRY DEATHS,0,0,0,6,0,6,20,0,20,6,0,6,32,0,32
MAHARASHTRA,2002,MOLESTATION,0,0,0,4,0,4,2,0,2,0,0,0,6,0,6
MAHARASHTRA,2002,EVE-TEASING,0,0,0,0,0,0,1,0,1,0,0,0,1,0,1
MAHARASHTRA,2002,CRUELTY BY HUSBAND OR RELATIVE OF HUSBAND,0,0,0,14,0,14,37,4,41,10,1,11,61,5,66
MAHARASHTRA,2002,OTHER IPC CRIMES,0,0,0,198,23,221,123,8,131,33,2,35,354,33,387
MAHARASHTRA,2002,TOTAL IPC,3,0,3,2072,80,2152,2780,102,2882,603,40,643,5458,222,5680
MAHARASHTRA,2003,MURDER,0,0,0,1289,65,1354,2011,72,2083,777,14,791,4077,151,4228
MAHARASHTRA,2003,ATTEMPT TO COMMIT MURDER,0,0,0,82,4,86,109,3,112,57,1,58,248,8,256
MAHARASHTRA,2003,C.H. NOT AMOUNTING TO MURDER,0,0,0,43,1,44,62,3,65,35,3,38,140,7,147
MAHARASHTRA,2003,RAPE,0,0,0,173,0,173,125,2,127,46,0,46,344,2,346
MAHARASHTRA,2003,KIDNAPPING AND ABDUCTION,0,0,0,23,2,25,19,1,20,5,0,5,47,3,50
MAHARASHTRA,2003,DACOITY,0,0,0,82,0,82,73,0,73,23,0,23,178,0,178
MAHARASHTRA,2003,PREP. AND ASSEMBLY FOR DACOITY,0,0,0,40,0,40,37,0,37,6,0,6,83,0,83
MAHARASHTRA,2003,ROBBERY,0,0,0,63,0,63,71,0,71,34,0,34,168,0,168
MAHARASHTRA,2003,BURGLARY,0,0,0,87,1,88,76,0,76,17,0,17,180,1,181
MAHARASHTRA,2003,THEFTS,0,0,0,206,12,218,155,6,161,33,1,34,394,19,413
MAHARASHTRA,2003,EXTORTION,0,0,0,0,0,0,2,0,2,0,0,0,2,0,2
MAHARASHTRA,2003,RIOTS,0,0,0,1,0,1,3,0,3,0,0,0,4,0,4
MAHARASHTRA,2003,ARSON,0,0,0,8,0,8,10,0,10,0,0,0,18,0,18
MAHARASHTRA,2003,CRIMINAL BREACH OF TRUST,0,0,0,1,0,1,3,0,3,4,0,4,8,0,8
MAHARASHTRA,2003,CHEATING,0,0,0,22,4,26,18,3,21,2,1,3,42,8,50
MAHARASHTRA,2003,COUNTER FEITING,0,0,0,0,0,0,0,0,0,0,0,0,0,0,0
MAHARASHTRA,2003,DOWRY DEATHS,0,0,0,12,5,17,10,3,13,1,0,1,23,8,31
MAHARASHTRA,2003,MOLESTATION,0,0,0,6,0,6,4,0,4,1,0,1,11,0,11
MAHARASHTRA,2003,EVE-TEASING,0,0,0,4,0,4,4,0,4,0,0,0,8,0,8
MAHARASHTRA,2003,CRUELTY BY HUSBAND OR RELATIVE OF HUSBAND,0,0,0,36,3,39,48,1,49,5,0,5,89,4,93
MAHARASHTRA,2003,OTHER IPC CRIMES,0,0,0,109,12,121,114,10,124,45,2,47,268,24,292
MAHARASHTRA,2003,TOTAL IPC,0,0,0,2287,109,2396,2954,104,3058,1091,22,1113,6332,235,6567
MAHARASHTRA,2004,MURDER,0,0,0,1143,28,1171,2395,42,2437,719,28,747,4257,98,4355
MAHARASHTRA,2004,ATTEMPT TO COMMIT MURDER,0,0,0,77,8,85,113,27,140,53,5,58,243,40,283
MAHARASHTRA,2004,C.H. NOT AMOUNTING TO MURDER,0,0,0,51,1,52,89,13,102,49,1,50,189,15,204
MAHARASHTRA,2004,RAPE,0,0,0,101,0,101,80,2,82,26,0,26,207,2,209
MAHARASHTRA,2004,KIDNAPPING AND ABDUCTION,0,0,0,18,0,18,19,2,21,0,0,0,37,2,39
MAHARASHTRA,2004,DACOITY,0,0,0,60,1,61,79,0,79,15,0,15,154,1,155
MAHARASHTRA,2004,PREP. AND ASSEMBLY FOR DACOITY,0,0,0,17,0,17,28,0,28,2,0,2,47,0,47
MAHARASHTRA,2004,ROBBERY,0,0,0,61,0,61,61,0,61,6,0,6,128,0,128
MAHARASHTRA,2004,BURGLARY,0,0,0,69,1,70,61,0,61,21,0,21,151,1,152
MAHARASHTRA,2004,THEFTS,0,0,0,200,14,214,150,10,160,54,1,55,404,25,429
MAHARASHTRA,2004,EXTORTION,0,0,0,7,0,7,8,0,8,0,0,0,15,0,15
MAHARASHTRA,2004,RIOTS,0,0,0,4,0,4,7,0,7,0,0,0,11,0,11
MAHARASHTRA,2004,ARSON,0,0,0,5,0,5,8,0,8,2,0,2,15,0,15
MAHARASHTRA,2004,CRIMINAL BREACH OF TRUST,0,0,0,3,0,3,12,0,12,6,0,6,21,0,21
MAHARASHTRA,2004,CHEATING,0,0,0,21,2,23,30,2,32,3,0,3,54,4,58
MAHARASHTRA,2004,COUNTER FEITING,0,0,0,0,0,0,1,0,1,1,0,1,2,0,2
MAHARASHTRA,2004,DOWRY DEATHS,0,0,0,13,0,13,12,5,17,3,3,6,28,8,36
MAHARASHTRA,2004,MOLESTATION,0,0,0,10,0,10,21,0,21,7,0,7,38,0,38
MAHARASHTRA,2004,EVE-TEASING,0,0,0,10,0,10,2,0,2,0,0,0,12,0,12
MAHARASHTRA,2004,CRUELTY BY HUSBAND OR RELATIVE OF HUSBAND,0,0,0,41,0,41,31,7,38,32,0,32,104,7,111
MAHARASHTRA,2004,OTHER IPC CRIMES,0,0,0,162,5,167,175,6,181,40,0,40,377,11,388
MAHARASHTRA,2004,TOTAL IPC,0,0,0,2073,60,2133,3382,116,3498,1039,38,1077,6494,214,6708
MAHARASHTRA,2005,MURDER,0,0,0,1333,36,1369,2488,122,2610,813,78,891,4634,236,4870
MAHARASHTRA,2005,ATTEMPT TO COMMIT MURDER,0,0,0,149,3,152,137,7,144,109,2,111,395,12,407
MAHARASHTRA,2005,C.H. NOT AMOUNTING TO MURDER,0,0,0,74,1,75,100,6,106,40,0,40,214,7,221
MAHARASHTRA,2005,RAPE,0,0,0,122,0,122,89,0,89,13,0,13,224,0,224
MAHARASHTRA,2005,KIDNAPPING AND ABDUCTION,0,0,0,29,1,30,43,3,46,7,1,8,79,5,84
MAHARASHTRA,2005,DACOITY,0,0,0,59,1,60,98,1,99,19,0,19,176,2,178
MAHARASHTRA,2005,PREP. AND ASSEMBLY FOR DACOITY,0,0,0,47,0,47,56,0,56,6,0,6,109,0,109
MAHARASHTRA,2005,ROBBERY,0,0,0,70,0,70,68,2,70,8,0,8,146,2,148
MAHARASHTRA,2005,BURGLARY,0,0,0,74,1,75,77,1,78,22,0,22,173,2,175
MAHARASHTRA,2005,THEFTS,0,0,0,184,5,189,133,17,150,38,8,46,355,30,385
MAHARASHTRA,2005,EXTORTION,0,0,0,0,0,0,4,0,4,0,0,0,4,0,4
MAHARASHTRA,2005,RIOTS,0,0,0,4,0,4,15,0,15,0,0,0,19,0,19
MAHARASHTRA,2005,ARSON,0,0,0,10,0,10,3,0,3,0,0,0,13,0,13
MAHARASHTRA,2005,CRIMINAL BREACH OF TRUST,0,0,0,8,0,8,7,0,7,1,0,1,16,0,16
MAHARASHTRA,2005,CHEATING,0,0,0,48,2,50,40,5,45,10,2,12,98,9,107
MAHARASHTRA,2005,COUNTER FEITING,0,0,0,4,0,4,1,0,1,0,0,0,5,0,5
MAHARASHTRA,2005,DOWRY DEATHS,0,0,0,28,0,28,85,0,85,21,2,23,134,2,136
MAHARASHTRA,2005,MOLESTATION,0,0,0,17,0,17,17,0,17,2,0,2,36,0,36
MAHARASHTRA,2005,EVE-TEASING,0,0,0,6,0,6,1,0,1,0,0,0,7,0,7
MAHARASHTRA,2005,CRUELTY BY HUSBAND OR RELATIVE OF HUSBAND,0,0,0,64,4,68,73,7,80,32,5,37,169,16,185
MAHARASHTRA,2005,OTHER IPC CRIMES,0,0,0,161,6,167,141,2,143,39,1,40,341,9,350
MAHARASHTRA,2005,TOTAL IPC,0,0,0,2491,60,2551,3676,173,3849,1180,99,1279,7347,332,7679
MAHARASHTRA,2006,MURDER,0,0,0,1441,25,1466,2676,181,2857,718,72,790,4835,278,5113
MAHARASHTRA,2006,ATTEMPT TO COMMIT MURDER,0,0,0,135,12,147,205,7,212,58,4,62,398,23,421
MAHARASHTRA,2006,C.H. NOT AMOUNTING TO MURDER,0,0,0,65,1,66,136,4,140,26,3,29,227,8,235
MAHARASHTRA,2006,RAPE,0,0,0,109,0,109,91,0,91,16,0,16,216,0,216
MAHARASHTRA,2006,KIDNAPPING AND ABDUCTION,0,0,0,36,0,36,20,0,20,2,0,2,58,0,58
MAHARASHTRA,2006,DACOITY,0,0,0,95,0,95,95,0,95,8,0,8,198,0,198
MAHARASHTRA,2006,PREP. AND ASSEMBLY FOR DACOITY,0,0,0,32,0,32,25,0,25,7,0,7,64,0,64
MAHARASHTRA,2006,ROBBERY,0,0,0,79,3,82,65,6,71,12,4,16,156,13,169
MAHARASHTRA,2006,BURGLARY,0,0,0,62,6,68,60,5,65,25,5,30,147,16,163
MAHARASHTRA,2006,THEFTS,0,0,0,229,6,235,233,8,241,43,0,43,505,14,519
MAHARASHTRA,2006,EXTORTION,0,0,0,22,0,22,14,0,14,10,0,10,46,0,46
MAHARASHTRA,2006,RIOTS,0,0,0,21,0,21,20,0,20,1,0,1,42,0,42
MAHARASHTRA,2006,ARSON,0,0,0,15,0,15,11,0,11,4,0,4,30,0,30
MAHARASHTRA,2006,CRIMINAL BREACH OF TRUST,0,0,0,2,0,2,16,0,16,3,0,3,21,0,21
MAHARASHTRA,2006,CHEATING,0,0,0,29,1,30,29,4,33,4,1,5,62,6,68
MAHARASHTRA,2006,COUNTER FEITING,0,0,0,9,0,9,13,1,14,0,0,0,22,1,23
MAHARASHTRA,2006,DOWRY DEATHS,0,0,0,50,0,50,76,0,76,51,0,51,177,0,177
MAHARASHTRA,2006,MOLESTATION,0,0,0,11,0,11,7,0,7,0,0,0,18,0,18
MAHARASHTRA,2006,EVE-TEASING,0,0,0,12,0,12,3,0,3,0,0,0,15,0,15
MAHARASHTRA,2006,CRUELTY BY HUSBAND OR RELATIVE OF HUSBAND,0,0,0,60,2,62,70,1,71,11,0,11,141,3,144
MAHARASHTRA,2006,OTHER IPC CRIMES,0,0,0,171,6,177,181,2,183,20,0,20,372,8,380
MAHARASHTRA,2006,TOTAL IPC,0,0,0,2685,62,2747,4046,219,4265,1019,89,1108,7750,370,8120
MAHARASHTRA,2007,MURDER,0,0,0,1461,44,1505,2989,198,3187,739,39,778,5189,281,5470
MAHARASHTRA,2007,ATTEMPT TO COMMIT MURDER,0,0,0,172,6,178,143,3,146,61,1,62,376,10,386
MAHARASHTRA,2007,C.H. NOT AMOUNTING TO MURDER,0,0,0,29,0,29,61,5,66,33,0,33,123,5,128
MAHARASHTRA,2007,RAPE,0,0,0,101,0,101,106,1,107,33,0,33,240,1,241
MAHARASHTRA,2007,KIDNAPPING AND ABDUCTION,0,0,0,37,0,37,35,0,35,3,2,5,75,2,77
MAHARASHTRA,2007,DACOITY,0,0,0,85,2,87,90,1,91,11,0,11,186,3,189
MAHARASHTRA,2007,PREP. AND ASSEMBLY FOR DACOITY,0,0,0,27,0,27,42,1,43,4,0,4,73,1,74
MAHARASHTRA,2007,ROBBERY,0,0,0,99,7,106,92,4,96,24,2,26,215,13,228
MAHARASHTRA,2007,BURGLARY,0,0,0,65,0,65,58,0,58,15,0,15,138,0,138
MAHARASHTRA,2007,THEFTS,0,0,0,140,12,152,113,10,123,35,2,37,288,24,312
MAHARASHTRA,2007,EXTORTION,0,0,0,11,2,13,18,4,22,6,1,7,35,7,42
MAHARASHTRA,2007,RIOTS,0,0,0,12,0,12,6,0,6,0,0,0,18,0,18
MAHARASHTRA,2007,ARSON,0,0,0,13,0,13,5,0,5,4,0,4,22,0,22
MAHARASHTRA,2007,CRIMINAL BREACH OF TRUST,0,0,0,2,0,2,3,0,3,1,0,1,6,0,6
MAHARASHTRA,2007,CHEATING,0,0,0,16,0,16,23,0,23,10,0,10,49,0,49
MAHARASHTRA,2007,COUNTER FEITING,0,0,0,4,0,4,5,0,5,3,0,3,12,0,12
MAHARASHTRA,2007,DOWRY DEATHS,0,0,0,32,0,32,51,1,52,30,2,32,113,3,116
MAHARASHTRA,2007,MOLESTATION,0,0,0,6,0,6,6,0,6,0,0,0,12,0,12
MAHARASHTRA,2007,EVE-TEASING,0,0,0,7,0,7,6,0,6,0,0,0,13,0,13
MAHARASHTRA,2007,CRUELTY BY HUSBAND OR RELATIVE OF HUSBAND,0,0,0,47,3,50,35,3,38,13,1,14,95,7,102
MAHARASHTRA,2007,OTHER IPC CRIMES,0,0,0,159,23,182,133,12,145,40,5,45,332,40,372
MAHARASHTRA,2007,TOTAL IPC,0,0,0,2525,99,2624,4020,243,4263,1065,55,1120,7610,397,8007
MAHARASHTRA,2008,MURDER,0,0,0,1316,51,1367,3014,198,3212,831,37,868,5161,286,5447
MAHARASHTRA,2008,ATTEMPT TO COMMIT MURDER,0,0,0,128,5,133,151,4,155,54,1,55,333,10,343
MAHARASHTRA,2008,C.H. NOT AMOUNTING TO MURDER,0,0,0,27,3,30,57,6,63,20,3,23,104,12,116
MAHARASHTRA,2008,RAPE,0,0,0,123,1,124,109,1,110,17,0,17,249,2,251
MAHARASHTRA,2008,KIDNAPPING AND ABDUCTION,0,0,0,32,0,32,31,1,32,8,1,9,71,2,73
MAHARASHTRA,2008,DACOITY,0,0,0,70,2,72,82,5,87,29,2,31,181,9,190
MAHARASHTRA,2008,PREP. AND ASSEMBLY FOR DACOITY,0,0,0,20,0,20,31,0,31,7,0,7,58,0,58
MAHARASHTRA,2008,ROBBERY,0,0,0,59,1,60,68,0,68,20,0,20,147,1,148
MAHARASHTRA,2008,BURGLARY,0,0,0,83,3,86,129,3,132,23,5,28,235,11,246
MAHARASHTRA,2008,THEFTS,0,0,0,116,2,118,145,0,145,28,0,28,289,2,291
MAHARASHTRA,2008,EXTORTION,0,0,0,7,0,7,3,0,3,1,0,1,11,0,11
MAHARASHTRA,2008,RIOTS,0,0,0,8,0,8,7,0,7,10,0,10,25,0,25
MAHARASHTRA,2008,ARSON,0,0,0,11,0,11,20,0,20,6,0,6,37,0,37
MAHARASHTRA,2008,CRIMINAL BREACH OF TRUST,0,0,0,2,0,2,6,0,6,2,0,2,10,0,10
MAHARASHTRA,2008,CHEATING,0,0,0,9,0,9,21,1,22,7,1,8,37,2,39
MAHARASHTRA,2008,COUNTER FEITING,0,0,0,13,0,13,7,0,7,5,0,5,25,0,25
MAHARASHTRA,2008,DOWRY DEATHS,0,0,0,19,0,19,31,0,31,31,3,34,81,3,84
MAHARASHTRA,2008,MOLESTATION,0,0,0,8,0,8,10,0,10,0,0,0,18,0,18
MAHARASHTRA,2008,EVE-TEASING,0,0,0,15,0,15,12,0,12,10,0,10,37,0,37
MAHARASHTRA,2008,CRUELTY BY HUSBAND OR RELATIVE OF HUSBAND,0,0,0,47,0,47,64,1,65,47,4,51,158,5,163
MAHARASHTRA,2008,OTHER IPC CRIMES,0,0,0,96,14,110,173,8,181,76,1,77,345,23,368
MAHARASHTRA,2008,TOTAL IPC,0,0,0,2209,82,2291,4171,228,4399,1232,58,1290,7612,368,7980
MAHARASHTRA,2009,MURDER,0,0,0,1556,52,1608,2532,181,2713,771,38,809,4859,271,5130
MAHARASHTRA,2009,ATTEMPT TO COMMIT MURDER,0,0,0,104,2,106,203,8,211,65,1,66,372,11,383
MAHARASHTRA,2009,C.H. NOT AMOUNTING TO MURDER,0,0,0,56,1,57,82,4,86,53,4,57,191,9,200
MAHARASHTRA,2009,RAPE,0,0,0,128,0,128,136,2,138,35,0,35,299,2,301
MAHARASHTRA,2009,KIDNAPPING AND ABDUCTION,0,0,0,28,0,28,23,7,30,10,0,10,61,7,68
MAHARASHTRA,2009,DACOITY,0,0,0,38,0,38,59,0,59,20,0,20,117,0,117
MAHARASHTRA,2009,PREP. AND ASSEMBLY FOR DACOITY,0,0,0,45,0,45,148,0,148,20,0,20,213,0,213
MAHARASHTRA,2009,ROBBERY,0,0,0,53,0,53,109,2,111,13,0,13,175,2,177
MAHARASHTRA,2009,BURGLARY,0,0,0,47,0,47,55,2,57,16,0,16,118,2,120
MAHARASHTRA,2009,THEFTS,0,0,0,128,1,129,135,8,143,42,0,42,305,9,314
MAHARASHTRA,2009,EXTORTION,0,0,0,10,0,10,10,0,10,3,0,3,23,0,23
MAHARASHTRA,2009,RIOTS,0,0,0,10,0,10,2,0,2,0,0,0,12,0,12
MAHARASHTRA,2009,ARSON,0,0,0,0,0,0,0,0,0,0,0,0,0,0,0
MAHARASHTRA,2009,CRIMINAL BREACH OF TRUST,0,0,0,0,0,0,2,0,2,0,0,0,2,0,2
MAHARASHTRA,2009,CHEATING,0,0,0,16,0,16,24,2,26,10,0,10,50,2,52
MAHARASHTRA,2009,COUNTER FEITING,0,0,0,1,0,1,3,0,3,1,0,1,5,0,5
MAHARASHTRA,2009,DOWRY DEATHS,0,0,0,8,2,10,29,1,30,15,0,15,52,3,55
MAHARASHTRA,2009,MOLESTATION,0,0,0,4,0,4,5,0,5,0,0,0,9,0,9
MAHARASHTRA,2009,EVE-TEASING,0,0,0,1,0,1,1,0,1,0,0,0,2,0,2
MAHARASHTRA,2009,CRUELTY BY HUSBAND OR RELATIVE OF HUSBAND,0,0,0,50,0,50,57,5,62,27,1,28,134,6,140
MAHARASHTRA,2009,OTHER IPC CRIMES,0,0,0,100,0,100,115,5,120,12,1,13,227,6,233
MAHARASHTRA,2009,TOTAL IPC,0,0,0,2383,58,2441,3730,227,3957,1113,45,1158,7226,330,7556
MAHARASHTRA,2010,MURDER,0,0,0,1602,59,1661,2945,189,3134,811,48,859,5358,296,5654
MAHARASHTRA,2010,ATTEMPT TO COMMIT MURDER,0,0,0,80,5,85,82,3,85,56,0,56,218,8,226
MAHARASHTRA,2010,C.H. NOT AMOUNTING TO MURDER,0,0,0,69,2,71,82,5,87,26,0,26,177,7,184
MAHARASHTRA,2010,RAPE,0,0,0,58,2,60,71,2,73,14,1,15,143,5,148
MAHARASHTRA,2010,KIDNAPPING AND ABDUCTION,0,0,0,36,1,37,20,3,23,5,0,5,61,4,65
MAHARASHTRA,2010,DACOITY,0,0,0,32,0,32,56,0,56,12,0,12,100,0,100
MAHARASHTRA,2010,PREP. AND ASSEMBLY FOR DACOITY,0,0,0,58,0,58,70,0,70,21,0,21,149,0,149
MAHARASHTRA,2010,ROBBERY,0,0,0,32,1,33,49,2,51,10,1,11,91,4,95
MAHARASHTRA,2010,BURGLARY,0,0,0,53,0,53,43,0,43,14,0,14,110,0,110
MAHARASHTRA,2010,THEFTS,0,0,0,49,3,52,124,7,131,5,2,7,178,12,190
MAHARASHTRA,2010,EXTORTION,0,0,0,13,0,13,4,0,4,0,0,0,17,0,17
MAHARASHTRA,2010,RIOTS,0,0,0,4,0,4,7,0,7,1,0,1,12,0,12
MAHARASHTRA,2010,ARSON,0,0,0,3,0,3,6,0,6,0,0,0,9,0,9
MAHARASHTRA,2010,CRIMINAL BREACH OF TRUST,0,0,0,0,0,0,0,0,0,1,0,1,1,0,1
MAHARASHTRA,2010,CHEATING,0,0,0,3,0,3,33,2,35,3,0,3,39,2,41
MAHARASHTRA,2010,COUNTER FEITING,0,0,0,2,6,8,2,7,9,0,16,16,4,29,33
MAHARASHTRA,2010,DOWRY DEATHS,0,0,0,20,0,20,19,1,20,5,0,5,44,1,45
MAHARASHTRA,2010,MOLESTATION,0,0,0,1,0,1,6,0,6,1,0,1,8,0,8
MAHARASHTRA,2010,EVE-TEASING,0,0,0,1,0,1,1,0,1,1,0,1,3,0,3
MAHARASHTRA,2010,CRUELTY BY HUSBAND OR RELATIVE OF HUSBAND,0,0,0,16,6,22,87,22,109,17,2,19,120,30,150
MAHARASHTRA,2010,OTHER IPC CRIMES,0,0,0,105,5,110,119,5,124,31,4,35,255,14,269
MAHARASHTRA,2010,TOTAL IPC,0,0,0,2237,90,2327,3826,248,4074,1034,74,1108,7097,412,7509
MAHARASHTRA,2011,MURDER,0,0,0,1989,38,2027,2125,176,2301,724,56,780,4838,270,5108
MAHARASHTRA,2011,ATTEMPT TO COMMIT MURDER,0,0,0,228,20,248,128,5,133,47,0,47,403,25,428
MAHARASHTRA,2011,C.H. NOT AMOUNTING TO MURDER,0,0,0,80,6,86,82,2,84,11,0,11,173,8,181
MAHARASHTRA,2011,RAPE,0,0,0,122,2,124,77,1,78,10,0,10,209,3,212
MAHARASHTRA,2011,KIDNAPPING AND ABDUCTION,0,0,0,61,2,63,43,2,45,5,0,5,109,4,113
MAHARASHTRA,2011,DACOITY,0,0,0,40,0,40,45,0,45,27,0,27,112,0,112
MAHARASHTRA,2011,PREP. AND ASSEMBLY FOR DACOITY,0,0,0,17,0,17,24,0,24,11,0,11,52,0,52
MAHARASHTRA,2011,ROBBERY,0,0,0,53,1,54,61,3,64,2,0,2,116,4,120
MAHARASHTRA,2011,BURGLARY,0,0,0,34,0,34,18,0,18,10,0,10,62,0,62
MAHARASHTRA,2011,THEFTS,0,0,0,75,4,79,71,5,76,28,0,28,174,9,183
MAHARASHTRA,2011,EXTORTION,0,0,0,7,0,7,8,0,8,3,0,3,18,0,18
MAHARASHTRA,2011,RIOTS,0,0,0,4,0,4,4,0,4,0,0,0,8,0,8
MAHARASHTRA,2011,ARSON,0,0,0,2,0,2,4,0,4,0,0,0,6,0,6
MAHARASHTRA,2011,CRIMINAL BREACH OF TRUST,0,0,0,1,0,1,1,0,1,0,0,0,2,0,2
MAHARASHTRA,2011,CHEATING,0,0,0,16,1,17,62,2,64,3,0,3,81,3,84
MAHARASHTRA,2011,COUNTER FEITING,0,0,0,0,0,0,7,1,8,0,0,0,7,1,8
MAHARASHTRA,2011,DOWRY DEATHS,0,0,0,12,4,16,20,6,26,2,0,2,34,10,44
MAHARASHTRA,2011,MOLESTATION,0,0,0,1,0,1,0,0,0,0,0,0,1,0,1
MAHARASHTRA,2011,EVE-TEASING,0,0,0,1,0,1,3,0,3,0,0,0,4,0,4
MAHARASHTRA,2011,CRUELTY BY HUSBAND OR RELATIVE OF HUSBAND,0,0,0,12,3,15,38,3,41,9,2,11,59,8,67
MAHARASHTRA,2011,OTHER IPC CRIMES,0,0,0,99,4,103,169,20,189,48,6,54,316,30,346
MAHARASHTRA,2011,TOTAL IPC,0,0,0,2854,85,2939,2990,226,3216,940,64,1004,6784,375,7159
MAHARASHTRA,2012,MURDER,0,0,0,1822,66,1888,1932,111,2043,717,52,769,4471,229,4700
MAHARASHTRA,2012,ATTEMPT TO COMMIT MURDER,0,0,0,148,3,151,107,24,131,111,1,112,366,28,394
MAHARASHTRA,2012,C.H. NOT AMOUNTING TO MURDER,0,0,0,74,1,75,110,7,117,12,0,12,196,8,204
MAHARASHTRA,2012,RAPE,0,0,0,86,4,90,76,3,79,25,0,25,187,7,194
MAHARASHTRA,2012,KIDNAPPING AND ABDUCTION,0,0,0,47,3,50,56,4,60,2,0,2,105,7,112
MAHARASHTRA,2012,DACOITY,0,0,0,69,3,72,36,4,40,12,0,12,117,7,124
MAHARASHTRA,2012,PREP. AND ASSEMBLY FOR DACOITY,0,0,0,52,0,52,43,1,44,17,0,17,112,1,113
MAHARASHTRA,2012,ROBBERY,0,0,0,64,3,67,37,2,39,19,0,19,120,5,125
MAHARASHTRA,2012,BURGLARY,0,0,0,49,0,49,52,0,52,11,0,11,112,0,112
MAHARASHTRA,2012,THEFTS,0,0,0,87,6,93,98,11,109,38,0,38,223,17,240
MAHARASHTRA,2012,EXTORTION,0,0,0,9,0,9,10,1,11,4,0,4,23,1,24
MAHARASHTRA,2012,RIOTS,0,0,0,1,0,1,0,0,0,0,0,0,1,0,1
MAHARASHTRA,2012,ARSON,0,0,0,8,0,8,13,0,13,4,0,4,25,0,25
MAHARASHTRA,2012,CRIMINAL BREACH OF TRUST,0,0,0,1,0,1,3,0,3,0,0,0,4,0,4
MAHARASHTRA,2012,CHEATING,0,0,0,19,2,21,32,3,35,6,0,6,57,5,62
MAHARASHTRA,2012,COUNTER FEITING,0,0,0,0,0,0,11,5,16,2,0,2,13,5,18
MAHARASHTRA,2012,DOWRY DEATHS,0,0,0,15,2,17,22,2,24,6,1,7,43,5,48
MAHARASHTRA,2012,MOLESTATION,0,0,0,7,0,7,12,19,31,1,3,4,20,22,42
MAHARASHTRA,2012,EVE-TEASING,0,0,0,3,0,3,8,0,8,3,0,3,14,0,14
MAHARASHTRA,2012,CRUELTY BY HUSBAND OR RELATIVE OF HUSBAND,0,0,0,14,3,17,34,4,38,13,0,13,61,7,68
MAHARASHTRA,2012,OTHER IPC CRIMES,0,0,0,163,12,175,212,21,233,75,3,78,450,36,486
MAHARASHTRA,2012,TOTAL IPC,0,0,0,2738,108,2846,2904,222,3126,1078,60,1138,6720,390,7110
MANIPUR,2001,MURDER,0,0,0,2,0,2,9,0,9,6,0,6,17,0,17
MANIPUR,2001,ATTEMPT TO COMMIT MURDER,0,0,0,0,0,0,0,0,0,0,0,0,0,0,0
MANIPUR,2001,C.H. NOT AMOUNTING TO MURDER,0,0,0,0,0,0,0,0,0,0,0,0,0,0,0
MANIPUR,2001,RAPE,0,0,0,0,0,0,0,0,0,0,0,0,0,0,0
MANIPUR,2001,KIDNAPPING AND ABDUCTION,0,0,0,0,0,0,0,0,0,0,0,0,0,0,0
MANIPUR,2001,DACOITY,0,0,0,0,0,0,0,0,0,0,0,0,0,0,0
MANIPUR,2001,PREP. AND ASSEMBLY FOR DACOITY,0,0,0,0,0,0,0,0,0,0,0,0,0,0,0
MANIPUR,2001,ROBBERY,0,0,0,0,0,0,0,0,0,0,0,0,0,0,0
MANIPUR,2001,BURGLARY,0,0,0,0,0,0,0,0,0,0,0,0,0,0,0
MANIPUR,2001,THEFTS,0,0,0,0,0,0,0,0,0,0,0,0,0,0,0
MANIPUR,2001,EXTORTION,0,0,0,0,0,0,0,0,0,0,0,0,0,0,0
MANIPUR,2001,RIOTS,0,0,0,0,0,0,0,0,0,0,0,0,0,0,0
MANIPUR,2001,ARSON,0,0,0,0,0,0,0,0,0,0,0,0,0,0,0
MANIPUR,2001,CRIMINAL BREACH OF TRUST,0,0,0,0,0,0,0,0,0,0,0,0,0,0,0
MANIPUR,2001,CHEATING,0,0,0,0,0,0,0,0,0,0,0,0,0,0,0
MANIPUR,2001,COUNTER FEITING,0,0,0,0,0,0,0,0,0,0,0,0,0,0,0
MANIPUR,2001,DOWRY DEATHS,0,0,0,0,0,0,0,0,0,0,0,0,0,0,0
MANIPUR,2001,MOLESTATION,0,0,0,0,0,0,0,0,0,0,0,0,0,0,0
MANIPUR,2001,EVE-TEASING,0,0,0,0,0,0,0,0,0,0,0,0,0,0,0
MANIPUR,2001,CRUELTY BY HUSBAND OR RELATIVE OF HUSBAND,0,0,0,0,0,0,0,0,0,0,0,0,0,0,0
MANIPUR,2001,OTHER IPC CRIMES,0,0,0,0,0,0,0,0,0,0,0,0,0,0,0
MANIPUR,2001,TOTAL IPC,0,0,0,2,0,2,9,0,9,6,0,6,17,0,17
MANIPUR,2002,MURDER,0,0,0,6,0,6,11,0,11,8,0,8,25,0,25
MANIPUR,2002,ATTEMPT TO COMMIT MURDER,0,0,0,0,0,0,0,0,0,0,0,0,0,0,0
MANIPUR,2002,C.H. NOT AMOUNTING TO MURDER,0,0,0,0,0,0,1,0,1,0,0,0,1,0,1
MANIPUR,2002,RAPE,0,0,0,0,0,0,2,0,2,0,0,0,2,0,2
MANIPUR,2002,KIDNAPPING AND ABDUCTION,0,0,0,0,0,0,0,0,0,0,0,0,0,0,0
MANIPUR,2002,DACOITY,0,0,0,0,0,0,0,0,0,0,0,0,0,0,0
MANIPUR,2002,PREP. AND ASSEMBLY FOR DACOITY,0,0,0,0,0,0,0,0,0,0,0,0,0,0,0
MANIPUR,2002,ROBBERY,0,0,0,0,0,0,0,0,0,0,0,0,0,0,0
MANIPUR,2002,BURGLARY,0,0,0,0,0,0,0,0,0,0,0,0,0,0,0
MANIPUR,2002,THEFTS,0,0,0,0,0,0,1,0,1,0,0,0,1,0,1
MANIPUR,2002,EXTORTION,0,0,0,0,0,0,0,0,0,0,0,0,0,0,0
MANIPUR,2002,RIOTS,0,0,0,0,0,0,0,0,0,0,0,0,0,0,0
MANIPUR,2002,ARSON,0,0,0,0,0,0,0,0,0,0,0,0,0,0,0
MANIPUR,2002,CRIMINAL BREACH OF TRUST,0,0,0,0,0,0,1,0,1,0,0,0,1,0,1
MANIPUR,2002,CHEATING,0,0,0,0,0,0,0,0,0,0,0,0,0,0,0
MANIPUR,2002,COUNTER FEITING,0,0,0,0,0,0,0,0,0,0,0,0,0,0,0
MANIPUR,2002,DOWRY DEATHS,0,0,0,0,0,0,0,0,0,0,0,0,0,0,0
MANIPUR,2002,MOLESTATION,0,0,0,0,0,0,0,0,0,0,0,0,0,0,0
MANIPUR,2002,EVE-TEASING,0,0,0,0,0,0,0,0,0,0,0,0,0,0,0
MANIPUR,2002,CRUELTY BY HUSBAND OR RELATIVE OF HUSBAND,0,0,0,0,0,0,0,0,0,0,0,0,0,0,0
MANIPUR,2002,OTHER IPC CRIMES,0,0,0,0,0,0,0,0,0,0,0,0,0,0,0
MANIPUR,2002,TOTAL IPC,0,0,0,6,0,6,16,0,16,8,0,8,30,0,30
MANIPUR,2003,MURDER,0,0,0,4,0,4,13,0,13,10,0,10,27,0,27
MANIPUR,2003,ATTEMPT TO COMMIT MURDER,0,0,0,0,0,0,0,0,0,0,0,0,0,0,0
MANIPUR,2003,C.H. NOT AMOUNTING TO MURDER,0,0,0,0,0,0,2,0,2,0,0,0,2,0,2
MANIPUR,2003,RAPE,0,0,0,0,0,0,1,0,1,0,0,0,1,0,1
MANIPUR,2003,KIDNAPPING AND ABDUCTION,0,0,0,0,0,0,0,0,0,0,0,0,0,0,0
MANIPUR,2003,DACOITY,0,0,0,0,0,0,0,0,0,0,0,0,0,0,0
MANIPUR,2003,PREP. AND ASSEMBLY FOR DACOITY,0,0,0,0,0,0,0,0,0,0,0,0,0,0,0
MANIPUR,2003,ROBBERY,0,0,0,0,0,0,0,0,0,0,0,0,0,0,0
MANIPUR,2003,BURGLARY,0,0,0,0,0,0,0,0,0,0,0,0,0,0,0
MANIPUR,2003,THEFTS,0,0,0,0,0,0,1,0,1,0,0,0,1,0,1
MANIPUR,2003,EXTORTION,0,0,0,0,0,0,0,0,0,0,0,0,0,0,0
MANIPUR,2003,RIOTS,0,0,0,0,0,0,0,0,0,0,0,0,0,0,0
MANIPUR,2003,ARSON,0,0,0,0,0,0,0,0,0,0,0,0,0,0,0
MANIPUR,2003,CRIMINAL BREACH OF TRUST,0,0,0,0,0,0,0,0,0,0,0,0,0,0,0
MANIPUR,2003,CHEATING,0,0,0,0,0,0,0,0,0,0,0,0,0,0,0
MANIPUR,2003,COUNTER FEITING,0,0,0,0,0,0,0,0,0,0,0,0,0,0,0
MANIPUR,2003,DOWRY DEATHS,0,0,0,0,0,0,0,0,0,0,0,0,0,0,0
MANIPUR,2003,MOLESTATION,0,0,0,0,0,0,0,0,0,0,0,0,0,0,0
MANIPUR,2003,EVE-TEASING,0,0,0,0,0,0,0,0,0,0,0,0,0,0,0
MANIPUR,2003,CRUELTY BY HUSBAND OR RELATIVE OF HUSBAND,0,0,0,0,0,0,0,0,0,0,0,0,0,0,0
MANIPUR,2003,OTHER IPC CRIMES,0,0,0,0,0,0,0,0,0,0,0,0,0,0,0
MANIPUR,2003,TOTAL IPC,0,0,0,4,0,4,17,0,17,10,0,10,31,0,31
MANIPUR,2004,MURDER,0,0,0,0,0,0,15,0,15,7,0,7,22,0,22
MANIPUR,2004,ATTEMPT TO COMMIT MURDER,0,0,0,0,0,0,0,0,0,0,0,0,0,0,0
MANIPUR,2004,C.H. NOT AMOUNTING TO MURDER,0,0,0,0,0,0,4,0,4,2,0,2,6,0,6
MANIPUR,2004,RAPE,0,0,0,0,0,0,1,0,1,0,0,0,1,0,1
MANIPUR,2004,KIDNAPPING AND ABDUCTION,0,0,0,0,0,0,2,0,2,0,0,0,2,0,2
MANIPUR,2004,DACOITY,0,0,0,0,0,0,0,0,0,0,0,0,0,0,0
MANIPUR,2004,PREP. AND ASSEMBLY FOR DACOITY,0,0,0,0,0,0,0,0,0,0,0,0,0,0,0
MANIPUR,2004,ROBBERY,0,0,0,0,0,0,0,0,0,0,0,0,0,0,0
MANIPUR,2004,BURGLARY,0,0,0,0,0,0,0,0,0,0,0,0,0,0,0
MANIPUR,2004,THEFTS,0,0,0,0,0,0,0,0,0,0,0,0,0,0,0
MANIPUR,2004,EXTORTION,0,0,0,0,0,0,0,0,0,0,0,0,0,0,0
MANIPUR,2004,RIOTS,0,0,0,0,0,0,0,0,0,0,0,0,0,0,0
MANIPUR,2004,ARSON,0,0,0,0,0,0,0,0,0,0,0,0,0,0,0
MANIPUR,2004,CRIMINAL BREACH OF TRUST,0,0,0,0,0,0,0,0,0,0,0,0,0,0,0
MANIPUR,2004,CHEATING,0,0,0,0,0,0,0,0,0,0,0,0,0,0,0
MANIPUR,2004,COUNTER FEITING,0,0,0,0,0,0,0,0,0,0,0,0,0,0,0
MANIPUR,2004,DOWRY DEATHS,0,0,0,0,0,0,0,0,0,0,0,0,0,0,0
MANIPUR,2004,MOLESTATION,0,0,0,0,0,0,0,0,0,0,0,0,0,0,0
MANIPUR,2004,EVE-TEASING,0,0,0,0,0,0,0,0,0,0,0,0,0,0,0
MANIPUR,2004,CRUELTY BY HUSBAND OR RELATIVE OF HUSBAND,0,0,0,0,0,0,0,0,0,0,0,0,0,0,0
MANIPUR,2004,OTHER IPC CRIMES,0,0,0,0,0,0,0,0,0,0,0,0,0,0,0
MANIPUR,2004,TOTAL IPC,0,0,0,0,0,0,22,0,22,9,0,9,31,0,31
MANIPUR,2005,MURDER,0,0,0,0,0,0,10,0,10,11,0,11,21,0,21
MANIPUR,2005,ATTEMPT TO COMMIT MURDER,0,0,0,0,0,0,0,0,0,0,0,0,0,0,0
MANIPUR,2005,C.H. NOT AMOUNTING TO MURDER,0,0,0,0,0,0,1,0,1,2,0,2,3,0,3
MANIPUR,2005,RAPE,0,0,0,0,0,0,1,0,1,0,0,0,1,0,1
MANIPUR,2005,KIDNAPPING AND ABDUCTION,0,0,0,0,0,0,1,0,1,0,0,0,1,0,1
MANIPUR,2005,DACOITY,0,0,0,0,0,0,0,0,0,0,0,0,0,0,0
MANIPUR,2005,PREP. AND ASSEMBLY FOR DACOITY,0,0,0,0,0,0,0,0,0,0,0,0,0,0,0
MANIPUR,2005,ROBBERY,0,0,0,0,0,0,0,0,0,0,0,0,0,0,0
MANIPUR,2005,BURGLARY,0,0,0,0,0,0,0,0,0,0,0,0,0,0,0
MANIPUR,2005,THEFTS,0,0,0,0,0,0,0,0,0,0,0,0,0,0,0
MANIPUR,2005,EXTORTION,0,0,0,0,0,0,0,0,0,0,0,0,0,0,0
MANIPUR,2005,RIOTS,0,0,0,0,0,0,0,0,0,0,0,0,0,0,0
MANIPUR,2005,ARSON,0,0,0,0,0,0,0,0,0,0,0,0,0,0,0
MANIPUR,2005,CRIMINAL BREACH OF TRUST,0,0,0,0,0,0,0,0,0,0,0,0,0,0,0
MANIPUR,2005,CHEATING,0,0,0,0,0,0,0,0,0,0,0,0,0,0,0
MANIPUR,2005,COUNTER FEITING,0,0,0,0,0,0,0,0,0,0,0,0,0,0,0
MANIPUR,2005,DOWRY DEATHS,0,0,0,0,0,0,0,0,0,0,0,0,0,0,0
MANIPUR,2005,MOLESTATION,0,0,0,0,0,0,0,0,0,0,0,0,0,0,0
MANIPUR,2005,EVE-TEASING,0,0,0,0,0,0,0,0,0,0,0,0,0,0,0
MANIPUR,2005,CRUELTY BY HUSBAND OR RELATIVE OF HUSBAND,0,0,0,0,0,0,0,0,0,0,0,0,0,0,0
MANIPUR,2005,OTHER IPC CRIMES,0,0,0,0,0,0,0,0,0,0,0,0,0,0,0
MANIPUR,2005,TOTAL IPC,0,0,0,0,0,0,13,0,13,13,0,13,26,0,26
MANIPUR,2006,MURDER,0,0,0,0,0,0,11,0,11,12,0,12,23,0,23
MANIPUR,2006,ATTEMPT TO COMMIT MURDER,0,0,0,0,0,0,0,0,0,0,0,0,0,0,0
MANIPUR,2006,C.H. NOT AMOUNTING TO MURDER,0,0,0,0,0,0,3,0,3,2,0,2,5,0,5
MANIPUR,2006,RAPE,0,0,0,0,0,0,1,0,1,0,0,0,1,0,1
MANIPUR,2006,KIDNAPPING AND ABDUCTION,0,0,0,0,0,0,0,0,0,0,0,0,0,0,0
MANIPUR,2006,DACOITY,0,0,0,0,0,0,0,0,0,0,0,0,0,0,0
MANIPUR,2006,PREP. AND ASSEMBLY FOR DACOITY,0,0,0,0,0,0,0,0,0,0,0,0,0,0,0
MANIPUR,2006,ROBBERY,0,0,0,0,0,0,0,0,0,0,0,0,0,0,0
MANIPUR,2006,BURGLARY,0,0,0,0,0,0,0,0,0,0,0,0,0,0,0
MANIPUR,2006,THEFTS,0,0,0,0,0,0,0,0,0,0,0,0,0,0,0
MANIPUR,2006,EXTORTION,0,0,0,0,0,0,0,0,0,0,0,0,0,0,0
MANIPUR,2006,RIOTS,0,0,0,0,0,0,0,0,0,0,0,0,0,0,0
MANIPUR,2006,ARSON,0,0,0,0,0,0,0,0,0,0,0,0,0,0,0
MANIPUR,2006,CRIMINAL BREACH OF TRUST,0,0,0,0,0,0,0,0,0,0,0,0,0,0,0
MANIPUR,2006,CHEATING,0,0,0,0,0,0,0,0,0,0,0,0,0,0,0
MANIPUR,2006,COUNTER FEITING,0,0,0,0,0,0,0,0,0,0,0,0,0,0,0
MANIPUR,2006,DOWRY DEATHS,0,0,0,0,0,0,0,0,0,0,0,0,0,0,0
MANIPUR,2006,MOLESTATION,0,0,0,0,0,0,0,0,0,0,0,0,0,0,0
MANIPUR,2006,EVE-TEASING,0,0,0,0,0,0,0,0,0,0,0,0,0,0,0
MANIPUR,2006,CRUELTY BY HUSBAND OR RELATIVE OF HUSBAND,0,0,0,0,0,0,0,0,0,0,0,0,0,0,0
MANIPUR,2006,OTHER IPC CRIMES,0,0,0,0,0,0,0,0,0,0,0,0,0,0,0
MANIPUR,2006,TOTAL IPC,0,0,0,0,0,0,15,0,15,14,0,14,29,0,29
MANIPUR,2007,MURDER,0,0,0,0,0,0,10,0,10,13,0,13,23,0,23
MANIPUR,2007,ATTEMPT TO COMMIT MURDER,0,0,0,0,0,0,0,0,0,0,0,0,0,0,0
MANIPUR,2007,C.H. NOT AMOUNTING TO MURDER,0,0,0,0,0,0,2,0,2,3,0,3,5,0,5
MANIPUR,2007,RAPE,0,0,0,0,0,0,1,0,1,0,0,0,1,0,1
MANIPUR,2007,KIDNAPPING AND ABDUCTION,0,0,0,0,0,0,0,0,0,0,0,0,0,0,0
MANIPUR,2007,DACOITY,0,0,0,0,0,0,0,0,0,0,0,0,0,0,0
MANIPUR,2007,PREP. AND ASSEMBLY FOR DACOITY,0,0,0,0,0,0,0,0,0,0,0,0,0,0,0
MANIPUR,2007,ROBBERY,0,0,0,0,0,0,0,0,0,0,0,0,0,0,0
MANIPUR,2007,BURGLARY,0,0,0,0,0,0,0,0,0,0,0,0,0,0,0
MANIPUR,2007,THEFTS,0,0,0,0,0,0,0,0,0,0,0,0,0,0,0
MANIPUR,2007,EXTORTION,0,0,0,0,0,0,0,0,0,0,0,0,0,0,0
MANIPUR,2007,RIOTS,0,0,0,0,0,0,0,0,0,0,0,0,0,0,0
MANIPUR,2007,ARSON,0,0,0,0,0,0,0,0,0,0,0,0,0,0,0
MANIPUR,2007,CRIMINAL BREACH OF TRUST,0,0,0,0,0,0,0,0,0,0,0,0,0,0,0
MANIPUR,2007,CHEATING,0,0,0,0,0,0,0,0,0,0,0,0,0,0,0
MANIPUR,2007,COUNTER FEITING,0,0,0,0,0,0,0,0,0,0,0,0,0,0,0
MANIPUR,2007,DOWRY DEATHS,0,0,0,0,0,0,0,0,0,0,0,0,0,0,0
MANIPUR,2007,MOLESTATION,0,0,0,0,0,0,0,0,0,0,0,0,0,0,0
MANIPUR,2007,EVE-TEASING,0,0,0,0,0,0,0,0,0,0,0,0,0,0,0
MANIPUR,2007,CRUELTY BY HUSBAND OR RELATIVE OF HUSBAND,0,0,0,1,0,1,0,0,0,0,0,0,1,0,1
MANIPUR,2007,OTHER IPC CRIMES,0,0,0,0,0,0,0,0,0,0,0,0,0,0,0
MANIPUR,2007,TOTAL IPC,0,0,0,1,0,1,13,0,13,16,0,16,30,0,30
MANIPUR,2008,MURDER,0,0,0,0,0,0,12,0,12,12,0,12,24,0,24
MANIPUR,2008,ATTEMPT TO COMMIT MURDER,0,0,0,0,0,0,0,0,0,0,0,0,0,0,0
MANIPUR,2008,C.H. NOT AMOUNTING TO MURDER,0,0,0,0,0,0,1,0,1,2,0,2,3,0,3
MANIPUR,2008,RAPE,0,0,0,0,0,0,2,0,2,0,0,0,2,0,2
MANIPUR,2008,KIDNAPPING AND ABDUCTION,0,0,0,0,0,0,1,0,1,0,0,0,1,0,1
MANIPUR,2008,DACOITY,0,0,0,0,0,0,0,0,0,0,0,0,0,0,0
MANIPUR,2008,PREP. AND ASSEMBLY FOR DACOITY,0,0,0,0,0,0,0,0,0,0,0,0,0,0,0
MANIPUR,2008,ROBBERY,0,0,0,0,0,0,0,0,0,0,0,0,0,0,0
MANIPUR,2008,BURGLARY,0,0,0,0,0,0,0,0,0,0,0,0,0,0,0
MANIPUR,2008,THEFTS,0,0,0,0,0,0,0,0,0,0,0,0,0,0,0
MANIPUR,2008,EXTORTION,0,0,0,0,0,0,0,0,0,0,0,0,0,0,0
MANIPUR,2008,RIOTS,0,0,0,0,0,0,0,0,0,0,0,0,0,0,0
MANIPUR,2008,ARSON,0,0,0,0,0,0,0,0,0,0,0,0,0,0,0
MANIPUR,2008,CRIMINAL BREACH OF TRUST,0,0,0,0,0,0,0,0,0,0,0,0,0,0,0
MANIPUR,2008,CHEATING,0,0,0,0,0,0,0,0,0,0,0,0,0,0,0
MANIPUR,2008,COUNTER FEITING,0,0,0,0,0,0,0,0,0,0,0,0,0,0,0
MANIPUR,2008,DOWRY DEATHS,0,0,0,0,0,0,0,0,0,0,0,0,0,0,0
MANIPUR,2008,MOLESTATION,0,0,0,0,0,0,0,0,0,0,0,0,0,0,0
MANIPUR,2008,EVE-TEASING,0,0,0,0,0,0,0,0,0,0,0,0,0,0,0
MANIPUR,2008,CRUELTY BY HUSBAND OR RELATIVE OF HUSBAND,0,0,0,0,0,0,0,0,0,0,0,0,0,0,0
MANIPUR,2008,OTHER IPC CRIMES,0,0,0,0,0,0,1,0,1,0,0,0,1,0,1
MANIPUR,2008,TOTAL IPC,0,0,0,0,0,0,17,0,17,14,0,14,31,0,31
MANIPUR,2009,MURDER,0,0,0,0,0,0,12,0,12,11,0,11,23,0,23
MANIPUR,2009,ATTEMPT TO COMMIT MURDER,0,0,0,0,0,0,0,0,0,0,0,0,0,0,0
MANIPUR,2009,C.H. NOT AMOUNTING TO MURDER,0,0,0,0,0,0,3,0,3,2,0,2,5,0,5
MANIPUR,2009,RAPE,0,0,0,0,0,0,0,0,0,0,0,0,0,0,0
MANIPUR,2009,KIDNAPPING AND ABDUCTION,0,0,0,0,0,0,0,0,0,0,0,0,0,0,0
MANIPUR,2009,DACOITY,0,0,0,0,0,0,0,0,0,0,0,0,0,0,0
MANIPUR,2009,PREP. AND ASSEMBLY FOR DACOITY,0,0,0,0,0,0,0,0,0,0,0,0,0,0,0
MANIPUR,2009,ROBBERY,0,0,0,0,0,0,0,0,0,0,0,0,0,0,0
MANIPUR,2009,BURGLARY,0,0,0,0,0,0,0,0,0,0,0,0,0,0,0
MANIPUR,2009,THEFTS,0,0,0,0,0,0,0,0,0,0,0,0,0,0,0
MANIPUR,2009,EXTORTION,0,0,0,0,0,0,0,0,0,0,0,0,0,0,0
MANIPUR,2009,RIOTS,0,0,0,0,0,0,0,0,0,0,0,0,0,0,0
MANIPUR,2009,ARSON,0,0,0,0,0,0,0,0,0,0,0,0,0,0,0
MANIPUR,2009,CRIMINAL BREACH OF TRUST,0,0,0,0,0,0,0,0,0,0,0,0,0,0,0
MANIPUR,2009,CHEATING,0,0,0,0,0,0,0,0,0,0,0,0,0,0,0
MANIPUR,2009,COUNTER FEITING,0,0,0,0,0,0,0,0,0,0,0,0,0,0,0
MANIPUR,2009,DOWRY DEATHS,0,0,0,0,0,0,0,0,0,0,0,0,0,0,0
MANIPUR,2009,MOLESTATION,0,0,0,0,0,0,0,0,0,0,0,0,0,0,0
MANIPUR,2009,EVE-TEASING,0,0,0,0,0,0,0,0,0,0,0,0,0,0,0
MANIPUR,2009,CRUELTY BY HUSBAND OR RELATIVE OF HUSBAND,0,0,0,0,0,0,0,0,0,0,0,0,0,0,0
MANIPUR,2009,OTHER IPC CRIMES,0,0,0,0,0,0,0,0,0,0,0,0,0,0,0
MANIPUR,2009,TOTAL IPC,0,0,0,0,0,0,15,0,15,13,0,13,28,0,28
MANIPUR,2010,MURDER,0,0,0,0,0,0,8,1,9,15,0,15,23,1,24
MANIPUR,2010,ATTEMPT TO COMMIT MURDER,0,0,0,0,0,0,0,0,0,0,0,0,0,0,0
MANIPUR,2010,C.H. NOT AMOUNTING TO MURDER,0,0,0,0,0,0,2,0,2,2,0,2,4,0,4
MANIPUR,2010,RAPE,0,0,0,0,0,0,0,0,0,0,0,0,0,0,0
MANIPUR,2010,KIDNAPPING AND ABDUCTION,0,0,0,0,0,0,0,0,0,0,0,0,0,0,0
MANIPUR,2010,DACOITY,0,0,0,0,0,0,0,0,0,0,0,0,0,0,0
MANIPUR,2010,PREP. AND ASSEMBLY FOR DACOITY,0,0,0,0,0,0,0,0,0,0,0,0,0,0,0
MANIPUR,2010,ROBBERY,0,0,0,0,0,0,0,0,0,0,0,0,0,0,0
MANIPUR,2010,BURGLARY,0,0,0,0,0,0,0,0,0,0,0,0,0,0,0
MANIPUR,2010,THEFTS,0,0,0,0,0,0,0,0,0,0,0,0,0,0,0
MANIPUR,2010,EXTORTION,0,0,0,0,0,0,0,0,0,0,0,0,0,0,0
MANIPUR,2010,RIOTS,0,0,0,0,0,0,0,0,0,0,0,0,0,0,0
MANIPUR,2010,ARSON,0,0,0,0,0,0,0,0,0,0,0,0,0,0,0
MANIPUR,2010,CRIMINAL BREACH OF TRUST,0,0,0,0,0,0,0,0,0,0,0,0,0,0,0
MANIPUR,2010,CHEATING,0,0,0,0,0,0,0,0,0,0,0,0,0,0,0
MANIPUR,2010,COUNTER FEITING,0,0,0,0,0,0,0,0,0,0,0,0,0,0,0
MANIPUR,2010,DOWRY DEATHS,0,0,0,0,0,0,0,0,0,0,0,0,0,0,0
MANIPUR,2010,MOLESTATION,0,0,0,0,0,0,0,0,0,0,0,0,0,0,0
MANIPUR,2010,EVE-TEASING,0,0,0,0,0,0,0,0,0,0,0,0,0,0,0
MANIPUR,2010,CRUELTY BY HUSBAND OR RELATIVE OF HUSBAND,0,0,0,0,0,0,0,0,0,0,0,0,0,0,0
MANIPUR,2010,OTHER IPC CRIMES,0,0,0,0,0,0,1,0,1,0,0,0,1,0,1
MANIPUR,2010,TOTAL IPC,0,0,0,0,0,0,11,1,12,17,0,17,28,1,29
MANIPUR,2011,MURDER,0,0,0,0,0,0,7,1,8,12,0,12,19,1,20
MANIPUR,2011,ATTEMPT TO COMMIT MURDER,0,0,0,0,0,0,0,0,0,0,0,0,0,0,0
MANIPUR,2011,C.H. NOT AMOUNTING TO MURDER,0,0,0,0,0,0,1,0,1,0,0,0,1,0,1
MANIPUR,2011,RAPE,0,0,0,0,0,0,0,0,0,0,0,0,0,0,0
MANIPUR,2011,KIDNAPPING AND ABDUCTION,0,0,0,0,0,0,0,0,0,0,0,0,0,0,0
MANIPUR,2011,DACOITY,0,0,0,0,0,0,0,0,0,0,0,0,0,0,0
MANIPUR,2011,PREP. AND ASSEMBLY FOR DACOITY,0,0,0,0,0,0,0,0,0,0,0,0,0,0,0
MANIPUR,2011,ROBBERY,0,0,0,0,0,0,0,0,0,0,0,0,0,0,0
MANIPUR,2011,BURGLARY,0,0,0,0,0,0,0,0,0,0,0,0,0,0,0
MANIPUR,2011,THEFTS,0,0,0,0,0,0,1,0,1,0,0,0,1,0,1
MANIPUR,2011,EXTORTION,0,0,0,0,0,0,0,0,0,0,0,0,0,0,0
MANIPUR,2011,RIOTS,0,0,0,0,0,0,0,0,0,0,0,0,0,0,0
MANIPUR,2011,ARSON,0,0,0,0,0,0,0,0,0,0,0,0,0,0,0
MANIPUR,2011,CRIMINAL BREACH OF TRUST,0,0,0,0,0,0,0,0,0,0,0,0,0,0,0
MANIPUR,2011,CHEATING,0,0,0,0,0,0,0,0,0,0,0,0,0,0,0
MANIPUR,2011,COUNTER FEITING,0,0,0,0,0,0,0,0,0,0,0,0,0,0,0
MANIPUR,2011,DOWRY DEATHS,0,0,0,0,0,0,0,0,0,0,0,0,0,0,0
MANIPUR,2011,MOLESTATION,0,0,0,0,0,0,0,0,0,0,0,0,0,0,0
MANIPUR,2011,EVE-TEASING,0,0,0,0,0,0,0,0,0,0,0,0,0,0,0
MANIPUR,2011,CRUELTY BY HUSBAND OR RELATIVE OF HUSBAND,0,0,0,0,0,0,0,0,0,0,0,0,0,0,0
MANIPUR,2011,OTHER IPC CRIMES,0,0,0,0,0,0,1,0,1,0,0,0,1,0,1
MANIPUR,2011,TOTAL IPC,0,0,0,0,0,0,10,1,11,12,0,12,22,1,23
MANIPUR,2012,MURDER,0,0,0,0,0,0,8,1,9,11,0,11,19,1,20
MANIPUR,2012,ATTEMPT TO COMMIT MURDER,0,0,0,0,0,0,0,0,0,0,0,0,0,0,0
MANIPUR,2012,C.H. NOT AMOUNTING TO MURDER,0,0,0,0,0,0,1,0,1,0,0,0,1,0,1
MANIPUR,2012,RAPE,0,0,0,0,0,0,0,0,0,0,0,0,0,0,0
MANIPUR,2012,KIDNAPPING AND ABDUCTION,0,0,0,0,0,0,0,0,0,0,0,0,0,0,0
MANIPUR,2012,DACOITY,0,0,0,0,0,0,0,0,0,0,0,0,0,0,0
MANIPUR,2012,PREP. AND ASSEMBLY FOR DACOITY,0,0,0,0,0,0,0,0,0,0,0,0,0,0,0
MANIPUR,2012,ROBBERY,0,0,0,0,0,0,0,0,0,0,0,0,0,0,0
MANIPUR,2012,BURGLARY,0,0,0,0,0,0,0,0,0,0,0,0,0,0,0
MANIPUR,2012,THEFTS,0,0,0,0,0,0,1,0,1,0,0,0,1,0,1
MANIPUR,2012,EXTORTION,0,0,0,0,0,0,0,0,0,0,0,0,0,0,0
MANIPUR,2012,RIOTS,0,0,0,0,0,0,0,0,0,0,0,0,0,0,0
MANIPUR,2012,ARSON,0,0,0,0,0,0,0,0,0,0,0,0,0,0,0
MANIPUR,2012,CRIMINAL BREACH OF TRUST,0,0,0,0,0,0,0,0,0,0,0,0,0,0,0
MANIPUR,2012,CHEATING,0,0,0,0,0,0,0,0,0,0,0,0,0,0,0
MANIPUR,2012,COUNTER FEITING,0,0,0,0,0,0,0,0,0,0,0,0,0,0,0
MANIPUR,2012,DOWRY DEATHS,0,0,0,0,0,0,0,0,0,0,0,0,0,0,0
MANIPUR,2012,MOLESTATION,0,0,0,0,0,0,0,0,0,0,0,0,0,0,0
MANIPUR,2012,EVE-TEASING,0,0,0,0,0,0,0,0,0,0,0,0,0,0,0
MANIPUR,2012,CRUELTY BY HUSBAND OR RELATIVE OF HUSBAND,0,0,0,0,0,0,0,0,0,0,0,0,0,0,0
MANIPUR,2012,OTHER IPC CRIMES,0,0,0,0,0,0,1,0,1,0,0,0,1,0,1
MANIPUR,2012,TOTAL IPC,0,0,0,0,0,0,11,1,12,11,0,11,22,1,23
MEGHALAYA,2001,MURDER,0,0,0,0,0,0,6,0,6,1,0,1,7,0,7
MEGHALAYA,2001,ATTEMPT TO COMMIT MURDER,0,0,0,0,0,0,0,0,0,0,0,0,0,0,0
MEGHALAYA,2001,C.H. NOT AMOUNTING TO MURDER,0,0,0,0,0,0,0,0,0,0,0,0,0,0,0
MEGHALAYA,2001,RAPE,0,0,0,0,0,0,1,0,1,0,0,0,1,0,1
MEGHALAYA,2001,KIDNAPPING AND ABDUCTION,0,0,0,0,0,0,0,0,0,0,0,0,0,0,0
MEGHALAYA,2001,DACOITY,0,0,0,1,0,1,0,0,0,0,0,0,1,0,1
MEGHALAYA,2001,PREP. AND ASSEMBLY FOR DACOITY,0,0,0,0,0,0,0,0,0,0,0,0,0,0,0
MEGHALAYA,2001,ROBBERY,0,0,0,2,0,2,0,0,0,0,0,0,2,0,2
MEGHALAYA,2001,BURGLARY,0,0,0,0,0,0,1,0,1,0,0,0,1,0,1
MEGHALAYA,2001,THEFTS,0,0,0,0,0,0,0,0,0,0,0,0,0,0,0
MEGHALAYA,2001,EXTORTION,0,0,0,0,0,0,0,0,0,0,0,0,0,0,0
MEGHALAYA,2001,RIOTS,0,0,0,0,0,0,0,0,0,0,0,0,0,0,0
MEGHALAYA,2001,ARSON,0,0,0,0,0,0,0,0,0,0,0,0,0,0,0
MEGHALAYA,2001,CRIMINAL BREACH OF TRUST,0,0,0,0,0,0,0,0,0,0,0,0,0,0,0
MEGHALAYA,2001,CHEATING,0,0,0,0,0,0,0,0,0,0,0,0,0,0,0
MEGHALAYA,2001,COUNTER FEITING,0,0,0,0,0,0,0,0,0,0,0,0,0,0,0
MEGHALAYA,2001,DOWRY DEATHS,0,0,0,0,0,0,0,0,0,0,0,0,0,0,0
MEGHALAYA,2001,MOLESTATION,0,0,0,0,0,0,1,0,1,0,0,0,1,0,1
MEGHALAYA,2001,EVE-TEASING,0,0,0,0,0,0,0,0,0,0,0,0,0,0,0
MEGHALAYA,2001,CRUELTY BY HUSBAND OR RELATIVE OF HUSBAND,0,0,0,0,0,0,0,0,0,0,0,0,0,0,0
MEGHALAYA,2001,OTHER IPC CRIMES,0,0,0,0,0,0,0,0,0,0,0,0,0,0,0
MEGHALAYA,2001,TOTAL IPC,0,0,0,3,0,3,9,0,9,1,0,1,13,0,13
MEGHALAYA,2002,MURDER,0,0,0,5,0,5,6,0,6,0,0,0,11,0,11
MEGHALAYA,2002,ATTEMPT TO COMMIT MURDER,0,0,0,0,0,0,0,0,0,0,0,0,0,0,0
MEGHALAYA,2002,C.H. NOT AMOUNTING TO MURDER,0,0,0,0,0,0,0,0,0,0,0,0,0,0,0
MEGHALAYA,2002,RAPE,0,0,0,1,0,1,1,0,1,0,0,0,2,0,2
MEGHALAYA,2002,KIDNAPPING AND ABDUCTION,0,0,0,0,0,0,0,0,0,0,0,0,0,0,0
MEGHALAYA,2002,DACOITY,0,0,0,0,0,0,0,0,0,0,0,0,0,0,0
MEGHALAYA,2002,PREP. AND ASSEMBLY FOR DACOITY,0,0,0,0,0,0,0,0,0,0,0,0,0,0,0
MEGHALAYA,2002,ROBBERY,0,0,0,0,0,0,0,0,0,0,0,0,0,0,0
MEGHALAYA,2002,BURGLARY,0,0,0,0,0,0,0,0,0,0,0,0,0,0,0
MEGHALAYA,2002,THEFTS,0,0,0,0,0,0,2,0,2,0,0,0,2,0,2
MEGHALAYA,2002,EXTORTION,0,0,0,0,0,0,0,0,0,0,0,0,0,0,0
MEGHALAYA,2002,RIOTS,0,0,0,0,0,0,0,0,0,0,0,0,0,0,0
MEGHALAYA,2002,ARSON,0,0,0,0,0,0,0,0,0,0,0,0,0,0,0
MEGHALAYA,2002,CRIMINAL BREACH OF TRUST,0,0,0,0,0,0,0,0,0,0,0,0,0,0,0
MEGHALAYA,2002,CHEATING,0,0,0,1,0,1,0,0,0,0,0,0,1,0,1
MEGHALAYA,2002,COUNTER FEITING,0,0,0,0,0,0,0,0,0,0,0,0,0,0,0
MEGHALAYA,2002,DOWRY DEATHS,0,0,0,0,0,0,0,0,0,0,0,0,0,0,0
MEGHALAYA,2002,MOLESTATION,0,0,0,0,0,0,0,0,0,0,0,0,0,0,0
MEGHALAYA,2002,EVE-TEASING,0,0,0,0,0,0,0,0,0,0,0,0,0,0,0
MEGHALAYA,2002,CRUELTY BY HUSBAND OR RELATIVE OF HUSBAND,0,0,0,0,0,0,0,0,0,0,0,0,0,0,0
MEGHALAYA,2002,OTHER IPC CRIMES,0,0,0,0,0,0,0,0,0,0,0,0,0,0,0
MEGHALAYA,2002,TOTAL IPC,0,0,0,7,0,7,9,0,9,0,0,0,16,0,16
MEGHALAYA,2003,MURDER,0,0,0,8,0,8,6,0,6,0,0,0,14,0,14
MEGHALAYA,2003,ATTEMPT TO COMMIT MURDER,0,0,0,0,0,0,0,0,0,0,0,0,0,0,0
MEGHALAYA,2003,C.H. NOT AMOUNTING TO MURDER,0,0,0,0,0,0,0,0,0,0,0,0,0,0,0
MEGHALAYA,2003,RAPE,0,0,0,0,0,0,1,0,1,0,0,0,1,0,1
MEGHALAYA,2003,KIDNAPPING AND ABDUCTION,0,0,0,0,0,0,0,0,0,0,0,0,0,0,0
MEGHALAYA,2003,DACOITY,0,0,0,1,0,1,3,0,3,0,0,0,4,0,4
MEGHALAYA,2003,PREP. AND ASSEMBLY FOR DACOITY,0,0,0,0,0,0,0,0,0,0,0,0,0,0,0
MEGHALAYA,2003,ROBBERY,0,0,0,0,0,0,0,0,0,0,0,0,0,0,0
MEGHALAYA,2003,BURGLARY,0,0,0,0,0,0,0,0,0,0,0,0,0,0,0
MEGHALAYA,2003,THEFTS,0,0,0,4,0,4,2,0,2,0,0,0,6,0,6
MEGHALAYA,2003,EXTORTION,0,0,0,0,0,0,1,0,1,0,0,0,1,0,1
MEGHALAYA,2003,RIOTS,0,0,0,0,0,0,0,0,0,0,0,0,0,0,0
MEGHALAYA,2003,ARSON,0,0,0,0,0,0,0,0,0,0,0,0,0,0,0
MEGHALAYA,2003,CRIMINAL BREACH OF TRUST,0,0,0,0,0,0,0,0,0,0,0,0,0,0,0
MEGHALAYA,2003,CHEATING,0,0,0,0,0,0,0,0,0,0,0,0,0,0,0
MEGHALAYA,2003,COUNTER FEITING,0,0,0,0,0,0,0,0,0,0,0,0,0,0,0
MEGHALAYA,2003,DOWRY DEATHS,0,0,0,0,0,0,0,0,0,0,0,0,0,0,0
MEGHALAYA,2003,MOLESTATION,0,0,0,0,0,0,0,0,0,0,0,0,0,0,0
MEGHALAYA,2003,EVE-TEASING,0,0,0,0,0,0,0,0,0,0,0,0,0,0,0
MEGHALAYA,2003,CRUELTY BY HUSBAND OR RELATIVE OF HUSBAND,0,0,0,0,0,0,0,0,0,0,0,0,0,0,0
MEGHALAYA,2003,OTHER IPC CRIMES,0,0,0,0,0,0,1,0,1,0,0,0,1,0,1
MEGHALAYA,2003,TOTAL IPC,0,0,0,13,0,13,14,0,14,0,0,0,27,0,27
MEGHALAYA,2004,MURDER,0,0,0,0,0,0,13,0,13,0,0,0,13,0,13
MEGHALAYA,2004,ATTEMPT TO COMMIT MURDER,0,0,0,0,0,0,0,0,0,0,0,0,0,0,0
MEGHALAYA,2004,C.H. NOT AMOUNTING TO MURDER,0,0,0,0,0,0,0,0,0,0,0,0,0,0,0
MEGHALAYA,2004,RAPE,0,0,0,0,0,0,5,0,5,0,0,0,5,0,5
MEGHALAYA,2004,KIDNAPPING AND ABDUCTION,0,0,0,0,0,0,0,0,0,0,0,0,0,0,0
MEGHALAYA,2004,DACOITY,0,0,0,0,0,0,0,0,0,0,0,0,0,0,0
MEGHALAYA,2004,PREP. AND ASSEMBLY FOR DACOITY,0,0,0,0,0,0,0,0,0,0,0,0,0,0,0
MEGHALAYA,2004,ROBBERY,0,0,0,2,0,2,0,0,0,0,0,0,2,0,2
MEGHALAYA,2004,BURGLARY,0,0,0,0,0,0,0,0,0,0,0,0,0,0,0
MEGHALAYA,2004,THEFTS,0,0,0,4,0,4,0,0,0,0,0,0,4,0,4
MEGHALAYA,2004,EXTORTION,0,0,0,0,0,0,0,0,0,0,0,0,0,0,0
MEGHALAYA,2004,RIOTS,0,0,0,0,0,0,0,0,0,0,0,0,0,0,0
MEGHALAYA,2004,ARSON,0,0,0,0,0,0,0,0,0,0,0,0,0,0,0
MEGHALAYA,2004,CRIMINAL BREACH OF TRUST,0,0,0,0,0,0,0,0,0,0,0,0,0,0,0
MEGHALAYA,2004,CHEATING,0,0,0,0,0,0,0,0,0,0,0,0,0,0,0
MEGHALAYA,2004,COUNTER FEITING,0,0,0,0,0,0,0,0,0,0,0,0,0,0,0
MEGHALAYA,2004,DOWRY DEATHS,0,0,0,0,0,0,0,0,0,0,0,0,0,0,0
MEGHALAYA,2004,MOLESTATION,0,0,0,0,0,0,0,0,0,0,0,0,0,0,0
MEGHALAYA,2004,EVE-TEASING,0,0,0,0,0,0,0,0,0,0,0,0,0,0,0
MEGHALAYA,2004,CRUELTY BY HUSBAND OR RELATIVE OF HUSBAND,0,0,0,0,0,0,0,0,0,0,0,0,0,0,0
MEGHALAYA,2004,OTHER IPC CRIMES,0,0,0,7,0,7,0,0,0,0,0,0,7,0,7
MEGHALAYA,2004,TOTAL IPC,0,0,0,13,0,13,18,0,18,0,0,0,31,0,31
MEGHALAYA,2005,MURDER,0,0,0,3,0,3,7,0,7,0,0,0,10,0,10
MEGHALAYA,2005,ATTEMPT TO COMMIT MURDER,0,0,0,0,0,0,0,0,0,0,0,0,0,0,0
MEGHALAYA,2005,C.H. NOT AMOUNTING TO MURDER,0,0,0,0,0,0,0,0,0,0,0,0,0,0,0
MEGHALAYA,2005,RAPE,0,0,0,1,0,1,4,0,4,0,0,0,5,0,5
MEGHALAYA,2005,KIDNAPPING AND ABDUCTION,0,0,0,0,0,0,0,0,0,0,0,0,0,0,0
MEGHALAYA,2005,DACOITY,0,0,0,0,0,0,0,0,0,0,0,0,0,0,0
MEGHALAYA,2005,PREP. AND ASSEMBLY FOR DACOITY,0,0,0,0,0,0,0,0,0,0,0,0,0,0,0
MEGHALAYA,2005,ROBBERY,0,0,0,0,0,0,1,0,1,0,0,0,1,0,1
MEGHALAYA,2005,BURGLARY,0,0,0,2,0,2,1,0,1,0,0,0,3,0,3
MEGHALAYA,2005,THEFTS,0,0,0,0,0,0,2,0,2,0,0,0,2,0,2
MEGHALAYA,2005,EXTORTION,0,0,0,0,0,0,0,0,0,0,0,0,0,0,0
MEGHALAYA,2005,RIOTS,0,0,0,0,0,0,0,0,0,0,0,0,0,0,0
MEGHALAYA,2005,ARSON,0,0,0,0,0,0,0,0,0,0,0,0,0,0,0
MEGHALAYA,2005,CRIMINAL BREACH OF TRUST,0,0,0,0,0,0,0,0,0,0,0,0,0,0,0
MEGHALAYA,2005,CHEATING,0,0,0,0,0,0,0,0,0,0,0,0,0,0,0
MEGHALAYA,2005,COUNTER FEITING,0,0,0,0,0,0,0,0,0,0,0,0,0,0,0
MEGHALAYA,2005,DOWRY DEATHS,0,0,0,0,0,0,0,0,0,0,0,0,0,0,0
MEGHALAYA,2005,MOLESTATION,0,0,0,0,0,0,0,0,0,0,0,0,0,0,0
MEGHALAYA,2005,EVE-TEASING,0,0,0,0,0,0,0,0,0,0,0,0,0,0,0
MEGHALAYA,2005,CRUELTY BY HUSBAND OR RELATIVE OF HUSBAND,0,0,0,0,0,0,0,0,0,0,0,0,0,0,0
MEGHALAYA,2005,OTHER IPC CRIMES,0,0,0,0,0,0,1,0,1,0,0,0,1,0,1
MEGHALAYA,2005,TOTAL IPC,0,0,0,6,0,6,16,0,16,0,0,0,22,0,22
MEGHALAYA,2006,MURDER,0,0,0,5,0,5,6,1,7,4,0,4,15,1,16
MEGHALAYA,2006,ATTEMPT TO COMMIT MURDER,0,0,0,0,0,0,3,0,3,0,0,0,3,0,3
MEGHALAYA,2006,C.H. NOT AMOUNTING TO MURDER,0,0,0,0,0,0,2,0,2,0,0,0,2,0,2
MEGHALAYA,2006,RAPE,0,0,0,6,0,6,7,0,7,2,0,2,15,0,15
MEGHALAYA,2006,KIDNAPPING AND ABDUCTION,0,0,0,0,0,0,0,0,0,0,0,0,0,0,0
MEGHALAYA,2006,DACOITY,0,0,0,0,0,0,0,0,0,0,0,0,0,0,0
MEGHALAYA,2006,PREP. AND ASSEMBLY FOR DACOITY,0,0,0,0,0,0,0,0,0,0,0,0,0,0,0
MEGHALAYA,2006,ROBBERY,0,0,0,2,0,2,6,0,6,0,0,0,8,0,8
MEGHALAYA,2006,BURGLARY,0,0,0,0,0,0,0,0,0,0,0,0,0,0,0
MEGHALAYA,2006,THEFTS,0,0,0,0,0,0,0,0,0,0,0,0,0,0,0
MEGHALAYA,2006,EXTORTION,0,0,0,0,0,0,0,0,0,0,0,0,0,0,0
MEGHALAYA,2006,RIOTS,0,0,0,0,0,0,0,0,0,0,0,0,0,0,0
MEGHALAYA,2006,ARSON,0,0,0,0,0,0,0,0,0,0,0,0,0,0,0
MEGHALAYA,2006,CRIMINAL BREACH OF TRUST,0,0,0,0,0,0,0,0,0,0,0,0,0,0,0
MEGHALAYA,2006,CHEATING,0,0,0,0,0,0,0,0,0,0,0,0,0,0,0
MEGHALAYA,2006,COUNTER FEITING,0,0,0,0,0,0,0,0,0,0,0,0,0,0,0
MEGHALAYA,2006,DOWRY DEATHS,0,0,0,0,0,0,0,0,0,0,0,0,0,0,0
MEGHALAYA,2006,MOLESTATION,0,0,0,0,0,0,0,0,0,0,0,0,0,0,0
MEGHALAYA,2006,EVE-TEASING,0,0,0,0,0,0,0,0,0,0,0,0,0,0,0
MEGHALAYA,2006,CRUELTY BY HUSBAND OR RELATIVE OF HUSBAND,0,0,0,0,0,0,0,0,0,0,0,0,0,0,0
MEGHALAYA,2006,OTHER IPC CRIMES,0,0,0,0,0,0,0,0,0,0,0,0,0,0,0
MEGHALAYA,2006,TOTAL IPC,0,0,0,13,0,13,24,1,25,6,0,6,43,1,44
MEGHALAYA,2007,MURDER,0,0,0,2,0,2,3,1,4,1,0,1,6,1,7
MEGHALAYA,2007,ATTEMPT TO COMMIT MURDER,0,0,0,0,0,0,0,0,0,0,0,0,0,0,0
MEGHALAYA,2007,C.H. NOT AMOUNTING TO MURDER,0,0,0,0,0,0,0,0,0,0,0,0,0,0,0
MEGHALAYA,2007,RAPE,0,0,0,5,0,5,13,0,13,0,0,0,18,0,18
MEGHALAYA,2007,KIDNAPPING AND ABDUCTION,0,0,0,1,0,1,1,0,1,0,0,0,2,0,2
MEGHALAYA,2007,DACOITY,0,0,0,0,0,0,2,0,2,0,0,0,2,0,2
MEGHALAYA,2007,PREP. AND ASSEMBLY FOR DACOITY,0,0,0,0,0,0,0,0,0,0,0,0,0,0,0
MEGHALAYA,2007,ROBBERY,0,0,0,3,0,3,7,0,7,0,0,0,10,0,10
MEGHALAYA,2007,BURGLARY,0,0,0,0,0,0,0,0,0,0,0,0,0,0,0
MEGHALAYA,2007,THEFTS,0,0,0,1,0,1,0,0,0,0,0,0,1,0,1
MEGHALAYA,2007,EXTORTION,0,0,0,0,0,0,0,0,0,0,0,0,0,0,0
MEGHALAYA,2007,RIOTS,0,0,0,0,0,0,0,0,0,0,0,0,0,0,0
MEGHALAYA,2007,ARSON,0,0,0,0,0,0,2,0,2,0,0,0,2,0,2
MEGHALAYA,2007,CRIMINAL BREACH OF TRUST,0,0,0,0,0,0,0,0,0,0,0,0,0,0,0
MEGHALAYA,2007,CHEATING,0,0,0,0,0,0,0,0,0,0,0,0,0,0,0
MEGHALAYA,2007,COUNTER FEITING,0,0,0,0,0,0,0,0,0,0,0,0,0,0,0
MEGHALAYA,2007,DOWRY DEATHS,0,0,0,0,0,0,0,0,0,0,0,0,0,0,0
MEGHALAYA,2007,MOLESTATION,0,0,0,0,0,0,1,0,1,0,0,0,1,0,1
MEGHALAYA,2007,EVE-TEASING,0,0,0,0,0,0,0,0,0,0,0,0,0,0,0
MEGHALAYA,2007,CRUELTY BY HUSBAND OR RELATIVE OF HUSBAND,0,0,0,0,0,0,0,0,0,0,0,0,0,0,0
MEGHALAYA,2007,OTHER IPC CRIMES,0,0,0,0,0,0,0,0,0,0,0,0,0,0,0
MEGHALAYA,2007,TOTAL IPC,0,0,0,12,0,12,29,1,30,1,0,1,42,1,43
MEGHALAYA,2008,MURDER,0,0,0,2,0,2,22,0,22,0,0,0,24,0,24
MEGHALAYA,2008,ATTEMPT TO COMMIT MURDER,0,0,0,2,0,2,1,0,1,0,0,0,3,0,3
MEGHALAYA,2008,C.H. NOT AMOUNTING TO MURDER,0,0,0,0,0,0,1,0,1,0,0,0,1,0,1
MEGHALAYA,2008,RAPE,0,0,0,0,0,0,6,0,6,0,0,0,6,0,6
MEGHALAYA,2008,KIDNAPPING AND ABDUCTION,0,0,0,1,0,1,2,0,2,0,0,0,3,0,3
MEGHALAYA,2008,DACOITY,0,0,0,2,0,2,1,0,1,0,0,0,3,0,3
MEGHALAYA,2008,PREP. AND ASSEMBLY FOR DACOITY,0,0,0,0,0,0,0,0,0,0,0,0,0,0,0
MEGHALAYA,2008,ROBBERY,0,0,0,2,0,2,5,0,5,0,0,0,7,0,7
MEGHALAYA,2008,BURGLARY,0,0,0,1,0,1,2,0,2,0,0,0,3,0,3
MEGHALAYA,2008,THEFTS,0,0,0,2,0,2,3,0,3,0,0,0,5,0,5
MEGHALAYA,2008,EXTORTION,0,0,0,3,0,3,2,0,2,0,0,0,5,0,5
MEGHALAYA,2008,RIOTS,0,0,0,0,0,0,0,0,0,0,0,0,0,0,0
MEGHALAYA,2008,ARSON,0,0,0,0,0,0,0,0,0,0,0,0,0,0,0
MEGHALAYA,2008,CRIMINAL BREACH OF TRUST,0,0,0,0,0,0,0,0,0,0,0,0,0,0,0
MEGHALAYA,2008,CHEATING,0,0,0,0,0,0,0,0,0,0,0,0,0,0,0
MEGHALAYA,2008,COUNTER FEITING,0,0,0,0,0,0,0,0,0,0,0,0,0,0,0
MEGHALAYA,2008,DOWRY DEATHS,0,0,0,0,0,0,0,0,0,0,0,0,0,0,0
MEGHALAYA,2008,MOLESTATION,0,0,0,0,0,0,0,0,0,0,0,0,0,0,0
MEGHALAYA,2008,EVE-TEASING,0,0,0,0,0,0,0,0,0,0,0,0,0,0,0
MEGHALAYA,2008,CRUELTY BY HUSBAND OR RELATIVE OF HUSBAND,0,0,0,0,0,0,0,0,0,0,0,0,0,0,0
MEGHALAYA,2008,OTHER IPC CRIMES,0,0,0,0,0,0,0,0,0,0,0,0,0,0,0
MEGHALAYA,2008,TOTAL IPC,0,0,0,15,0,15,45,0,45,0,0,0,60,0,60
MEGHALAYA,2009,MURDER,0,0,0,2,0,2,13,0,13,0,0,0,15,0,15
MEGHALAYA,2009,ATTEMPT TO COMMIT MURDER,0,0,0,1,0,1,4,0,4,0,0,0,5,0,5
MEGHALAYA,2009,C.H. NOT AMOUNTING TO MURDER,0,0,0,0,0,0,1,0,1,0,0,0,1,0,1
MEGHALAYA,2009,RAPE,0,0,0,11,0,11,9,0,9,0,0,0,20,0,20
MEGHALAYA,2009,KIDNAPPING AND ABDUCTION,0,0,0,1,0,1,3,0,3,0,0,0,4,0,4
MEGHALAYA,2009,DACOITY,0,0,0,8,0,8,4,0,4,0,0,0,12,0,12
MEGHALAYA,2009,PREP. AND ASSEMBLY FOR DACOITY,0,0,0,0,0,0,0,0,0,0,0,0,0,0,0
MEGHALAYA,2009,ROBBERY,0,0,0,4,0,4,3,0,3,0,0,0,7,0,7
MEGHALAYA,2009,BURGLARY,0,0,0,0,0,0,0,0,0,0,0,0,0,0,0
MEGHALAYA,2009,THEFTS,0,0,0,5,0,5,5,0,5,0,0,0,10,0,10
MEGHALAYA,2009,EXTORTION,0,0,0,0,0,0,0,0,0,0,0,0,0,0,0
MEGHALAYA,2009,RIOTS,0,0,0,0,0,0,0,0,0,0,0,0,0,0,0
MEGHALAYA,2009,ARSON,0,0,0,0,0,0,0,0,0,0,0,0,0,0,0
MEGHALAYA,2009,CRIMINAL BREACH OF TRUST,0,0,0,0,0,0,0,0,0,0,0,0,0,0,0
MEGHALAYA,2009,CHEATING,0,0,0,0,0,0,0,0,0,0,0,0,0,0,0
MEGHALAYA,2009,COUNTER FEITING,0,0,0,0,0,0,0,0,0,0,0,0,0,0,0
MEGHALAYA,2009,DOWRY DEATHS,0,0,0,0,0,0,2,0,2,0,0,0,2,0,2
MEGHALAYA,2009,MOLESTATION,0,0,0,0,0,0,0,0,0,0,0,0,0,0,0
MEGHALAYA,2009,EVE-TEASING,0,0,0,0,0,0,0,0,0,0,0,0,0,0,0
MEGHALAYA,2009,CRUELTY BY HUSBAND OR RELATIVE OF HUSBAND,0,0,0,0,0,0,0,0,0,0,0,0,0,0,0
MEGHALAYA,2009,OTHER IPC CRIMES,0,0,0,0,0,0,1,0,1,0,0,0,1,0,1
MEGHALAYA,2009,TOTAL IPC,0,0,0,32,0,32,45,0,45,0,0,0,77,0,77
MEGHALAYA,2010,MURDER,0,0,0,7,0,7,6,0,6,3,0,3,16,0,16
MEGHALAYA,2010,ATTEMPT TO COMMIT MURDER,0,0,0,1,0,1,0,0,0,0,0,0,1,0,1
MEGHALAYA,2010,C.H. NOT AMOUNTING TO MURDER,0,0,0,0,0,0,1,0,1,0,0,0,1,0,1
MEGHALAYA,2010,RAPE,0,0,0,8,0,8,6,0,6,2,0,2,16,0,16
MEGHALAYA,2010,KIDNAPPING AND ABDUCTION,0,0,0,0,0,0,0,0,0,0,0,0,0,0,0
MEGHALAYA,2010,DACOITY,0,0,0,0,0,0,0,0,0,0,0,0,0,0,0
MEGHALAYA,2010,PREP. AND ASSEMBLY FOR DACOITY,0,0,0,0,0,0,0,0,0,0,0,0,0,0,0
MEGHALAYA,2010,ROBBERY,0,0,0,0,0,0,0,0,0,0,0,0,0,0,0
MEGHALAYA,2010,BURGLARY,0,0,0,0,0,0,0,0,0,0,0,0,0,0,0
MEGHALAYA,2010,THEFTS,0,0,0,0,0,0,6,0,6,0,0,0,6,0,6
MEGHALAYA,2010,EXTORTION,0,0,0,0,0,0,0,0,0,0,0,0,0,0,0
MEGHALAYA,2010,RIOTS,0,0,0,0,0,0,0,0,0,0,0,0,0,0,0
MEGHALAYA,2010,ARSON,0,0,0,0,0,0,0,0,0,0,0,0,0,0,0
MEGHALAYA,2010,CRIMINAL BREACH OF TRUST,0,0,0,0,0,0,0,0,0,0,0,0,0,0,0
MEGHALAYA,2010,CHEATING,0,0,0,0,0,0,0,0,0,0,0,0,0,0,0
MEGHALAYA,2010,COUNTER FEITING,0,0,0,0,0,0,2,0,2,0,0,0,2,0,2
MEGHALAYA,2010,DOWRY DEATHS,0,0,0,0,0,0,0,0,0,0,0,0,0,0,0
MEGHALAYA,2010,MOLESTATION,0,0,0,0,0,0,0,0,0,0,0,0,0,0,0
MEGHALAYA,2010,EVE-TEASING,0,0,0,0,0,0,0,0,0,0,0,0,0,0,0
MEGHALAYA,2010,CRUELTY BY HUSBAND OR RELATIVE OF HUSBAND,0,0,0,0,0,0,0,0,0,0,0,0,0,0,0
MEGHALAYA,2010,OTHER IPC CRIMES,0,0,0,1,0,1,5,0,5,0,0,0,6,0,6
MEGHALAYA,2010,TOTAL IPC,0,0,0,17,0,17,26,0,26,5,0,5,48,0,48
MEGHALAYA,2011,MURDER,0,0,0,3,0,3,7,0,7,2,0,2,12,0,12
MEGHALAYA,2011,ATTEMPT TO COMMIT MURDER,0,0,0,1,0,1,0,0,0,0,0,0,1,0,1
MEGHALAYA,2011,C.H. NOT AMOUNTING TO MURDER,0,0,0,0,0,0,2,0,2,0,0,0,2,0,2
MEGHALAYA,2011,RAPE,0,0,0,16,0,16,6,0,6,1,0,1,23,0,23
MEGHALAYA,2011,KIDNAPPING AND ABDUCTION,0,0,0,2,0,2,1,0,1,0,0,0,3,0,3
MEGHALAYA,2011,DACOITY,0,0,0,2,0,2,0,0,0,0,0,0,2,0,2
MEGHALAYA,2011,PREP. AND ASSEMBLY FOR DACOITY,0,0,0,0,0,0,0,0,0,0,0,0,0,0,0
MEGHALAYA,2011,ROBBERY,0,0,0,3,0,3,0,0,0,0,0,0,3,0,3
MEGHALAYA,2011,BURGLARY,0,0,0,0,0,0,0,0,0,0,0,0,0,0,0
MEGHALAYA,2011,THEFTS,0,0,0,2,0,2,3,0,3,0,0,0,5,0,5
MEGHALAYA,2011,EXTORTION,0,0,0,0,0,0,0,0,0,0,0,0,0,0,0
MEGHALAYA,2011,RIOTS,0,0,0,0,0,0,0,0,0,0,0,0,0,0,0
MEGHALAYA,2011,ARSON,0,0,0,0,0,0,0,0,0,0,0,0,0,0,0
MEGHALAYA,2011,CRIMINAL BREACH OF TRUST,0,0,0,0,0,0,0,0,0,0,0,0,0,0,0
MEGHALAYA,2011,CHEATING,0,0,0,0,0,0,0,0,0,0,0,0,0,0,0
MEGHALAYA,2011,COUNTER FEITING,0,0,0,0,0,0,1,0,1,1,0,1,2,0,2
MEGHALAYA,2011,DOWRY DEATHS,0,0,0,0,0,0,0,0,0,0,0,0,0,0,0
MEGHALAYA,2011,MOLESTATION,0,0,0,0,0,0,0,0,0,0,0,0,0,0,0
MEGHALAYA,2011,EVE-TEASING,0,0,0,0,0,0,0,0,0,0,0,0,0,0,0
MEGHALAYA,2011,CRUELTY BY HUSBAND OR RELATIVE OF HUSBAND,0,0,0,0,0,0,0,0,0,0,0,0,0,0,0
MEGHALAYA,2011,OTHER IPC CRIMES,0,0,0,1,0,1,0,0,0,0,0,0,1,0,1
MEGHALAYA,2011,TOTAL IPC,0,0,0,30,0,30,20,0,20,4,0,4,54,0,54
MEGHALAYA,2012,MURDER,0,0,0,12,0,12,10,0,10,4,0,4,26,0,26
MEGHALAYA,2012,ATTEMPT TO COMMIT MURDER,0,0,0,0,0,0,0,0,0,0,0,0,0,0,0
MEGHALAYA,2012,C.H. NOT AMOUNTING TO MURDER,0,0,0,0,0,0,1,0,1,0,0,0,1,0,1
MEGHALAYA,2012,RAPE,0,0,0,11,0,11,12,0,12,0,0,0,23,0,23
MEGHALAYA,2012,KIDNAPPING AND ABDUCTION,0,0,0,0,0,0,1,0,1,0,0,0,1,0,1
MEGHALAYA,2012,DACOITY,0,0,0,1,0,1,1,0,1,0,0,0,2,0,2
MEGHALAYA,2012,PREP. AND ASSEMBLY FOR DACOITY,0,0,0,0,0,0,0,0,0,0,0,0,0,0,0
MEGHALAYA,2012,ROBBERY,0,0,0,1,0,1,1,0,1,0,0,0,2,0,2
MEGHALAYA,2012,BURGLARY,0,0,0,0,0,0,1,0,1,0,0,0,1,0,1
MEGHALAYA,2012,THEFTS,0,0,0,5,0,5,1,0,1,0,0,0,6,0,6
MEGHALAYA,2012,EXTORTION,0,0,0,0,0,0,0,0,0,0,0,0,0,0,0
MEGHALAYA,2012,RIOTS,0,0,0,0,0,0,0,0,0,0,0,0,0,0,0
MEGHALAYA,2012,ARSON,0,0,0,0,0,0,0,0,0,0,0,0,0,0,0
MEGHALAYA,2012,CRIMINAL BREACH OF TRUST,0,0,0,0,0,0,0,0,0,0,0,0,0,0,0
MEGHALAYA,2012,CHEATING,0,0,0,0,0,0,0,0,0,0,0,0,0,0,0
MEGHALAYA,2012,COUNTER FEITING,0,0,0,0,0,0,0,0,0,0,0,0,0,0,0
MEGHALAYA,2012,DOWRY DEATHS,0,0,0,0,0,0,0,0,0,0,0,0,0,0,0
MEGHALAYA,2012,MOLESTATION,0,0,0,0,0,0,0,0,0,0,0,0,0,0,0
MEGHALAYA,2012,EVE-TEASING,0,0,0,0,0,0,0,0,0,0,0,0,0,0,0
MEGHALAYA,2012,CRUELTY BY HUSBAND OR RELATIVE OF HUSBAND,0,0,0,0,0,0,0,0,0,0,0,0,0,0,0
MEGHALAYA,2012,OTHER IPC CRIMES,0,0,0,0,0,0,0,0,0,0,0,0,0,0,0
MEGHALAYA,2012,TOTAL IPC,0,0,0,30,0,30,28,0,28,4,0,4,62,0,62
MIZORAM,2001,MURDER,0,0,0,6,0,6,5,0,5,0,0,0,11,0,11
MIZORAM,2001,ATTEMPT TO COMMIT MURDER,0,0,0,0,0,0,0,0,0,0,0,0,0,0,0
MIZORAM,2001,C.H. NOT AMOUNTING TO MURDER,0,0,0,1,0,1,0,0,0,0,0,0,1,0,1
MIZORAM,2001,RAPE,0,0,0,8,0,8,5,0,5,0,0,0,13,0,13
MIZORAM,2001,KIDNAPPING AND ABDUCTION,0,0,0,0,0,0,0,0,0,0,0,0,0,0,0
MIZORAM,2001,DACOITY,0,0,0,0,0,0,0,0,0,0,0,0,0,0,0
MIZORAM,2001,PREP. AND ASSEMBLY FOR DACOITY,0,0,0,0,0,0,0,0,0,0,0,0,0,0,0
MIZORAM,2001,ROBBERY,0,0,0,0,0,0,0,0,0,0,0,0,0,0,0
MIZORAM,2001,BURGLARY,0,0,0,9,0,9,0,0,0,0,0,0,9,0,9
MIZORAM,2001,THEFTS,5,0,5,25,0,25,5,0,5,0,0,0,35,0,35
MIZORAM,2001,EXTORTION,0,0,0,0,0,0,0,0,0,0,0,0,0,0,0
MIZORAM,2001,RIOTS,0,0,0,0,0,0,0,0,0,0,0,0,0,0,0
MIZORAM,2001,ARSON,0,0,0,0,0,0,0,0,0,0,0,0,0,0,0
MIZORAM,2001,CRIMINAL BREACH OF TRUST,0,0,0,0,0,0,0,0,0,0,0,0,0,0,0
MIZORAM,2001,CHEATING,0,0,0,0,0,0,0,0,0,0,0,0,0,0,0
MIZORAM,2001,COUNTER FEITING,0,0,0,0,0,0,0,0,0,0,0,0,0,0,0
MIZORAM,2001,DOWRY DEATHS,0,0,0,0,0,0,0,0,0,0,0,0,0,0,0
MIZORAM,2001,MOLESTATION,0,0,0,0,0,0,0,0,0,0,0,0,0,0,0
MIZORAM,2001,EVE-TEASING,0,0,0,0,0,0,0,0,0,0,0,0,0,0,0
MIZORAM,2001,CRUELTY BY HUSBAND OR RELATIVE OF HUSBAND,0,0,0,0,0,0,0,0,0,0,0,0,0,0,0
MIZORAM,2001,OTHER IPC CRIMES,0,0,0,0,0,0,0,0,0,0,0,0,0,0,0
MIZORAM,2001,TOTAL IPC,5,0,5,49,0,49,15,0,15,0,0,0,69,0,69
MIZORAM,2002,MURDER,0,0,0,6,0,6,6,0,6,0,0,0,12,0,12
MIZORAM,2002,ATTEMPT TO COMMIT MURDER,0,0,0,3,1,4,2,0,2,0,0,0,5,1,6
MIZORAM,2002,C.H. NOT AMOUNTING TO MURDER,0,0,0,5,0,5,0,0,0,0,0,0,5,0,5
MIZORAM,2002,RAPE,0,0,0,8,0,8,6,0,6,0,0,0,14,0,14
MIZORAM,2002,KIDNAPPING AND ABDUCTION,0,0,0,0,0,0,0,0,0,0,0,0,0,0,0
MIZORAM,2002,DACOITY,0,0,0,0,0,0,0,0,0,0,0,0,0,0,0
MIZORAM,2002,PREP. AND ASSEMBLY FOR DACOITY,0,0,0,0,0,0,0,0,0,0,0,0,0,0,0
MIZORAM,2002,ROBBERY,0,0,0,5,2,7,5,0,5,0,0,0,10,2,12
MIZORAM,2002,BURGLARY,0,0,0,10,0,10,10,0,10,0,0,0,20,0,20
MIZORAM,2002,THEFTS,19,0,19,70,10,80,20,5,25,0,0,0,109,15,124
MIZORAM,2002,EXTORTION,0,0,0,0,0,0,0,0,0,0,0,0,0,0,0
MIZORAM,2002,RIOTS,0,0,0,0,0,0,0,0,0,0,0,0,0,0,0
MIZORAM,2002,ARSON,0,0,0,0,0,0,0,0,0,0,0,0,0,0,0
MIZORAM,2002,CRIMINAL BREACH OF TRUST,0,0,0,0,0,0,0,0,0,0,0,0,0,0,0
MIZORAM,2002,CHEATING,0,0,0,0,0,0,0,0,0,0,0,0,0,0,0
MIZORAM,2002,COUNTER FEITING,0,0,0,0,0,0,0,0,0,0,0,0,0,0,0
MIZORAM,2002,DOWRY DEATHS,0,0,0,0,0,0,0,0,0,0,0,0,0,0,0
MIZORAM,2002,MOLESTATION,0,0,0,0,0,0,0,0,0,0,0,0,0,0,0
MIZORAM,2002,EVE-TEASING,0,0,0,0,0,0,0,0,0,0,0,0,0,0,0
MIZORAM,2002,CRUELTY BY HUSBAND OR RELATIVE OF HUSBAND,0,0,0,0,0,0,0,0,0,0,0,0,0,0,0
MIZORAM,2002,OTHER IPC CRIMES,0,0,0,0,0,0,0,0,0,0,0,0,0,0,0
MIZORAM,2002,TOTAL IPC,19,0,19,107,13,120,49,5,54,0,0,0,175,18,193
MIZORAM,2003,MURDER,0,0,0,8,0,8,8,0,8,0,0,0,16,0,16
MIZORAM,2003,ATTEMPT TO COMMIT MURDER,0,0,0,0,0,0,5,0,5,0,0,0,5,0,5
MIZORAM,2003,C.H. NOT AMOUNTING TO MURDER,0,0,0,0,0,0,1,0,1,0,0,0,1,0,1
MIZORAM,2003,RAPE,0,0,0,7,0,7,9,0,9,0,0,0,16,0,16
MIZORAM,2003,KIDNAPPING AND ABDUCTION,0,0,0,2,0,2,0,0,0,0,0,0,2,0,2
MIZORAM,2003,DACOITY,0,0,0,0,0,0,0,0,0,0,0,0,0,0,0
MIZORAM,2003,PREP. AND ASSEMBLY FOR DACOITY,0,0,0,0,0,0,0,0,0,0,0,0,0,0,0
MIZORAM,2003,ROBBERY,0,0,0,2,0,2,6,0,6,0,0,0,8,0,8
MIZORAM,2003,BURGLARY,0,0,0,21,0,21,7,0,7,1,0,1,29,0,29
MIZORAM,2003,THEFTS,12,0,12,30,1,31,6,0,6,0,0,0,48,1,49
MIZORAM,2003,EXTORTION,0,0,0,2,0,2,0,0,0,0,0,0,2,0,2
MIZORAM,2003,RIOTS,0,0,0,0,0,0,0,0,0,0,0,0,0,0,0
MIZORAM,2003,ARSON,0,0,0,0,0,0,1,0,1,0,0,0,1,0,1
MIZORAM,2003,CRIMINAL BREACH OF TRUST,0,0,0,0,0,0,1,0,1,0,0,0,1,0,1
MIZORAM,2003,CHEATING,2,0,2,2,0,2,4,0,4,0,0,0,8,0,8
MIZORAM,2003,COUNTER FEITING,0,0,0,0,0,0,0,0,0,0,0,0,0,0,0
MIZORAM,2003,DOWRY DEATHS,0,0,0,0,0,0,0,0,0,0,0,0,0,0,0
MIZORAM,2003,MOLESTATION,0,0,0,2,0,2,1,0,1,0,0,0,3,0,3
MIZORAM,2003,EVE-TEASING,0,0,0,0,0,0,0,0,0,0,0,0,0,0,0
MIZORAM,2003,CRUELTY BY HUSBAND OR RELATIVE OF HUSBAND,0,0,0,0,0,0,0,0,0,0,0,0,0,0,0
MIZORAM,2003,OTHER IPC CRIMES,0,0,0,0,0,0,1,0,1,0,0,0,1,0,1
MIZORAM,2003,TOTAL IPC,14,0,14,76,1,77,50,0,50,1,0,1,141,1,142
MIZORAM,2004,MURDER,0,0,0,5,0,5,13,0,13,0,0,0,18,0,18
MIZORAM,2004,ATTEMPT TO COMMIT MURDER,0,0,0,5,0,5,5,0,5,0,0,0,10,0,10
MIZORAM,2004,C.H. NOT AMOUNTING TO MURDER,0,0,0,2,0,2,2,0,2,0,0,0,4,0,4
MIZORAM,2004,RAPE,0,0,0,12,0,12,11,0,11,0,0,0,23,0,23
MIZORAM,2004,KIDNAPPING AND ABDUCTION,0,0,0,0,0,0,0,0,0,0,0,0,0,0,0
MIZORAM,2004,DACOITY,0,0,0,0,0,0,0,0,0,0,0,0,0,0,0
MIZORAM,2004,PREP. AND ASSEMBLY FOR DACOITY,0,0,0,0,0,0,0,0,0,0,0,0,0,0,0
MIZORAM,2004,ROBBERY,1,0,1,6,0,6,0,0,0,0,0,0,7,0,7
MIZORAM,2004,BURGLARY,2,0,2,5,0,5,6,0,6,0,0,0,13,0,13
MIZORAM,2004,THEFTS,10,0,10,18,3,21,2,0,2,0,0,0,30,3,33
MIZORAM,2004,EXTORTION,0,0,0,0,0,0,0,0,0,0,0,0,0,0,0
MIZORAM,2004,RIOTS,0,0,0,0,0,0,0,0,0,0,0,0,0,0,0
MIZORAM,2004,ARSON,0,0,0,0,0,0,0,0,0,0,0,0,0,0,0
MIZORAM,2004,CRIMINAL BREACH OF TRUST,0,0,0,2,0,2,0,0,0,0,0,0,2,0,2
MIZORAM,2004,CHEATING,1,0,1,7,0,7,13,0,13,0,0,0,21,0,21
MIZORAM,2004,COUNTER FEITING,0,0,0,0,0,0,0,0,0,0,0,0,0,0,0
MIZORAM,2004,DOWRY DEATHS,0,0,0,0,0,0,0,0,0,0,0,0,0,0,0
MIZORAM,2004,MOLESTATION,0,0,0,0,0,0,0,0,0,0,0,0,0,0,0
MIZORAM,2004,EVE-TEASING,0,0,0,0,0,0,0,0,0,0,0,0,0,0,0
MIZORAM,2004,CRUELTY BY HUSBAND OR RELATIVE OF HUSBAND,0,0,0,0,0,0,0,0,0,0,0,0,0,0,0
MIZORAM,2004,OTHER IPC CRIMES,0,0,0,7,0,7,0,0,0,0,0,0,7,0,7
MIZORAM,2004,TOTAL IPC,14,0,14,69,3,72,52,0,52,0,0,0,135,3,138
MIZORAM,2005,MURDER,0,0,0,6,0,6,8,0,8,0,0,0,14,0,14
MIZORAM,2005,ATTEMPT TO COMMIT MURDER,0,0,0,0,0,0,5,0,5,0,0,0,5,0,5
MIZORAM,2005,C.H. NOT AMOUNTING TO MURDER,0,0,0,0,0,0,2,0,2,0,0,0,2,0,2
MIZORAM,2005,RAPE,0,0,0,6,0,6,8,0,8,0,0,0,14,0,14
MIZORAM,2005,KIDNAPPING AND ABDUCTION,0,0,0,2,0,2,1,0,1,0,0,0,3,0,3
MIZORAM,2005,DACOITY,0,0,0,0,0,0,0,0,0,0,0,0,0,0,0
MIZORAM,2005,PREP. AND ASSEMBLY FOR DACOITY,0,0,0,0,0,0,0,0,0,0,0,0,0,0,0
MIZORAM,2005,ROBBERY,1,0,1,5,0,5,5,0,5,0,0,0,11,0,11
MIZORAM,2005,BURGLARY,2,0,2,8,0,8,8,0,8,0,0,0,18,0,18
MIZORAM,2005,THEFTS,9,0,9,30,7,37,0,0,0,0,0,0,39,7,46
MIZORAM,2005,EXTORTION,0,0,0,3,0,3,0,0,0,0,0,0,3,0,3
MIZORAM,2005,RIOTS,0,0,0,0,0,0,0,0,0,0,0,0,0,0,0
MIZORAM,2005,ARSON,0,0,0,0,0,0,0,0,0,0,0,0,0,0,0
MIZORAM,2005,CRIMINAL BREACH OF TRUST,0,0,0,2,0,2,0,0,0,0,0,0,2,0,2
MIZORAM,2005,CHEATING,1,0,1,8,0,8,3,9,12,0,0,0,12,9,21
MIZORAM,2005,COUNTER FEITING,0,0,0,0,0,0,0,0,0,0,0,0,0,0,0
MIZORAM,2005,DOWRY DEATHS,0,0,0,0,0,0,0,0,0,0,0,0,0,0,0
MIZORAM,2005,MOLESTATION,0,0,0,0,0,0,0,0,0,0,0,0,0,0,0
MIZORAM,2005,EVE-TEASING,0,0,0,0,0,0,0,0,0,0,0,0,0,0,0
MIZORAM,2005,CRUELTY BY HUSBAND OR RELATIVE OF HUSBAND,0,0,0,0,0,0,0,0,0,0,0,0,0,0,0
MIZORAM,2005,OTHER IPC CRIMES,0,0,0,0,0,0,0,0,0,0,0,0,0,0,0
MIZORAM,2005,TOTAL IPC,13,0,13,70,7,77,40,9,49,0,0,0,123,16,139
MIZORAM,2006,MURDER,0,0,0,7,0,7,14,0,14,0,0,0,21,0,21
MIZORAM,2006,ATTEMPT TO COMMIT MURDER,0,0,0,1,0,1,0,0,0,0,0,0,1,0,1
MIZORAM,2006,C.H. NOT AMOUNTING TO MURDER,0,0,0,0,0,0,0,0,0,0,0,0,0,0,0
MIZORAM,2006,RAPE,0,0,0,6,0,6,16,0,16,0,0,0,22,0,22
MIZORAM,2006,KIDNAPPING AND ABDUCTION,0,0,0,2,0,2,0,0,0,0,0,0,2,0,2
MIZORAM,2006,DACOITY,0,0,0,0,0,0,0,0,0,0,0,0,0,0,0
MIZORAM,2006,PREP. AND ASSEMBLY FOR DACOITY,0,0,0,0,0,0,0,0,0,0,0,0,0,0,0
MIZORAM,2006,ROBBERY,0,0,0,15,4,19,2,0,2,0,0,0,17,4,21
MIZORAM,2006,BURGLARY,0,0,0,0,0,0,0,0,0,0,0,0,0,0,0
MIZORAM,2006,THEFTS,0,0,0,21,0,21,12,0,12,0,0,0,33,0,33
MIZORAM,2006,EXTORTION,0,0,0,0,0,0,0,0,0,0,0,0,0,0,0
MIZORAM,2006,RIOTS,0,0,0,0,0,0,0,0,0,0,0,0,0,0,0
MIZORAM,2006,ARSON,0,0,0,0,0,0,0,0,0,0,0,0,0,0,0
MIZORAM,2006,CRIMINAL BREACH OF TRUST,0,0,0,0,0,0,0,0,0,0,0,0,0,0,0
MIZORAM,2006,CHEATING,0,0,0,0,0,0,5,1,6,0,0,0,5,1,6
MIZORAM,2006,COUNTER FEITING,0,0,0,0,0,0,0,0,0,0,0,0,0,0,0
MIZORAM,2006,DOWRY DEATHS,0,0,0,0,0,0,0,0,0,0,0,0,0,0,0
MIZORAM,2006,MOLESTATION,0,0,0,1,0,1,0,0,0,0,0,0,1,0,1
MIZORAM,2006,EVE-TEASING,0,0,0,0,0,0,0,0,0,0,0,0,0,0,0
MIZORAM,2006,CRUELTY BY HUSBAND OR RELATIVE OF HUSBAND,0,0,0,0,0,0,0,0,0,0,0,0,0,0,0
MIZORAM,2006,OTHER IPC CRIMES,0,0,0,11,4,15,1,3,4,0,0,0,12,7,19
MIZORAM,2006,TOTAL IPC,0,0,0,64,8,72,50,4,54,0,0,0,114,12,126
MIZORAM,2007,MURDER,0,0,0,8,0,8,3,0,3,2,0,2,13,0,13
MIZORAM,2007,ATTEMPT TO COMMIT MURDER,0,0,0,1,0,1,1,0,1,0,0,0,2,0,2
MIZORAM,2007,C.H. NOT AMOUNTING TO MURDER,0,0,0,0,0,0,3,1,4,0,0,0,3,1,4
MIZORAM,2007,RAPE,0,0,0,5,0,5,10,0,10,3,0,3,18,0,18
MIZORAM,2007,KIDNAPPING AND ABDUCTION,0,0,0,0,0,0,0,0,0,0,0,0,0,0,0
MIZORAM,2007,DACOITY,0,0,0,0,0,0,0,0,0,0,0,0,0,0,0
MIZORAM,2007,PREP. AND ASSEMBLY FOR DACOITY,0,0,0,0,0,0,0,0,0,0,0,0,0,0,0
MIZORAM,2007,ROBBERY,0,0,0,7,0,7,3,0,3,0,0,0,10,0,10
MIZORAM,2007,BURGLARY,0,0,0,7,0,7,0,0,0,0,0,0,7,0,7
MIZORAM,2007,THEFTS,0,0,0,63,4,67,25,0,25,1,0,1,89,4,93
MIZORAM,2007,EXTORTION,0,0,0,0,0,0,1,0,1,0,0,0,1,0,1
MIZORAM,2007,RIOTS,0,0,0,0,0,0,0,0,0,0,0,0,0,0,0
MIZORAM,2007,ARSON,0,0,0,0,0,0,0,0,0,0,0,0,0,0,0
MIZORAM,2007,CRIMINAL BREACH OF TRUST,0,0,0,0,0,0,0,0,0,0,0,0,0,0,0
MIZORAM,2007,CHEATING,0,0,0,0,0,0,3,1,4,0,0,0,3,1,4
MIZORAM,2007,COUNTER FEITING,0,0,0,0,0,0,0,0,0,0,0,0,0,0,0
MIZORAM,2007,DOWRY DEATHS,0,0,0,0,0,0,0,0,0,0,0,0,0,0,0
MIZORAM,2007,MOLESTATION,0,0,0,0,0,0,2,0,2,0,0,0,2,0,2
MIZORAM,2007,EVE-TEASING,0,0,0,0,0,0,0,0,0,0,0,0,0,0,0
MIZORAM,2007,CRUELTY BY HUSBAND OR RELATIVE OF HUSBAND,0,0,0,0,0,0,0,0,0,0,0,0,0,0,0
MIZORAM,2007,OTHER IPC CRIMES,0,0,0,11,1,12,2,0,2,0,0,0,13,1,14
MIZORAM,2007,TOTAL IPC,0,0,0,102,5,107,53,2,55,6,0,6,161,7,168
MIZORAM,2008,MURDER,0,0,0,6,0,6,1,0,1,2,0,2,9,0,9
MIZORAM,2008,ATTEMPT TO COMMIT MURDER,0,0,0,9,0,9,7,0,7,4,0,4,20,0,20
MIZORAM,2008,C.H. NOT AMOUNTING TO MURDER,0,0,0,0,0,0,0,0,0,0,0,0,0,0,0
MIZORAM,2008,RAPE,0,0,0,10,0,10,15,0,15,0,0,0,25,0,25
MIZORAM,2008,KIDNAPPING AND ABDUCTION,0,0,0,2,0,2,0,0,0,0,0,0,2,0,2
MIZORAM,2008,DACOITY,0,0,0,0,0,0,0,0,0,0,0,0,0,0,0
MIZORAM,2008,PREP. AND ASSEMBLY FOR DACOITY,0,0,0,0,0,0,0,0,0,0,0,0,0,0,0
MIZORAM,2008,ROBBERY,0,0,0,0,0,0,0,0,0,0,0,0,0,0,0
MIZORAM,2008,BURGLARY,0,0,0,9,0,9,0,0,0,0,0,0,9,0,9
MIZORAM,2008,THEFTS,0,0,0,65,1,66,49,0,49,0,0,0,114,1,115
MIZORAM,2008,EXTORTION,0,0,0,0,0,0,0,0,0,0,0,0,0,0,0
MIZORAM,2008,RIOTS,0,0,0,0,0,0,0,0,0,0,0,0,0,0,0
MIZORAM,2008,ARSON,0,0,0,0,0,0,0,0,0,0,0,0,0,0,0
MIZORAM,2008,CRIMINAL BREACH OF TRUST,0,0,0,0,0,0,0,0,0,0,0,0,0,0,0
MIZORAM,2008,CHEATING,0,0,0,5,0,5,1,1,2,0,0,0,6,1,7
MIZORAM,2008,COUNTER FEITING,0,0,0,0,0,0,0,0,0,0,0,0,0,0,0
MIZORAM,2008,DOWRY DEATHS,0,0,0,0,0,0,0,0,0,0,0,0,0,0,0
MIZORAM,2008,MOLESTATION,0,0,0,0,0,0,1,0,1,0,0,0,1,0,1
MIZORAM,2008,EVE-TEASING,0,0,0,0,0,0,0,0,0,0,0,0,0,0,0
MIZORAM,2008,CRUELTY BY HUSBAND OR RELATIVE OF HUSBAND,0,0,0,0,0,0,0,0,0,0,0,0,0,0,0
MIZORAM,2008,OTHER IPC CRIMES,0,0,0,9,0,9,11,0,11,1,1,2,21,1,22
MIZORAM,2008,TOTAL IPC,0,0,0,115,1,116,85,1,86,7,1,8,207,3,210
MIZORAM,2009,MURDER,0,0,0,7,0,7,4,0,4,0,0,0,11,0,11
MIZORAM,2009,ATTEMPT TO COMMIT MURDER,0,0,0,1,0,1,0,0,0,0,0,0,1,0,1
MIZORAM,2009,C.H. NOT AMOUNTING TO MURDER,0,0,0,0,0,0,0,0,0,0,0,0,0,0,0
MIZORAM,2009,RAPE,0,0,0,15,0,15,13,0,13,2,0,2,30,0,30
MIZORAM,2009,KIDNAPPING AND ABDUCTION,0,0,0,7,0,7,4,0,4,0,0,0,11,0,11
MIZORAM,2009,DACOITY,0,0,0,0,0,0,0,0,0,0,0,0,0,0,0
MIZORAM,2009,PREP. AND ASSEMBLY FOR DACOITY,0,0,0,0,0,0,0,0,0,0,0,0,0,0,0
MIZORAM,2009,ROBBERY,0,0,0,0,0,0,0,0,0,0,0,0,0,0,0
MIZORAM,2009,BURGLARY,0,0,0,10,0,10,3,0,3,0,0,0,13,0,13
MIZORAM,2009,THEFTS,0,0,0,106,0,106,24,2,26,4,0,4,134,2,136
MIZORAM,2009,EXTORTION,0,0,0,5,0,5,2,0,2,0,0,0,7,0,7
MIZORAM,2009,RIOTS,0,0,0,0,0,0,0,0,0,0,0,0,0,0,0
MIZORAM,2009,ARSON,0,0,0,2,0,2,0,0,0,0,0,0,2,0,2
MIZORAM,2009,CRIMINAL BREACH OF TRUST,0,0,0,0,0,0,0,0,0,0,0,0,0,0,0
MIZORAM,2009,CHEATING,0,0,0,0,0,0,0,0,0,0,0,0,0,0,0
MIZORAM,2009,COUNTER FEITING,0,0,0,0,0,0,0,0,0,0,0,0,0,0,0
MIZORAM,2009,DOWRY DEATHS,0,0,0,0,0,0,0,0,0,0,0,0,0,0,0
MIZORAM,2009,MOLESTATION,0,0,0,1,0,1,1,0,1,0,0,0,2,0,2
MIZORAM,2009,EVE-TEASING,0,0,0,2,0,2,0,0,0,0,0,0,2,0,2
MIZORAM,2009,CRUELTY BY HUSBAND OR RELATIVE OF HUSBAND,0,0,0,0,0,0,0,0,0,0,0,0,0,0,0
MIZORAM,2009,OTHER IPC CRIMES,0,0,0,13,0,13,7,0,7,0,0,0,20,0,20
MIZORAM,2009,TOTAL IPC,0,0,0,169,0,169,58,2,60,6,0,6,233,2,235
MIZORAM,2010,MURDER,0,0,0,14,0,14,11,0,11,2,0,2,27,0,27
MIZORAM,2010,ATTEMPT TO COMMIT MURDER,0,0,0,5,0,5,3,0,3,0,0,0,8,0,8
MIZORAM,2010,C.H. NOT AMOUNTING TO MURDER,0,0,0,0,0,0,0,0,0,0,0,0,0,0,0
MIZORAM,2010,RAPE,0,0,0,20,0,20,25,0,25,4,0,4,49,0,49
MIZORAM,2010,KIDNAPPING AND ABDUCTION,0,0,0,3,0,3,5,0,5,0,0,0,8,0,8
MIZORAM,2010,DACOITY,0,0,0,0,0,0,0,0,0,0,0,0,0,0,0
MIZORAM,2010,PREP. AND ASSEMBLY FOR DACOITY,0,0,0,0,0,0,0,0,0,0,0,0,0,0,0
MIZORAM,2010,ROBBERY,0,0,0,0,0,0,1,0,1,0,0,0,1,0,1
MIZORAM,2010,BURGLARY,0,0,0,14,0,14,0,0,0,0,0,0,14,0,14
MIZORAM,2010,THEFTS,0,0,0,101,1,102,39,0,39,0,0,0,140,1,141
MIZORAM,2010,EXTORTION,0,0,0,0,0,0,0,0,0,0,0,0,0,0,0
MIZORAM,2010,RIOTS,0,0,0,0,0,0,0,0,0,0,0,0,0,0,0
MIZORAM,2010,ARSON,0,0,0,0,0,0,0,0,0,0,0,0,0,0,0
MIZORAM,2010,CRIMINAL BREACH OF TRUST,0,0,0,0,0,0,0,0,0,0,0,0,0,0,0
MIZORAM,2010,CHEATING,0,0,0,7,0,7,9,0,9,0,0,0,16,0,16
MIZORAM,2010,COUNTER FEITING,0,0,0,0,0,0,0,0,0,0,0,0,0,0,0
MIZORAM,2010,DOWRY DEATHS,0,0,0,0,0,0,0,0,0,0,0,0,0,0,0
MIZORAM,2010,MOLESTATION,0,0,0,0,0,0,0,0,0,1,0,1,1,0,1
MIZORAM,2010,EVE-TEASING,0,0,0,0,0,0,0,0,0,0,0,0,0,0,0
MIZORAM,2010,CRUELTY BY HUSBAND OR RELATIVE OF HUSBAND,0,0,0,0,0,0,0,0,0,0,0,0,0,0,0
MIZORAM,2010,OTHER IPC CRIMES,0,0,0,7,2,9,1,0,1,0,0,0,8,2,10
MIZORAM,2010,TOTAL IPC,0,0,0,171,3,174,94,0,94,7,0,7,272,3,275
MIZORAM,2011,MURDER,0,0,0,17,0,17,15,0,15,3,0,3,35,0,35
MIZORAM,2011,ATTEMPT TO COMMIT MURDER,0,0,0,6,1,7,5,0,5,0,0,0,11,1,12
MIZORAM,2011,C.H. NOT AMOUNTING TO MURDER,0,0,0,1,0,1,1,0,1,0,0,0,2,0,2
MIZORAM,2011,RAPE,0,0,0,14,0,14,10,0,10,12,0,12,36,0,36
MIZORAM,2011,KIDNAPPING AND ABDUCTION,0,0,0,0,0,0,0,0,0,0,0,0,0,0,0
MIZORAM,2011,DACOITY,0,0,0,0,0,0,0,0,0,0,0,0,0,0,0
MIZORAM,2011,PREP. AND ASSEMBLY FOR DACOITY,0,0,0,0,0,0,0,0,0,0,0,0,0,0,0
MIZORAM,2011,ROBBERY,0,0,0,2,0,2,2,0,2,0,0,0,4,0,4
MIZORAM,2011,BURGLARY,0,0,0,14,0,14,1,0,1,0,0,0,15,0,15
MIZORAM,2011,THEFTS,0,0,0,112,0,112,21,0,21,7,0,7,140,0,140
MIZORAM,2011,EXTORTION,0,0,0,0,0,0,0,0,0,0,0,0,0,0,0
MIZORAM,2011,RIOTS,0,0,0,0,0,0,0,0,0,0,0,0,0,0,0
MIZORAM,2011,ARSON,0,0,0,0,0,0,0,0,0,0,0,0,0,0,0
MIZORAM,2011,CRIMINAL BREACH OF TRUST,0,0,0,0,0,0,0,0,0,0,0,0,0,0,0
MIZORAM,2011,CHEATING,0,0,0,7,0,7,9,0,9,0,0,0,16,0,16
MIZORAM,2011,COUNTER FEITING,0,0,0,0,0,0,0,0,0,0,0,0,0,0,0
MIZORAM,2011,DOWRY DEATHS,0,0,0,0,0,0,0,0,0,0,0,0,0,0,0
MIZORAM,2011,MOLESTATION,0,0,0,1,0,1,0,0,0,0,0,0,1,0,1
MIZORAM,2011,EVE-TEASING,0,0,0,0,0,0,0,0,0,0,0,0,0,0,0
MIZORAM,2011,CRUELTY BY HUSBAND OR RELATIVE OF HUSBAND,0,0,0,0,0,0,0,0,0,0,0,0,0,0,0
MIZORAM,2011,OTHER IPC CRIMES,0,0,0,3,0,3,1,0,1,0,0,0,4,0,4
MIZORAM,2011,TOTAL IPC,0,0,0,177,1,178,65,0,65,22,0,22,264,1,265
MIZORAM,2012,MURDER,0,0,0,18,0,18,20,0,20,5,0,5,43,0,43
MIZORAM,2012,ATTEMPT TO COMMIT MURDER,0,0,0,3,0,3,7,0,7,0,0,0,10,0,10
MIZORAM,2012,C.H. NOT AMOUNTING TO MURDER,0,0,0,5,0,5,6,0,6,1,0,1,12,0,12
MIZORAM,2012,RAPE,0,0,0,18,0,18,36,0,36,9,0,9,63,0,63
MIZORAM,2012,KIDNAPPING AND ABDUCTION,0,0,0,0,0,0,1,0,1,0,0,0,1,0,1
MIZORAM,2012,DACOITY,0,0,0,0,0,0,0,0,0,0,0,0,0,0,0
MIZORAM,2012,PREP. AND ASSEMBLY FOR DACOITY,0,0,0,0,0,0,0,0,0,0,0,0,0,0,0
MIZORAM,2012,ROBBERY,0,0,0,1,0,1,3,0,3,0,0,0,4,0,4
MIZORAM,2012,BURGLARY,0,0,0,17,0,17,5,0,5,0,0,0,22,0,22
MIZORAM,2012,THEFTS,0,0,0,46,0,46,29,0,29,0,0,0,75,0,75
MIZORAM,2012,EXTORTION,0,0,0,1,0,1,0,0,0,0,0,0,1,0,1
MIZORAM,2012,RIOTS,0,0,0,0,0,0,0,0,0,0,0,0,0,0,0
MIZORAM,2012,ARSON,0,0,0,0,0,0,0,0,0,0,0,0,0,0,0
MIZORAM,2012,CRIMINAL BREACH OF TRUST,0,0,0,0,0,0,0,0,0,0,0,0,0,0,0
MIZORAM,2012,CHEATING,0,0,0,2,0,2,1,0,1,0,0,0,3,0,3
MIZORAM,2012,COUNTER FEITING,0,0,0,0,0,0,0,0,0,0,0,0,0,0,0
MIZORAM,2012,DOWRY DEATHS,0,0,0,0,0,0,0,0,0,0,0,0,0,0,0
MIZORAM,2012,MOLESTATION,0,0,0,1,0,1,2,0,2,0,0,0,3,0,3
MIZORAM,2012,EVE-TEASING,0,0,0,0,0,0,1,0,1,0,0,0,1,0,1
MIZORAM,2012,CRUELTY BY HUSBAND OR RELATIVE OF HUSBAND,0,0,0,0,0,0,0,0,0,0,0,0,0,0,0
MIZORAM,2012,OTHER IPC CRIMES,0,0,0,6,0,6,4,0,4,0,0,0,10,0,10
MIZORAM,2012,TOTAL IPC,0,0,0,118,0,118,115,0,115,15,0,15,248,0,248
NAGALAND,2001,MURDER,0,0,0,2,0,2,1,0,1,0,0,0,3,0,3
NAGALAND,2001,ATTEMPT TO COMMIT MURDER,0,0,0,1,0,1,3,0,3,0,0,0,4,0,4
NAGALAND,2001,C.H. NOT AMOUNTING TO MURDER,0,0,0,0,0,0,0,0,0,1,0,1,1,0,1
NAGALAND,2001,RAPE,0,0,0,2,0,2,0,0,0,0,0,0,2,0,2
NAGALAND,2001,KIDNAPPING AND ABDUCTION,0,0,0,3,0,3,2,0,2,0,0,0,5,0,5
NAGALAND,2001,DACOITY,0,0,0,3,0,3,0,0,0,0,0,0,3,0,3
NAGALAND,2001,PREP. AND ASSEMBLY FOR DACOITY,0,0,0,0,0,0,0,0,0,0,0,0,0,0,0
NAGALAND,2001,ROBBERY,0,0,0,3,0,3,4,0,4,0,0,0,7,0,7
NAGALAND,2001,BURGLARY,0,0,0,0,0,0,0,0,0,1,0,1,1,0,1
NAGALAND,2001,THEFTS,0,0,0,0,0,0,0,0,0,0,0,0,0,0,0
NAGALAND,2001,EXTORTION,0,0,0,3,0,3,6,0,6,0,0,0,9,0,9
NAGALAND,2001,RIOTS,0,0,0,0,0,0,0,0,0,0,0,0,0,0,0
NAGALAND,2001,ARSON,0,0,0,0,0,0,0,0,0,0,0,0,0,0,0
NAGALAND,2001,CRIMINAL BREACH OF TRUST,0,0,0,0,0,0,0,0,0,0,0,0,0,0,0
NAGALAND,2001,CHEATING,0,0,0,0,0,0,0,0,0,0,0,0,0,0,0
NAGALAND,2001,COUNTER FEITING,0,0,0,0,0,0,0,0,0,0,0,0,0,0,0
NAGALAND,2001,DOWRY DEATHS,0,0,0,0,0,0,0,0,0,0,0,0,0,0,0
NAGALAND,2001,MOLESTATION,0,0,0,0,0,0,0,0,0,0,0,0,0,0,0
NAGALAND,2001,EVE-TEASING,0,0,0,0,0,0,0,0,0,0,0,0,0,0,0
NAGALAND,2001,CRUELTY BY HUSBAND OR RELATIVE OF HUSBAND,0,0,0,0,0,0,0,0,0,0,0,0,0,0,0
NAGALAND,2001,OTHER IPC CRIMES,0,0,0,0,0,0,0,0,0,0,0,0,0,0,0
NAGALAND,2001,TOTAL IPC,0,0,0,17,0,17,16,0,16,2,0,2,35,0,35
NAGALAND,2002,MURDER,0,0,0,2,0,2,1,0,1,0,0,0,3,0,3
NAGALAND,2002,ATTEMPT TO COMMIT MURDER,0,0,0,1,0,1,1,0,1,0,0,0,2,0,2
NAGALAND,2002,C.H. NOT AMOUNTING TO MURDER,0,0,0,0,0,0,0,0,0,0,0,0,0,0,0
NAGALAND,2002,RAPE,0,0,0,0,0,0,0,0,0,0,0,0,0,0,0
NAGALAND,2002,KIDNAPPING AND ABDUCTION,0,0,0,1,0,1,0,0,0,0,0,0,1,0,1
NAGALAND,2002,DACOITY,0,0,0,2,0,2,0,0,0,0,0,0,2,0,2
NAGALAND,2002,PREP. AND ASSEMBLY FOR DACOITY,0,0,0,0,0,0,0,0,0,0,0,0,0,0,0
NAGALAND,2002,ROBBERY,0,0,0,2,0,2,1,0,1,0,0,0,3,0,3
NAGALAND,2002,BURGLARY,0,0,0,0,0,0,0,0,0,0,0,0,0,0,0
NAGALAND,2002,THEFTS,0,0,0,0,0,0,0,0,0,0,0,0,0,0,0
NAGALAND,2002,EXTORTION,0,0,0,1,0,1,0,0,0,3,0,3,4,0,4
NAGALAND,2002,RIOTS,0,0,0,0,0,0,0,0,0,0,0,0,0,0,0
NAGALAND,2002,ARSON,0,0,0,0,0,0,0,0,0,0,0,0,0,0,0
NAGALAND,2002,CRIMINAL BREACH OF TRUST,0,0,0,0,0,0,0,0,0,0,0,0,0,0,0
NAGALAND,2002,CHEATING,0,0,0,4,0,4,1,1,2,0,0,0,5,1,6
NAGALAND,2002,COUNTER FEITING,0,0,0,0,0,0,0,0,0,0,0,0,0,0,0
NAGALAND,2002,DOWRY DEATHS,0,0,0,0,0,0,0,0,0,0,0,0,0,0,0
NAGALAND,2002,MOLESTATION,0,0,0,0,0,0,0,0,0,0,0,0,0,0,0
NAGALAND,2002,EVE-TEASING,0,0,0,0,0,0,0,0,0,0,0,0,0,0,0
NAGALAND,2002,CRUELTY BY HUSBAND OR RELATIVE OF HUSBAND,0,0,0,0,0,0,0,0,0,0,0,0,0,0,0
NAGALAND,2002,OTHER IPC CRIMES,0,0,0,0,0,0,0,0,0,0,0,0,0,0,0
NAGALAND,2002,TOTAL IPC,0,0,0,13,0,13,4,1,5,3,0,3,20,1,21
NAGALAND,2003,MURDER,0,0,0,2,0,2,1,0,1,0,0,0,3,0,3
NAGALAND,2003,ATTEMPT TO COMMIT MURDER,0,0,0,1,0,1,1,0,1,1,0,1,3,0,3
NAGALAND,2003,C.H. NOT AMOUNTING TO MURDER,0,0,0,0,0,0,0,0,0,0,0,0,0,0,0
NAGALAND,2003,RAPE,0,0,0,0,0,0,2,0,2,0,0,0,2,0,2
NAGALAND,2003,KIDNAPPING AND ABDUCTION,0,0,0,0,0,0,3,0,3,0,0,0,3,0,3
NAGALAND,2003,DACOITY,0,0,0,14,0,14,5,0,5,0,0,0,19,0,19
NAGALAND,2003,PREP. AND ASSEMBLY FOR DACOITY,0,0,0,0,0,0,0,0,0,0,0,0,0,0,0
NAGALAND,2003,ROBBERY,0,0,0,10,0,10,3,0,3,0,0,0,13,0,13
NAGALAND,2003,BURGLARY,0,0,0,0,0,0,0,0,0,0,0,0,0,0,0
NAGALAND,2003,THEFTS,0,0,0,0,0,0,0,0,0,0,0,0,0,0,0
NAGALAND,2003,EXTORTION,0,0,0,4,0,4,4,0,4,3,0,3,11,0,11
NAGALAND,2003,RIOTS,0,0,0,1,0,1,0,0,0,0,0,0,1,0,1
NAGALAND,2003,ARSON,0,0,0,0,0,0,0,0,0,0,0,0,0,0,0
NAGALAND,2003,CRIMINAL BREACH OF TRUST,0,0,0,0,0,0,0,0,0,0,0,0,0,0,0
NAGALAND,2003,CHEATING,0,0,0,3,0,3,2,0,2,2,0,2,7,0,7
NAGALAND,2003,COUNTER FEITING,0,0,0,0,0,0,0,0,0,0,0,0,0,0,0
NAGALAND,2003,DOWRY DEATHS,0,0,0,0,0,0,0,0,0,0,0,0,0,0,0
NAGALAND,2003,MOLESTATION,0,0,0,0,0,0,0,0,0,0,0,0,0,0,0
NAGALAND,2003,EVE-TEASING,0,0,0,0,0,0,0,0,0,0,0,0,0,0,0
NAGALAND,2003,CRUELTY BY HUSBAND OR RELATIVE OF HUSBAND,0,0,0,0,0,0,0,0,0,0,0,0,0,0,0
NAGALAND,2003,OTHER IPC CRIMES,0,0,0,0,0,0,0,0,0,0,0,0,0,0,0
NAGALAND,2003,TOTAL IPC,0,0,0,35,0,35,21,0,21,6,0,6,62,0,62
NAGALAND,2004,MURDER,0,0,0,2,0,2,2,0,2,0,0,0,4,0,4
NAGALAND,2004,ATTEMPT TO COMMIT MURDER,0,0,0,1,0,1,3,0,3,2,0,2,6,0,6
NAGALAND,2004,C.H. NOT AMOUNTING TO MURDER,0,0,0,0,0,0,0,0,0,0,0,0,0,0,0
NAGALAND,2004,RAPE,0,0,0,0,0,0,2,0,2,0,0,0,2,0,2
NAGALAND,2004,KIDNAPPING AND ABDUCTION,0,0,0,0,0,0,0,0,0,0,0,0,0,0,0
NAGALAND,2004,DACOITY,0,0,0,16,0,16,8,0,8,0,0,0,24,0,24
NAGALAND,2004,PREP. AND ASSEMBLY FOR DACOITY,0,0,0,0,0,0,0,0,0,0,0,0,0,0,0
NAGALAND,2004,ROBBERY,0,0,0,10,0,10,5,0,5,0,0,0,15,0,15
NAGALAND,2004,BURGLARY,0,0,0,0,0,0,0,0,0,0,0,0,0,0,0
NAGALAND,2004,THEFTS,0,0,0,4,0,4,7,0,7,0,0,0,11,0,11
NAGALAND,2004,EXTORTION,0,0,0,7,0,7,21,0,21,7,0,7,35,0,35
NAGALAND,2004,RIOTS,0,0,0,0,0,0,0,0,0,0,0,0,0,0,0
NAGALAND,2004,ARSON,0,0,0,0,0,0,0,0,0,0,0,0,0,0,0
NAGALAND,2004,CRIMINAL BREACH OF TRUST,0,0,0,0,0,0,0,0,0,0,0,0,0,0,0
NAGALAND,2004,CHEATING,0,0,0,0,0,0,15,0,15,5,0,5,20,0,20
NAGALAND,2004,COUNTER FEITING,0,0,0,0,0,0,0,0,0,0,0,0,0,0,0
NAGALAND,2004,DOWRY DEATHS,0,0,0,0,0,0,0,0,0,0,0,0,0,0,0
NAGALAND,2004,MOLESTATION,0,0,0,0,0,0,0,0,0,0,0,0,0,0,0
NAGALAND,2004,EVE-TEASING,0,0,0,0,0,0,0,0,0,0,0,0,0,0,0
NAGALAND,2004,CRUELTY BY HUSBAND OR RELATIVE OF HUSBAND,0,0,0,0,0,0,0,0,0,0,0,0,0,0,0
NAGALAND,2004,OTHER IPC CRIMES,0,0,0,0,0,0,0,0,0,0,0,0,0,0,0
NAGALAND,2004,TOTAL IPC,0,0,0,40,0,40,63,0,63,14,0,14,117,0,117
NAGALAND,2005,MURDER,0,0,0,2,0,2,2,2,4,5,0,5,9,2,11
NAGALAND,2005,ATTEMPT TO COMMIT MURDER,0,0,0,0,0,0,3,0,3,0,0,0,3,0,3
NAGALAND,2005,C.H. NOT AMOUNTING TO MURDER,0,0,0,0,0,0,0,0,0,0,0,0,0,0,0
NAGALAND,2005,RAPE,0,0,0,1,0,1,1,0,1,0,0,0,2,0,2
NAGALAND,2005,KIDNAPPING AND ABDUCTION,0,0,0,0,0,0,0,0,0,0,0,0,0,0,0
NAGALAND,2005,DACOITY,0,0,0,0,0,0,0,0,0,0,0,0,0,0,0
NAGALAND,2005,PREP. AND ASSEMBLY FOR DACOITY,0,0,0,0,0,0,0,0,0,4,0,4,4,0,4
NAGALAND,2005,ROBBERY,0,0,0,4,0,4,10,0,10,0,0,0,14,0,14
NAGALAND,2005,BURGLARY,0,0,0,0,0,0,0,0,0,0,0,0,0,0,0
NAGALAND,2005,THEFTS,0,0,0,7,2,9,0,0,0,0,0,0,7,2,9
NAGALAND,2005,EXTORTION,0,0,0,10,0,10,15,0,15,10,0,10,35,0,35
NAGALAND,2005,RIOTS,0,0,0,0,0,0,0,0,0,0,0,0,0,0,0
NAGALAND,2005,ARSON,0,0,0,0,0,0,0,0,0,0,0,0,0,0,0
NAGALAND,2005,CRIMINAL BREACH OF TRUST,0,0,0,0,0,0,0,0,0,0,0,0,0,0,0
NAGALAND,2005,CHEATING,0,0,0,10,0,10,15,0,15,0,0,0,25,0,25
NAGALAND,2005,COUNTER FEITING,0,0,0,0,0,0,0,0,0,0,0,0,0,0,0
NAGALAND,2005,DOWRY DEATHS,0,0,0,0,0,0,0,0,0,0,0,0,0,0,0
NAGALAND,2005,MOLESTATION,0,0,0,0,0,0,0,0,0,0,0,0,0,0,0
NAGALAND,2005,EVE-TEASING,0,0,0,0,0,0,0,0,0,0,0,0,0,0,0
NAGALAND,2005,CRUELTY BY HUSBAND OR RELATIVE OF HUSBAND,0,0,0,0,0,0,0,0,0,0,0,0,0,0,0
NAGALAND,2005,OTHER IPC CRIMES,0,0,0,0,0,0,0,0,0,0,0,0,0,0,0
NAGALAND,2005,TOTAL IPC,0,0,0,34,2,36,46,2,48,19,0,19,99,4,103
NAGALAND,2006,MURDER,0,0,0,2,0,2,10,0,10,5,0,5,17,0,17
NAGALAND,2006,ATTEMPT TO COMMIT MURDER,0,0,0,3,0,3,0,2,2,0,0,0,3,2,5
NAGALAND,2006,C.H. NOT AMOUNTING TO MURDER,0,0,0,0,0,0,0,0,0,0,0,0,0,0,0
NAGALAND,2006,RAPE,0,0,0,2,0,2,2,0,2,0,0,0,4,0,4
NAGALAND,2006,KIDNAPPING AND ABDUCTION,0,0,0,0,0,0,0,0,0,0,0,0,0,0,0
NAGALAND,2006,DACOITY,0,0,0,0,0,0,0,0,0,0,0,0,0,0,0
NAGALAND,2006,PREP. AND ASSEMBLY FOR DACOITY,0,0,0,0,0,0,0,0,0,0,0,0,0,0,0
NAGALAND,2006,ROBBERY,0,0,0,0,0,0,10,0,10,0,0,0,10,0,10
NAGALAND,2006,BURGLARY,0,0,0,0,0,0,0,0,0,0,0,0,0,0,0
NAGALAND,2006,THEFTS,0,0,0,10,1,11,6,0,6,0,0,0,16,1,17
NAGALAND,2006,EXTORTION,0,0,0,10,0,10,21,0,21,0,0,0,31,0,31
NAGALAND,2006,RIOTS,0,0,0,0,0,0,0,0,0,0,0,0,0,0,0
NAGALAND,2006,ARSON,0,0,0,0,0,0,0,0,0,0,0,0,0,0,0
NAGALAND,2006,CRIMINAL BREACH OF TRUST,0,0,0,0,0,0,0,0,0,0,0,0,0,0,0
NAGALAND,2006,CHEATING,0,0,0,6,0,6,7,0,7,0,0,0,13,0,13
NAGALAND,2006,COUNTER FEITING,0,0,0,0,0,0,0,0,0,0,0,0,0,0,0
NAGALAND,2006,DOWRY DEATHS,0,0,0,0,0,0,0,0,0,0,0,0,0,0,0
NAGALAND,2006,MOLESTATION,0,0,0,0,0,0,0,0,0,0,0,0,0,0,0
NAGALAND,2006,EVE-TEASING,0,0,0,0,0,0,0,0,0,0,0,0,0,0,0
NAGALAND,2006,CRUELTY BY HUSBAND OR RELATIVE OF HUSBAND,0,0,0,0,0,0,0,0,0,0,0,0,0,0,0
NAGALAND,2006,OTHER IPC CRIMES,0,0,0,0,0,0,0,0,0,0,0,0,0,0,0
NAGALAND,2006,TOTAL IPC,0,0,0,33,1,34,56,2,58,5,0,5,94,3,97
NAGALAND,2007,MURDER,0,0,0,0,0,0,5,1,6,2,0,2,7,1,8
NAGALAND,2007,ATTEMPT TO COMMIT MURDER,0,0,0,7,0,7,4,0,4,0,0,0,11,0,11
NAGALAND,2007,C.H. NOT AMOUNTING TO MURDER,0,0,0,0,0,0,0,0,0,4,0,4,4,0,4
NAGALAND,2007,RAPE,0,0,0,3,0,3,4,0,4,0,0,0,7,0,7
NAGALAND,2007,KIDNAPPING AND ABDUCTION,0,0,0,3,0,3,0,0,0,0,0,0,3,0,3
NAGALAND,2007,DACOITY,0,0,0,0,0,0,0,0,0,0,0,0,0,0,0
NAGALAND,2007,PREP. AND ASSEMBLY FOR DACOITY,0,0,0,0,0,0,0,0,0,0,0,0,0,0,0
NAGALAND,2007,ROBBERY,0,0,0,0,0,0,0,0,0,0,0,0,0,0,0
NAGALAND,2007,BURGLARY,0,0,0,0,0,0,0,0,0,0,0,0,0,0,0
NAGALAND,2007,THEFTS,1,0,1,1,0,1,5,0,5,3,0,3,10,0,10
NAGALAND,2007,EXTORTION,0,0,0,8,0,8,7,1,8,0,0,0,15,1,16
NAGALAND,2007,RIOTS,0,0,0,0,0,0,0,0,0,0,0,0,0,0,0
NAGALAND,2007,ARSON,0,0,0,0,0,0,0,0,0,0,0,0,0,0,0
NAGALAND,2007,CRIMINAL BREACH OF TRUST,0,0,0,0,0,0,0,0,0,0,0,0,0,0,0
NAGALAND,2007,CHEATING,0,0,0,2,0,2,0,0,0,0,0,0,2,0,2
NAGALAND,2007,COUNTER FEITING,0,0,0,0,0,0,0,0,0,0,0,0,0,0,0
NAGALAND,2007,DOWRY DEATHS,0,0,0,0,0,0,0,0,0,0,0,0,0,0,0
NAGALAND,2007,MOLESTATION,0,0,0,0,0,0,0,0,0,0,0,0,0,0,0
NAGALAND,2007,EVE-TEASING,0,0,0,0,0,0,0,0,0,0,0,0,0,0,0
NAGALAND,2007,CRUELTY BY HUSBAND OR RELATIVE OF HUSBAND,0,0,0,0,0,0,0,0,0,0,0,0,0,0,0
NAGALAND,2007,OTHER IPC CRIMES,0,0,0,0,0,0,0,0,0,0,0,0,0,0,0
NAGALAND,2007,TOTAL IPC,1,0,1,24,0,24,25,2,27,9,0,9,59,2,61
NAGALAND,2008,MURDER,0,0,0,0,0,0,5,1,6,2,0,2,7,1,8
NAGALAND,2008,ATTEMPT TO COMMIT MURDER,0,0,0,7,0,7,4,0,4,0,0,0,11,0,11
NAGALAND,2008,C.H. NOT AMOUNTING TO MURDER,0,0,0,0,0,0,0,0,0,4,0,4,4,0,4
NAGALAND,2008,RAPE,0,0,0,2,0,2,1,0,1,2,0,2,5,0,5
NAGALAND,2008,KIDNAPPING AND ABDUCTION,0,0,0,0,0,0,7,0,7,0,0,0,7,0,7
NAGALAND,2008,DACOITY,0,0,0,0,0,0,0,0,0,0,0,0,0,0,0
NAGALAND,2008,PREP. AND ASSEMBLY FOR DACOITY,0,0,0,0,0,0,0,0,0,0,0,0,0,0,0
NAGALAND,2008,ROBBERY,0,0,0,0,0,0,10,0,10,0,0,0,10,0,10
NAGALAND,2008,BURGLARY,0,0,0,0,0,0,0,0,0,0,0,0,0,0,0
NAGALAND,2008,THEFTS,0,0,0,7,0,7,10,0,10,0,0,0,17,0,17
NAGALAND,2008,EXTORTION,0,0,0,17,1,18,8,0,8,10,0,10,35,1,36
NAGALAND,2008,RIOTS,0,0,0,4,0,4,0,0,0,4,0,4,8,0,8
NAGALAND,2008,ARSON,0,0,0,0,0,0,0,0,0,0,0,0,0,0,0
NAGALAND,2008,CRIMINAL BREACH OF TRUST,0,0,0,0,0,0,0,0,0,0,0,0,0,0,0
NAGALAND,2008,CHEATING,0,0,0,0,0,0,0,0,0,0,0,0,0,0,0
NAGALAND,2008,COUNTER FEITING,0,0,0,0,0,0,0,0,0,0,0,0,0,0,0
NAGALAND,2008,DOWRY DEATHS,0,0,0,0,0,0,0,0,0,0,0,0,0,0,0
NAGALAND,2008,MOLESTATION,0,0,0,0,0,0,0,0,0,0,0,0,0,0,0
NAGALAND,2008,EVE-TEASING,0,0,0,0,0,0,0,0,0,0,0,0,0,0,0
NAGALAND,2008,CRUELTY BY HUSBAND OR RELATIVE OF HUSBAND,0,0,0,0,0,0,0,0,0,0,0,0,0,0,0
NAGALAND,2008,OTHER IPC CRIMES,0,0,0,0,0,0,0,0,0,6,0,6,6,0,6
NAGALAND,2008,TOTAL IPC,0,0,0,37,1,38,45,1,46,28,0,28,110,2,112
NAGALAND,2009,MURDER,0,0,0,5,0,5,9,0,9,1,0,1,15,0,15
NAGALAND,2009,ATTEMPT TO COMMIT MURDER,0,0,0,2,0,2,5,2,7,0,0,0,7,2,9
NAGALAND,2009,C.H. NOT AMOUNTING TO MURDER,0,0,0,4,0,4,0,0,0,0,0,0,4,0,4
NAGALAND,2009,RAPE,0,0,0,2,0,2,3,0,3,1,0,1,6,0,6
NAGALAND,2009,KIDNAPPING AND ABDUCTION,0,0,0,2,0,2,4,0,4,0,0,0,6,0,6
NAGALAND,2009,DACOITY,0,0,0,0,0,0,0,0,0,0,0,0,0,0,0
NAGALAND,2009,PREP. AND ASSEMBLY FOR DACOITY,0,0,0,1,0,1,2,0,2,0,0,0,3,0,3
NAGALAND,2009,ROBBERY,0,0,0,4,0,4,3,0,3,0,0,0,7,0,7
NAGALAND,2009,BURGLARY,0,0,0,2,0,2,2,0,2,0,0,0,4,0,4
NAGALAND,2009,THEFTS,0,0,0,16,0,16,19,0,19,4,0,4,39,0,39
NAGALAND,2009,EXTORTION,0,0,0,8,0,8,11,0,11,2,0,2,21,0,21
NAGALAND,2009,RIOTS,0,0,0,0,0,0,0,0,0,0,0,0,0,0,0
NAGALAND,2009,ARSON,0,0,0,0,0,0,0,0,0,0,0,0,0,0,0
NAGALAND,2009,CRIMINAL BREACH OF TRUST,0,0,0,0,0,0,0,0,0,0,0,0,0,0,0
NAGALAND,2009,CHEATING,0,0,0,1,0,1,2,0,2,0,0,0,3,0,3
NAGALAND,2009,COUNTER FEITING,0,0,0,0,0,0,0,0,0,0,0,0,0,0,0
NAGALAND,2009,DOWRY DEATHS,0,0,0,0,0,0,0,0,0,0,0,0,0,0,0
NAGALAND,2009,MOLESTATION,0,0,0,0,0,0,2,0,2,0,0,0,2,0,2
NAGALAND,2009,EVE-TEASING,0,0,0,0,0,0,0,0,0,0,0,0,0,0,0
NAGALAND,2009,CRUELTY BY HUSBAND OR RELATIVE OF HUSBAND,0,0,0,0,0,0,0,0,0,0,0,0,0,0,0
NAGALAND,2009,OTHER IPC CRIMES,0,0,0,2,0,2,3,0,3,2,0,2,7,0,7
NAGALAND,2009,TOTAL IPC,0,0,0,49,0,49,65,2,67,10,0,10,124,2,126
NAGALAND,2010,MURDER,0,0,0,5,0,5,2,0,2,2,0,2,9,0,9
NAGALAND,2010,ATTEMPT TO COMMIT MURDER,0,0,0,4,0,4,1,0,1,1,0,1,6,0,6
NAGALAND,2010,C.H. NOT AMOUNTING TO MURDER,0,0,0,3,0,3,2,0,2,0,0,0,5,0,5
NAGALAND,2010,RAPE,0,0,0,8,0,8,2,0,2,1,0,1,11,0,11
NAGALAND,2010,KIDNAPPING AND ABDUCTION,0,0,0,4,0,4,3,0,3,2,0,2,9,0,9
NAGALAND,2010,DACOITY,0,0,0,0,0,0,2,0,2,0,0,0,2,0,2
NAGALAND,2010,PREP. AND ASSEMBLY FOR DACOITY,0,0,0,0,0,0,0,0,0,0,0,0,0,0,0
NAGALAND,2010,ROBBERY,0,0,0,4,0,4,3,0,3,2,0,2,9,0,9
NAGALAND,2010,BURGLARY,0,0,0,2,0,2,2,0,2,0,0,0,4,0,4
NAGALAND,2010,THEFTS,0,0,0,7,0,7,3,0,3,3,0,3,13,0,13
NAGALAND,2010,EXTORTION,0,0,0,8,0,8,3,0,3,3,0,3,14,0,14
NAGALAND,2010,RIOTS,0,0,0,0,0,0,0,0,0,0,0,0,0,0,0
NAGALAND,2010,ARSON,0,0,0,0,0,0,0,0,0,0,0,0,0,0,0
NAGALAND,2010,CRIMINAL BREACH OF TRUST,0,0,0,0,0,0,0,0,0,0,0,0,0,0,0
NAGALAND,2010,CHEATING,0,0,0,5,0,5,3,0,3,4,0,4,12,0,12
NAGALAND,2010,COUNTER FEITING,0,0,0,0,0,0,0,0,0,0,0,0,0,0,0
NAGALAND,2010,DOWRY DEATHS,0,0,0,0,0,0,0,0,0,0,0,0,0,0,0
NAGALAND,2010,MOLESTATION,0,0,0,2,0,2,2,0,2,1,0,1,5,0,5
NAGALAND,2010,EVE-TEASING,0,0,0,0,0,0,0,0,0,0,0,0,0,0,0
NAGALAND,2010,CRUELTY BY HUSBAND OR RELATIVE OF HUSBAND,0,0,0,0,1,1,0,0,0,0,0,0,0,1,1
NAGALAND,2010,OTHER IPC CRIMES,0,0,0,6,0,6,2,0,2,2,0,2,10,0,10
NAGALAND,2010,TOTAL IPC,0,0,0,58,1,59,30,0,30,21,0,21,109,1,110
NAGALAND,2011,MURDER,0,0,0,20,0,20,15,5,20,4,0,4,39,5,44
NAGALAND,2011,ATTEMPT TO COMMIT MURDER,0,0,0,3,0,3,2,0,2,0,0,0,5,0,5
NAGALAND,2011,C.H. NOT AMOUNTING TO MURDER,0,0,0,1,0,1,0,0,0,0,0,0,1,0,1
NAGALAND,2011,RAPE,0,0,0,7,0,7,2,0,2,1,0,1,10,0,10
NAGALAND,2011,KIDNAPPING AND ABDUCTION,0,0,0,2,0,2,2,0,2,0,0,0,4,0,4
NAGALAND,2011,DACOITY,0,0,0,0,0,0,0,0,0,0,0,0,0,0,0
NAGALAND,2011,PREP. AND ASSEMBLY FOR DACOITY,0,0,0,0,0,0,0,0,0,0,0,0,0,0,0
NAGALAND,2011,ROBBERY,0,0,0,3,0,3,0,0,0,0,0,0,3,0,3
NAGALAND,2011,BURGLARY,0,0,0,2,0,2,1,0,1,0,0,0,3,0,3
NAGALAND,2011,THEFTS,0,0,0,16,0,16,10,0,10,0,0,0,26,0,26
NAGALAND,2011,EXTORTION,0,0,0,1,0,1,1,0,1,0,0,0,2,0,2
NAGALAND,2011,RIOTS,0,0,0,0,0,0,0,0,0,0,0,0,0,0,0
NAGALAND,2011,ARSON,0,0,0,0,0,0,0,0,0,0,0,0,0,0,0
NAGALAND,2011,CRIMINAL BREACH OF TRUST,0,0,0,0,0,0,0,0,0,0,0,0,0,0,0
NAGALAND,2011,CHEATING,0,0,0,0,0,0,0,0,0,0,0,0,0,0,0
NAGALAND,2011,COUNTER FEITING,0,0,0,0,0,0,0,0,0,0,0,0,0,0,0
NAGALAND,2011,DOWRY DEATHS,0,0,0,0,0,0,0,0,0,0,0,0,0,0,0
NAGALAND,2011,MOLESTATION,0,0,0,0,0,0,0,0,0,0,0,0,0,0,0
NAGALAND,2011,EVE-TEASING,0,0,0,0,0,0,0,0,0,0,0,0,0,0,0
NAGALAND,2011,CRUELTY BY HUSBAND OR RELATIVE OF HUSBAND,0,0,0,0,0,0,0,0,0,0,0,0,0,0,0
NAGALAND,2011,OTHER IPC CRIMES,0,0,0,6,0,6,6,0,6,0,0,0,12,0,12
NAGALAND,2011,TOTAL IPC,0,0,0,61,0,61,39,5,44,5,0,5,105,5,110
NAGALAND,2012,MURDER,0,0,0,11,0,11,17,2,19,3,0,3,31,2,33
NAGALAND,2012,ATTEMPT TO COMMIT MURDER,0,0,0,2,1,3,2,0,2,0,0,0,4,1,5
NAGALAND,2012,C.H. NOT AMOUNTING TO MURDER,0,0,0,2,0,2,1,0,1,0,0,0,3,0,3
NAGALAND,2012,RAPE,0,0,0,5,0,5,5,0,5,0,0,0,10,0,10
NAGALAND,2012,KIDNAPPING AND ABDUCTION,0,0,0,2,0,2,0,0,0,0,0,0,2,0,2
NAGALAND,2012,DACOITY,0,0,0,0,0,0,0,0,0,0,0,0,0,0,0
NAGALAND,2012,PREP. AND ASSEMBLY FOR DACOITY,0,0,0,0,0,0,0,0,0,0,0,0,0,0,0
NAGALAND,2012,ROBBERY,0,0,0,2,0,2,0,0,0,1,0,1,3,0,3
NAGALAND,2012,BURGLARY,0,0,0,7,0,7,1,0,1,0,0,0,8,0,8
NAGALAND,2012,THEFTS,0,0,0,13,0,13,2,0,2,0,0,0,15,0,15
NAGALAND,2012,EXTORTION,0,0,0,2,0,2,2,0,2,0,0,0,4,0,4
NAGALAND,2012,RIOTS,0,0,0,0,0,0,0,0,0,0,0,0,0,0,0
NAGALAND,2012,ARSON,0,0,0,0,0,0,0,0,0,0,0,0,0,0,0
NAGALAND,2012,CRIMINAL BREACH OF TRUST,0,0,0,0,0,0,0,0,0,0,0,0,0,0,0
NAGALAND,2012,CHEATING,0,0,0,3,0,3,0,0,0,0,0,0,3,0,3
NAGALAND,2012,COUNTER FEITING,0,0,0,0,0,0,0,0,0,0,0,0,0,0,0
NAGALAND,2012,DOWRY DEATHS,0,0,0,0,0,0,0,0,0,0,0,0,0,0,0
NAGALAND,2012,MOLESTATION,0,0,0,0,0,0,1,0,1,0,0,0,1,0,1
NAGALAND,2012,EVE-TEASING,0,0,0,0,0,0,0,0,0,0,0,0,0,0,0
NAGALAND,2012,CRUELTY BY HUSBAND OR RELATIVE OF HUSBAND,0,0,0,0,0,0,1,0,1,0,0,0,1,0,1
NAGALAND,2012,OTHER IPC CRIMES,0,0,0,21,0,21,7,0,7,1,0,1,29,0,29
NAGALAND,2012,TOTAL IPC,0,0,0,70,1,71,39,2,41,5,0,5,114,3,117
ORISSA,2001,MURDER,3,0,3,367,8,375,1023,18,1041,239,7,246,1632,33,1665
ORISSA,2001,ATTEMPT TO COMMIT MURDER,0,0,0,70,1,71,40,0,40,7,0,7,117,1,118
ORISSA,2001,C.H. NOT AMOUNTING TO MURDER,0,0,0,24,1,25,20,2,22,1,2,3,45,5,50
ORISSA,2001,RAPE,0,0,0,81,0,81,70,0,70,10,0,10,161,0,161
ORISSA,2001,KIDNAPPING AND ABDUCTION,0,0,0,5,1,6,16,0,16,2,0,2,23,1,24
ORISSA,2001,DACOITY,0,0,0,29,0,29,33,0,33,8,0,8,70,0,70
ORISSA,2001,PREP. AND ASSEMBLY FOR DACOITY,0,0,0,12,0,12,9,6,15,4,0,4,25,6,31
ORISSA,2001,ROBBERY,0,0,0,27,0,27,15,0,15,3,0,3,45,0,45
ORISSA,2001,BURGLARY,0,0,0,13,0,13,23,0,23,5,0,5,41,0,41
ORISSA,2001,THEFTS,2,0,2,75,0,75,42,0,42,4,0,4,123,0,123
ORISSA,2001,EXTORTION,0,0,0,5,0,5,0,0,0,0,0,0,5,0,5
ORISSA,2001,RIOTS,0,0,0,22,0,22,12,0,12,3,0,3,37,0,37
ORISSA,2001,ARSON,0,0,0,4,0,4,4,0,4,0,0,0,8,0,8
ORISSA,2001,CRIMINAL BREACH OF TRUST,0,0,0,29,0,29,36,0,36,39,0,39,104,0,104
ORISSA,2001,CHEATING,0,0,0,5,1,6,12,0,12,0,0,0,17,1,18
ORISSA,2001,COUNTER FEITING,0,0,0,1,0,1,0,0,0,0,0,0,1,0,1
ORISSA,2001,DOWRY DEATHS,0,0,0,6,0,6,25,0,25,8,1,9,39,1,40
ORISSA,2001,MOLESTATION,0,0,0,3,0,3,12,0,12,0,0,0,15,0,15
ORISSA,2001,EVE-TEASING,0,0,0,1,0,1,0,0,0,0,0,0,1,0,1
ORISSA,2001,CRUELTY BY HUSBAND OR RELATIVE OF HUSBAND,0,0,0,3,0,3,19,0,19,0,0,0,22,0,22
ORISSA,2001,OTHER IPC CRIMES,0,0,0,35,0,35,17,0,17,7,3,10,59,3,62
ORISSA,2001,TOTAL IPC,5,0,5,817,12,829,1428,26,1454,340,13,353,2590,51,2641
ORISSA,2002,MURDER,3,0,3,504,6,510,986,15,1001,351,9,360,1844,30,1874
ORISSA,2002,ATTEMPT TO COMMIT MURDER,3,0,3,81,1,82,57,1,58,17,1,18,158,3,161
ORISSA,2002,C.H. NOT AMOUNTING TO MURDER,0,0,0,10,0,10,25,0,25,15,0,15,50,0,50
ORISSA,2002,RAPE,0,0,0,52,0,52,63,0,63,8,0,8,123,0,123
ORISSA,2002,KIDNAPPING AND ABDUCTION,0,0,0,9,0,9,8,0,8,4,0,4,21,0,21
ORISSA,2002,DACOITY,0,0,0,23,0,23,27,0,27,18,0,18,68,0,68
ORISSA,2002,PREP. AND ASSEMBLY FOR DACOITY,0,0,0,9,0,9,1,0,1,3,0,3,13,0,13
ORISSA,2002,ROBBERY,0,0,0,22,0,22,11,0,11,12,0,12,45,0,45
ORISSA,2002,BURGLARY,0,0,0,18,0,18,16,0,16,0,0,0,34,0,34
ORISSA,2002,THEFTS,0,0,0,97,2,99,51,7,58,43,1,44,191,10,201
ORISSA,2002,EXTORTION,0,0,0,3,0,3,2,0,2,1,0,1,6,0,6
ORISSA,2002,RIOTS,0,0,0,11,0,11,27,0,27,9,0,9,47,0,47
ORISSA,2002,ARSON,0,0,0,3,0,3,2,0,2,0,0,0,5,0,5
ORISSA,2002,CRIMINAL BREACH OF TRUST,0,0,0,4,0,4,2,0,2,1,0,1,7,0,7
ORISSA,2002,CHEATING,0,0,0,5,0,5,10,0,10,14,0,14,29,0,29
ORISSA,2002,COUNTER FEITING,0,0,0,0,0,0,10,0,10,0,0,0,10,0,10
ORISSA,2002,DOWRY DEATHS,0,0,0,16,0,16,19,2,21,12,0,12,47,2,49
ORISSA,2002,MOLESTATION,0,0,0,2,0,2,5,0,5,0,0,0,7,0,7
ORISSA,2002,EVE-TEASING,0,0,0,0,0,0,0,0,0,0,0,0,0,0,0
ORISSA,2002,CRUELTY BY HUSBAND OR RELATIVE OF HUSBAND,0,0,0,6,0,6,16,0,16,0,0,0,22,0,22
ORISSA,2002,OTHER IPC CRIMES,0,0,0,31,0,31,17,2,19,31,1,32,79,3,82
ORISSA,2002,TOTAL IPC,6,0,6,906,9,915,1355,27,1382,539,12,551,2806,48,2854
ORISSA,2003,MURDER,3,0,3,531,8,539,1006,24,1030,324,8,332,1864,40,1904
ORISSA,2003,ATTEMPT TO COMMIT MURDER,0,0,0,73,2,75,81,2,83,22,2,24,176,6,182
ORISSA,2003,C.H. NOT AMOUNTING TO MURDER,0,0,0,12,0,12,28,0,28,13,0,13,53,0,53
ORISSA,2003,RAPE,0,0,0,47,0,47,94,0,94,10,0,10,151,0,151
ORISSA,2003,KIDNAPPING AND ABDUCTION,0,0,0,8,0,8,13,0,13,5,0,5,26,0,26
ORISSA,2003,DACOITY,0,0,0,24,0,24,48,0,48,18,0,18,90,0,90
ORISSA,2003,PREP. AND ASSEMBLY FOR DACOITY,0,0,0,11,0,11,7,0,7,4,0,4,22,0,22
ORISSA,2003,ROBBERY,0,0,0,29,0,29,21,0,21,14,0,14,64,0,64
ORISSA,2003,BURGLARY,0,0,0,16,0,16,36,0,36,0,0,0,52,0,52
ORISSA,2003,THEFTS,1,0,1,56,3,59,124,13,137,48,0,48,229,16,245
ORISSA,2003,EXTORTION,0,0,0,3,0,3,7,0,7,0,0,0,10,0,10
ORISSA,2003,RIOTS,0,0,0,10,0,10,51,0,51,8,0,8,69,0,69
ORISSA,2003,ARSON,0,0,0,2,0,2,13,0,13,0,0,0,15,0,15
ORISSA,2003,CRIMINAL BREACH OF TRUST,0,0,0,2,0,2,7,0,7,0,0,0,9,0,9
ORISSA,2003,CHEATING,0,0,0,5,0,5,22,0,22,15,0,15,42,0,42
ORISSA,2003,COUNTER FEITING,0,0,0,0,0,0,3,0,3,0,0,0,3,0,3
ORISSA,2003,DOWRY DEATHS,0,0,0,18,0,18,25,0,25,18,0,18,61,0,61
ORISSA,2003,MOLESTATION,0,0,0,1,0,1,4,0,4,0,0,0,5,0,5
ORISSA,2003,EVE-TEASING,0,0,0,0,0,0,0,0,0,0,0,0,0,0,0
ORISSA,2003,CRUELTY BY HUSBAND OR RELATIVE OF HUSBAND,0,0,0,8,0,8,33,0,33,0,0,0,41,0,41
ORISSA,2003,OTHER IPC CRIMES,0,0,0,24,0,24,41,0,41,21,0,21,86,0,86
ORISSA,2003,TOTAL IPC,4,0,4,880,13,893,1664,39,1703,520,10,530,3068,62,3130
ORISSA,2004,MURDER,4,0,4,722,3,725,1301,33,1334,284,8,292,2311,44,2355
ORISSA,2004,ATTEMPT TO COMMIT MURDER,0,0,0,46,0,46,72,0,72,11,1,12,129,1,130
ORISSA,2004,C.H. NOT AMOUNTING TO MURDER,0,0,0,53,1,54,67,6,73,13,0,13,133,7,140
ORISSA,2004,RAPE,0,0,0,116,0,116,60,0,60,12,0,12,188,0,188
ORISSA,2004,KIDNAPPING AND ABDUCTION,0,0,0,30,0,30,9,1,10,5,0,5,44,1,45
ORISSA,2004,DACOITY,0,0,0,91,1,92,39,0,39,4,0,4,134,1,135
ORISSA,2004,PREP. AND ASSEMBLY FOR DACOITY,0,0,0,21,0,21,7,1,8,9,0,9,37,1,38
ORISSA,2004,ROBBERY,0,0,0,37,0,37,35,0,35,2,0,2,74,0,74
ORISSA,2004,BURGLARY,0,0,0,46,1,47,11,1,12,0,0,0,57,2,59
ORISSA,2004,THEFTS,0,0,0,87,1,88,37,0,37,2,0,2,126,1,127
ORISSA,2004,EXTORTION,0,0,0,4,0,4,0,0,0,0,0,0,4,0,4
ORISSA,2004,RIOTS,0,0,0,7,0,7,10,0,10,2,0,2,19,0,19
ORISSA,2004,ARSON,0,0,0,6,0,6,1,0,1,0,0,0,7,0,7
ORISSA,2004,CRIMINAL BREACH OF TRUST,0,0,0,7,0,7,1,0,1,0,0,0,8,0,8
ORISSA,2004,CHEATING,0,0,0,34,0,34,10,0,10,0,0,0,44,0,44
ORISSA,2004,COUNTER FEITING,0,0,0,0,0,0,0,0,0,0,0,0,0,0,0
ORISSA,2004,DOWRY DEATHS,0,0,0,23,0,23,35,4,39,3,0,3,61,4,65
ORISSA,2004,MOLESTATION,0,0,0,7,0,7,7,0,7,0,0,0,14,0,14
ORISSA,2004,EVE-TEASING,0,0,0,5,0,5,2,0,2,0,0,0,7,0,7
ORISSA,2004,CRUELTY BY HUSBAND OR RELATIVE OF HUSBAND,0,0,0,13,0,13,4,0,4,0,0,0,17,0,17
ORISSA,2004,OTHER IPC CRIMES,0,0,0,35,2,37,47,0,47,11,0,11,93,2,95
ORISSA,2004,TOTAL IPC,4,0,4,1390,9,1399,1755,46,1801,358,9,367,3507,64,3571
ORISSA,2005,MURDER,0,0,0,668,6,674,1411,41,1452,349,19,368,2428,66,2494
ORISSA,2005,ATTEMPT TO COMMIT MURDER,0,0,0,160,1,161,185,0,185,97,0,97,442,1,443
ORISSA,2005,C.H. NOT AMOUNTING TO MURDER,0,0,0,88,1,89,42,3,45,31,0,31,161,4,165
ORISSA,2005,RAPE,0,0,0,140,0,140,46,0,46,12,0,12,198,0,198
ORISSA,2005,KIDNAPPING AND ABDUCTION,0,0,0,16,2,18,6,1,7,0,0,0,22,3,25
ORISSA,2005,DACOITY,0,0,0,96,0,96,87,0,87,12,0,12,195,0,195
ORISSA,2005,PREP. AND ASSEMBLY FOR DACOITY,0,0,0,1,0,1,2,0,2,0,0,0,3,0,3
ORISSA,2005,ROBBERY,0,0,0,29,0,29,18,0,18,0,0,0,47,0,47
ORISSA,2005,BURGLARY,0,0,0,39,0,39,18,0,18,4,0,4,61,0,61
ORISSA,2005,THEFTS,0,0,0,47,0,47,62,0,62,14,0,14,123,0,123
ORISSA,2005,EXTORTION,0,0,0,0,0,0,3,0,3,5,0,5,8,0,8
ORISSA,2005,RIOTS,0,0,0,0,0,0,7,0,7,0,0,0,7,0,7
ORISSA,2005,ARSON,0,0,0,3,0,3,4,0,4,0,0,0,7,0,7
ORISSA,2005,CRIMINAL BREACH OF TRUST,0,0,0,0,0,0,5,0,5,0,0,0,5,0,5
ORISSA,2005,CHEATING,0,0,0,2,0,2,1,0,1,0,0,0,3,0,3
ORISSA,2005,COUNTER FEITING,0,0,0,0,0,0,1,0,1,0,0,0,1,0,1
ORISSA,2005,DOWRY DEATHS,0,0,0,34,0,34,30,2,32,33,2,35,97,4,101
ORISSA,2005,MOLESTATION,0,0,0,12,0,12,13,0,13,1,0,1,26,0,26
ORISSA,2005,EVE-TEASING,0,0,0,1,0,1,0,0,0,0,0,0,1,0,1
ORISSA,2005,CRUELTY BY HUSBAND OR RELATIVE OF HUSBAND,0,0,0,8,1,9,2,0,2,0,0,0,10,1,11
ORISSA,2005,OTHER IPC CRIMES,0,0,0,48,1,49,41,2,43,27,0,27,116,3,119
ORISSA,2005,TOTAL IPC,0,0,0,1392,12,1404,1984,49,2033,585,21,606,3961,82,4043
ORISSA,2006,MURDER,0,0,0,757,11,768,1502,42,1544,371,10,381,2630,63,2693
ORISSA,2006,ATTEMPT TO COMMIT MURDER,0,0,0,145,1,146,178,0,178,84,0,84,407,1,408
ORISSA,2006,C.H. NOT AMOUNTING TO MURDER,0,0,0,92,1,93,41,2,43,28,0,28,161,3,164
ORISSA,2006,RAPE,0,0,0,153,0,153,62,0,62,12,0,12,227,0,227
ORISSA,2006,KIDNAPPING AND ABDUCTION,0,0,0,10,1,11,8,0,8,5,0,5,23,1,24
ORISSA,2006,DACOITY,0,0,0,103,0,103,79,0,79,5,0,5,187,0,187
ORISSA,2006,PREP. AND ASSEMBLY FOR DACOITY,0,0,0,1,0,1,1,0,1,0,0,0,2,0,2
ORISSA,2006,ROBBERY,0,0,0,36,0,36,22,0,22,0,0,0,58,0,58
ORISSA,2006,BURGLARY,0,0,0,45,0,45,13,0,13,2,0,2,60,0,60
ORISSA,2006,THEFTS,0,0,0,68,0,68,74,0,74,8,0,8,150,0,150
ORISSA,2006,EXTORTION,0,0,0,0,0,0,3,0,3,0,0,0,3,0,3
ORISSA,2006,RIOTS,0,0,0,0,0,0,2,0,2,0,0,0,2,0,2
ORISSA,2006,ARSON,0,0,0,2,0,2,2,0,2,0,0,0,4,0,4
ORISSA,2006,CRIMINAL BREACH OF TRUST,0,0,0,0,0,0,4,0,4,0,0,0,4,0,4
ORISSA,2006,CHEATING,0,0,0,2,0,2,1,0,1,0,0,0,3,0,3
ORISSA,2006,COUNTER FEITING,0,0,0,0,0,0,0,0,0,0,0,0,0,0,0
ORISSA,2006,DOWRY DEATHS,0,0,0,18,0,18,25,2,27,1,0,1,44,2,46
ORISSA,2006,MOLESTATION,0,0,0,10,0,10,13,0,13,1,0,1,24,0,24
ORISSA,2006,EVE-TEASING,0,0,0,0,0,0,0,0,0,0,0,0,0,0,0
ORISSA,2006,CRUELTY BY HUSBAND OR RELATIVE OF HUSBAND,0,0,0,12,1,13,16,2,18,5,0,5,33,3,36
ORISSA,2006,OTHER IPC CRIMES,0,0,0,31,5,36,52,8,60,18,1,19,101,14,115
ORISSA,2006,TOTAL IPC,0,0,0,1485,20,1505,2098,56,2154,540,11,551,4123,87,4210
ORISSA,2007,MURDER,0,0,0,778,12,790,1475,48,1523,395,10,405,2648,70,2718
ORISSA,2007,ATTEMPT TO COMMIT MURDER,0,0,0,148,1,149,151,0,151,84,0,84,383,1,384
ORISSA,2007,C.H. NOT AMOUNTING TO MURDER,0,0,0,95,1,96,40,6,46,28,0,28,163,7,170
ORISSA,2007,RAPE,0,0,0,160,0,160,59,0,59,14,0,14,233,0,233
ORISSA,2007,KIDNAPPING AND ABDUCTION,0,0,0,11,0,11,5,0,5,5,0,5,21,0,21
ORISSA,2007,DACOITY,0,0,0,113,0,113,68,0,68,6,0,6,187,0,187
ORISSA,2007,PREP. AND ASSEMBLY FOR DACOITY,0,0,0,1,0,1,1,0,1,0,0,0,2,0,2
ORISSA,2007,ROBBERY,0,0,0,40,0,40,20,0,20,0,0,0,60,0,60
ORISSA,2007,BURGLARY,0,0,0,44,0,44,13,0,13,2,0,2,59,0,59
ORISSA,2007,THEFTS,0,0,0,76,0,76,62,0,62,12,0,12,150,0,150
ORISSA,2007,EXTORTION,0,0,0,0,0,0,3,0,3,0,0,0,3,0,3
ORISSA,2007,RIOTS,0,0,0,0,0,0,2,0,2,0,0,0,2,0,2
ORISSA,2007,ARSON,0,0,0,2,0,2,2,0,2,0,0,0,4,0,4
ORISSA,2007,CRIMINAL BREACH OF TRUST,0,0,0,0,0,0,4,0,4,0,0,0,4,0,4
ORISSA,2007,CHEATING,0,0,0,3,0,3,1,0,1,0,0,0,4,0,4
ORISSA,2007,COUNTER FEITING,0,0,0,0,0,0,0,0,0,0,0,0,0,0,0
ORISSA,2007,DOWRY DEATHS,0,0,0,19,0,19,28,2,30,2,0,2,49,2,51
ORISSA,2007,MOLESTATION,0,0,0,10,0,10,8,0,8,1,0,1,19,0,19
ORISSA,2007,EVE-TEASING,0,0,0,0,0,0,0,0,0,0,0,0,0,0,0
ORISSA,2007,CRUELTY BY HUSBAND OR RELATIVE OF HUSBAND,0,0,0,15,1,16,18,6,24,8,0,8,41,7,48
ORISSA,2007,OTHER IPC CRIMES,0,0,0,32,1,33,22,10,32,18,1,19,72,12,84
ORISSA,2007,TOTAL IPC,0,0,0,1547,16,1563,1982,72,2054,575,11,586,4104,99,4203
ORISSA,2008,MURDER,0,0,0,775,17,792,1467,49,1516,382,10,392,2624,76,2700
ORISSA,2008,ATTEMPT TO COMMIT MURDER,0,0,0,146,2,148,148,2,150,82,0,82,376,4,380
ORISSA,2008,C.H. NOT AMOUNTING TO MURDER,0,0,0,93,1,94,40,5,45,26,0,26,159,6,165
ORISSA,2008,RAPE,0,0,0,159,0,159,57,0,57,14,0,14,230,0,230
ORISSA,2008,KIDNAPPING AND ABDUCTION,0,0,0,10,0,10,5,0,5,5,0,5,20,0,20
ORISSA,2008,DACOITY,0,0,0,112,0,112,62,0,62,6,0,6,180,0,180
ORISSA,2008,PREP. AND ASSEMBLY FOR DACOITY,0,0,0,1,0,1,1,0,1,0,0,0,2,0,2
ORISSA,2008,ROBBERY,0,0,0,38,0,38,20,0,20,0,0,0,58,0,58
ORISSA,2008,BURGLARY,0,0,0,43,0,43,13,0,13,2,0,2,58,0,58
ORISSA,2008,THEFTS,0,0,0,75,2,77,60,8,68,11,2,13,146,12,158
ORISSA,2008,EXTORTION,0,0,0,0,0,0,3,0,3,0,0,0,3,0,3
ORISSA,2008,RIOTS,0,0,0,0,0,0,2,0,2,0,0,0,2,0,2
ORISSA,2008,ARSON,0,0,0,1,0,1,2,0,2,0,0,0,3,0,3
ORISSA,2008,CRIMINAL BREACH OF TRUST,0,0,0,0,0,0,4,0,4,0,0,0,4,0,4
ORISSA,2008,CHEATING,0,0,0,2,0,2,1,0,1,0,0,0,3,0,3
ORISSA,2008,COUNTER FEITING,0,0,0,0,0,0,0,0,0,0,0,0,0,0,0
ORISSA,2008,DOWRY DEATHS,0,0,0,17,0,17,29,2,31,2,0,2,48,2,50
ORISSA,2008,MOLESTATION,0,0,0,9,0,9,8,0,8,1,0,1,18,0,18
ORISSA,2008,EVE-TEASING,0,0,0,0,0,0,0,0,0,0,0,0,0,0,0
ORISSA,2008,CRUELTY BY HUSBAND OR RELATIVE OF HUSBAND,0,0,0,18,1,19,18,6,24,8,0,8,44,7,51
ORISSA,2008,OTHER IPC CRIMES,0,0,0,29,0,29,24,10,34,19,2,21,72,12,84
ORISSA,2008,TOTAL IPC,0,0,0,1528,23,1551,1964,82,2046,558,14,572,4050,119,4169
ORISSA,2009,MURDER,0,0,0,742,17,759,1449,44,1493,350,8,358,2541,69,2610
ORISSA,2009,ATTEMPT TO COMMIT MURDER,0,0,0,141,2,143,153,2,155,78,0,78,372,4,376
ORISSA,2009,C.H. NOT AMOUNTING TO MURDER,0,0,0,93,1,94,39,3,42,23,0,23,155,4,159
ORISSA,2009,RAPE,0,0,0,149,0,149,51,0,51,9,0,9,209,0,209
ORISSA,2009,KIDNAPPING AND ABDUCTION,0,0,0,10,0,10,5,0,5,3,0,3,18,0,18
ORISSA,2009,DACOITY,0,0,0,98,0,98,52,0,52,5,0,5,155,0,155
ORISSA,2009,PREP. AND ASSEMBLY FOR DACOITY,0,0,0,1,0,1,1,0,1,0,0,0,2,0,2
ORISSA,2009,ROBBERY,0,0,0,33,0,33,18,0,18,0,0,0,51,0,51
ORISSA,2009,BURGLARY,0,0,0,42,0,42,13,0,13,2,0,2,57,0,57
ORISSA,2009,THEFTS,0,0,0,63,1,64,45,5,50,8,2,10,116,8,124
ORISSA,2009,EXTORTION,0,0,0,0,0,0,3,0,3,0,0,0,3,0,3
ORISSA,2009,RIOTS,0,0,0,0,0,0,2,0,2,0,0,0,2,0,2
ORISSA,2009,ARSON,0,0,0,1,0,1,2,0,2,0,0,0,3,0,3
ORISSA,2009,CRIMINAL BREACH OF TRUST,0,0,0,0,0,0,3,0,3,0,0,0,3,0,3
ORISSA,2009,CHEATING,0,0,0,2,0,2,1,0,1,0,0,0,3,0,3
ORISSA,2009,COUNTER FEITING,0,0,0,0,0,0,0,0,0,0,0,0,0,0,0
ORISSA,2009,DOWRY DEATHS,0,0,0,14,0,14,22,2,24,2,0,2,38,2,40
ORISSA,2009,MOLESTATION,0,0,0,6,0,6,5,0,5,1,0,1,12,0,12
ORISSA,2009,EVE-TEASING,0,0,0,0,0,0,0,0,0,0,0,0,0,0,0
ORISSA,2009,CRUELTY BY HUSBAND OR RELATIVE OF HUSBAND,0,0,0,12,1,13,11,6,17,6,0,6,29,7,36
ORISSA,2009,OTHER IPC CRIMES,0,0,0,20,0,20,19,10,29,12,2,14,51,12,63
ORISSA,2009,TOTAL IPC,0,0,0,1427,22,1449,1894,72,1966,499,12,511,3820,106,3926
ORISSA,2010,MURDER,0,0,0,728,15,743,1419,48,1467,340,8,348,2487,71,2558
ORISSA,2010,ATTEMPT TO COMMIT MURDER,0,0,0,135,3,138,149,4,153,76,0,76,360,7,367
ORISSA,2010,C.H. NOT AMOUNTING TO MURDER,0,0,0,91,1,92,39,3,42,23,0,23,153,4,157
ORISSA,2010,RAPE,0,0,0,140,0,140,48,0,48,9,0,9,197,0,197
ORISSA,2010,KIDNAPPING AND ABDUCTION,0,0,0,10,1,11,8,0,8,3,0,3,21,1,22
ORISSA,2010,DACOITY,0,0,0,97,0,97,50,0,50,5,0,5,152,0,152
ORISSA,2010,PREP. AND ASSEMBLY FOR DACOITY,0,0,0,1,0,1,3,0,3,0,0,0,4,0,4
ORISSA,2010,ROBBERY,0,0,0,34,0,34,16,0,16,0,0,0,50,0,50
ORISSA,2010,BURGLARY,0,0,0,41,0,41,15,0,15,2,0,2,58,0,58
ORISSA,2010,THEFTS,0,0,0,64,1,65,44,5,49,8,2,10,116,8,124
ORISSA,2010,EXTORTION,0,0,0,0,0,0,4,0,4,0,0,0,4,0,4
ORISSA,2010,RIOTS,0,0,0,0,0,0,1,0,1,0,0,0,1,0,1
ORISSA,2010,ARSON,0,0,0,0,0,0,3,0,3,0,0,0,3,0,3
ORISSA,2010,CRIMINAL BREACH OF TRUST,0,0,0,0,0,0,4,0,4,0,0,0,4,0,4
ORISSA,2010,CHEATING,0,0,0,2,0,2,2,0,2,0,0,0,4,0,4
ORISSA,2010,COUNTER FEITING,0,0,0,0,0,0,0,0,0,0,0,0,0,0,0
ORISSA,2010,DOWRY DEATHS,0,0,0,15,0,15,24,2,26,2,0,2,41,2,43
ORISSA,2010,MOLESTATION,0,0,0,5,0,5,2,0,2,1,0,1,8,0,8
ORISSA,2010,EVE-TEASING,0,0,0,0,0,0,0,0,0,0,0,0,0,0,0
ORISSA,2010,CRUELTY BY HUSBAND OR RELATIVE OF HUSBAND,0,0,0,11,1,12,14,6,20,6,0,6,31,7,38
ORISSA,2010,OTHER IPC CRIMES,0,0,0,21,0,21,15,10,25,12,2,14,48,12,60
ORISSA,2010,TOTAL IPC,0,0,0,1395,22,1417,1860,78,1938,487,12,499,3742,112,3854
ORISSA,2011,MURDER,0,0,0,517,5,522,915,45,960,293,10,303,1725,60,1785
ORISSA,2011,ATTEMPT TO COMMIT MURDER,0,0,0,139,4,143,152,24,176,79,0,79,370,28,398
ORISSA,2011,C.H. NOT AMOUNTING TO MURDER,0,0,0,97,1,98,140,8,148,25,0,25,262,9,271
ORISSA,2011,RAPE,0,0,0,146,0,146,150,0,150,12,0,12,308,0,308
ORISSA,2011,KIDNAPPING AND ABDUCTION,0,0,0,13,0,13,10,0,10,5,0,5,28,0,28
ORISSA,2011,DACOITY,0,0,0,106,0,106,123,0,123,8,0,8,237,0,237
ORISSA,2011,PREP. AND ASSEMBLY FOR DACOITY,0,0,0,0,0,0,0,0,0,0,0,0,0,0,0
ORISSA,2011,ROBBERY,0,0,0,40,0,40,16,0,16,0,0,0,56,0,56
ORISSA,2011,BURGLARY,0,0,0,57,0,57,17,0,17,4,0,4,78,0,78
ORISSA,2011,THEFTS,0,0,0,70,0,70,49,0,49,13,0,13,132,0,132
ORISSA,2011,EXTORTION,0,0,0,0,0,0,0,0,0,0,0,0,0,0,0
ORISSA,2011,RIOTS,0,0,0,0,0,0,0,0,0,0,0,0,0,0,0
ORISSA,2011,ARSON,0,0,0,6,0,6,3,0,3,2,0,2,11,0,11
ORISSA,2011,CRIMINAL BREACH OF TRUST,0,0,0,9,0,9,7,0,7,4,0,4,20,0,20
ORISSA,2011,CHEATING,0,0,0,7,0,7,4,0,4,1,0,1,12,0,12
ORISSA,2011,COUNTER FEITING,0,0,0,0,0,0,0,0,0,0,0,0,0,0,0
ORISSA,2011,DOWRY DEATHS,0,0,0,20,0,20,28,2,30,7,0,7,55,2,57
ORISSA,2011,MOLESTATION,0,0,0,7,0,7,3,0,3,1,0,1,11,0,11
ORISSA,2011,EVE-TEASING,0,0,0,0,0,0,0,0,0,0,0,0,0,0,0
ORISSA,2011,CRUELTY BY HUSBAND OR RELATIVE OF HUSBAND,0,0,0,27,1,28,17,3,20,6,0,6,50,4,54
ORISSA,2011,OTHER IPC CRIMES,0,0,0,29,0,29,24,0,24,10,0,10,63,0,63
ORISSA,2011,TOTAL IPC,0,0,0,1290,11,1301,1658,82,1740,470,10,480,3418,103,3521
ORISSA,2012,MURDER,0,0,0,604,4,608,864,46,910,459,22,481,1927,72,1999
ORISSA,2012,ATTEMPT TO COMMIT MURDER,0,0,0,139,4,143,152,4,156,79,0,79,370,8,378
ORISSA,2012,C.H. NOT AMOUNTING TO MURDER,0,0,0,97,1,98,40,4,44,25,0,25,162,5,167
ORISSA,2012,RAPE,0,0,0,146,0,146,50,0,50,12,0,12,208,0,208
ORISSA,2012,KIDNAPPING AND ABDUCTION,0,0,0,13,0,13,10,0,10,5,0,5,28,0,28
ORISSA,2012,DACOITY,0,0,0,106,0,106,57,0,57,8,0,8,171,0,171
ORISSA,2012,PREP. AND ASSEMBLY FOR DACOITY,0,0,0,0,0,0,0,0,0,0,0,0,0,0,0
ORISSA,2012,ROBBERY,0,0,0,35,0,35,16,0,16,0,0,0,51,0,51
ORISSA,2012,BURGLARY,0,0,0,48,0,48,23,0,23,4,0,4,75,0,75
ORISSA,2012,THEFTS,0,0,0,84,0,84,43,0,43,13,0,13,140,0,140
ORISSA,2012,EXTORTION,0,0,0,0,0,0,0,0,0,0,0,0,0,0,0
ORISSA,2012,RIOTS,0,0,0,0,0,0,0,0,0,0,0,0,0,0,0
ORISSA,2012,ARSON,0,0,0,9,0,9,1,0,1,2,0,2,12,0,12
ORISSA,2012,CRIMINAL BREACH OF TRUST,0,0,0,7,0,7,11,0,11,4,0,4,22,0,22
ORISSA,2012,CHEATING,0,0,0,11,0,11,2,0,2,1,0,1,14,0,14
ORISSA,2012,COUNTER FEITING,0,0,0,0,0,0,0,0,0,0,0,0,0,0,0
ORISSA,2012,DOWRY DEATHS,0,0,0,7,0,7,24,2,26,7,0,7,38,2,40
ORISSA,2012,MOLESTATION,0,0,0,6,0,6,5,0,5,1,0,1,12,0,12
ORISSA,2012,EVE-TEASING,0,0,0,0,0,0,0,0,0,0,0,0,0,0,0
ORISSA,2012,CRUELTY BY HUSBAND OR RELATIVE OF HUSBAND,0,0,0,29,1,30,15,3,18,6,0,6,50,4,54
ORISSA,2012,OTHER IPC CRIMES,0,0,0,27,0,27,28,0,28,10,0,10,65,0,65
ORISSA,2012,TOTAL IPC,0,0,0,1368,10,1378,1341,59,1400,636,22,658,3345,91,3436
PUNJAB,2001,MURDER,0,0,0,458,9,467,205,8,213,203,6,209,866,23,889
PUNJAB,2001,ATTEMPT TO COMMIT MURDER,0,0,0,76,7,83,26,5,31,65,2,67,167,14,181
PUNJAB,2001,C.H. NOT AMOUNTING TO MURDER,0,0,0,0,0,0,85,8,93,36,5,41,121,13,134
PUNJAB,2001,RAPE,0,0,0,65,12,77,0,0,0,5,0,5,70,12,82
PUNJAB,2001,KIDNAPPING AND ABDUCTION,0,0,0,42,0,42,38,16,54,38,2,40,118,18,136
PUNJAB,2001,DACOITY,0,0,0,28,0,28,52,20,72,12,0,12,92,20,112
PUNJAB,2001,PREP. AND ASSEMBLY FOR DACOITY,0,0,0,22,0,22,12,0,12,8,0,8,42,0,42
PUNJAB,2001,ROBBERY,0,0,0,26,0,26,20,0,20,25,0,25,71,0,71
PUNJAB,2001,BURGLARY,0,0,0,15,0,15,25,0,25,9,0,9,49,0,49
PUNJAB,2001,THEFTS,0,0,0,125,0,125,102,5,107,18,0,18,245,5,250
PUNJAB,2001,EXTORTION,0,0,0,26,0,26,6,0,6,4,0,4,36,0,36
PUNJAB,2001,RIOTS,0,0,0,12,0,12,4,0,4,7,0,7,23,0,23
PUNJAB,2001,ARSON,0,0,0,16,0,16,9,0,9,11,0,11,36,0,36
PUNJAB,2001,CRIMINAL BREACH OF TRUST,0,0,0,8,0,8,7,0,7,9,0,9,24,0,24
PUNJAB,2001,CHEATING,0,0,0,35,0,35,40,0,40,46,0,46,121,0,121
PUNJAB,2001,COUNTER FEITING,0,0,0,10,0,10,8,0,8,7,0,7,25,0,25
PUNJAB,2001,DOWRY DEATHS,0,0,0,6,0,6,4,10,14,16,0,16,26,10,36
PUNJAB,2001,MOLESTATION,0,0,0,27,0,27,35,0,35,48,0,48,110,0,110
PUNJAB,2001,EVE-TEASING,0,0,0,4,0,4,3,0,3,2,0,2,9,0,9
PUNJAB,2001,CRUELTY BY HUSBAND OR RELATIVE OF HUSBAND,0,0,0,8,0,8,12,0,12,8,0,8,28,0,28
PUNJAB,2001,OTHER IPC CRIMES,0,0,0,26,6,32,32,6,38,45,0,45,103,12,115
PUNJAB,2001,TOTAL IPC,0,0,0,1035,34,1069,725,78,803,622,15,637,2382,127,2509
PUNJAB,2002,MURDER,0,0,0,324,15,339,364,28,392,38,19,57,726,62,788
PUNJAB,2002,ATTEMPT TO COMMIT MURDER,0,0,0,154,1,155,71,6,77,23,3,26,248,10,258
PUNJAB,2002,C.H. NOT AMOUNTING TO MURDER,0,0,0,96,1,97,90,1,91,15,0,15,201,2,203
PUNJAB,2002,RAPE,0,0,0,65,20,85,30,0,30,0,0,0,95,20,115
PUNJAB,2002,KIDNAPPING AND ABDUCTION,0,0,0,44,0,44,14,0,14,1,0,1,59,0,59
PUNJAB,2002,DACOITY,0,0,0,30,0,30,15,0,15,3,0,3,48,0,48
PUNJAB,2002,PREP. AND ASSEMBLY FOR DACOITY,0,0,0,25,0,25,5,0,5,0,0,0,30,0,30
PUNJAB,2002,ROBBERY,0,0,0,25,0,25,8,0,8,0,0,0,33,0,33
PUNJAB,2002,BURGLARY,0,0,0,23,0,23,9,0,9,0,0,0,32,0,32
PUNJAB,2002,THEFTS,0,0,0,340,0,340,369,0,369,2,0,2,711,0,711
PUNJAB,2002,EXTORTION,0,0,0,0,0,0,0,0,0,0,0,0,0,0,0
PUNJAB,2002,RIOTS,0,0,0,25,0,25,0,0,0,0,0,0,25,0,25
PUNJAB,2002,ARSON,0,0,0,35,0,35,15,0,15,10,0,10,60,0,60
PUNJAB,2002,CRIMINAL BREACH OF TRUST,0,0,0,21,0,21,18,1,19,4,0,4,43,1,44
PUNJAB,2002,CHEATING,0,0,0,32,0,32,25,0,25,0,0,0,57,0,57
PUNJAB,2002,COUNTER FEITING,0,0,0,0,0,0,15,0,15,3,0,3,18,0,18
PUNJAB,2002,DOWRY DEATHS,0,0,0,18,0,18,16,0,16,4,0,4,38,0,38
PUNJAB,2002,MOLESTATION,0,0,0,6,1,7,8,2,10,15,4,19,29,7,36
PUNJAB,2002,EVE-TEASING,0,0,0,4,0,4,6,0,6,3,0,3,13,0,13
PUNJAB,2002,CRUELTY BY HUSBAND OR RELATIVE OF HUSBAND,0,0,0,12,3,15,16,3,19,21,4,25,49,10,59
PUNJAB,2002,OTHER IPC CRIMES,0,0,0,60,6,66,25,0,25,3,2,5,88,8,96
PUNJAB,2002,TOTAL IPC,0,0,0,1339,47,1386,1119,41,1160,145,32,177,2603,120,2723
PUNJAB,2003,MURDER,0,0,0,442,5,447,410,26,436,167,12,179,1019,43,1062
PUNJAB,2003,ATTEMPT TO COMMIT MURDER,0,0,0,158,3,161,166,4,170,36,4,40,360,11,371
PUNJAB,2003,C.H. NOT AMOUNTING TO MURDER,0,0,0,112,1,113,86,1,87,11,0,11,209,2,211
PUNJAB,2003,RAPE,0,0,0,109,24,133,60,2,62,0,0,0,169,26,195
PUNJAB,2003,KIDNAPPING AND ABDUCTION,0,0,0,32,0,32,9,0,9,0,0,0,41,0,41
PUNJAB,2003,DACOITY,0,0,0,33,0,33,20,0,20,2,0,2,55,0,55
PUNJAB,2003,PREP. AND ASSEMBLY FOR DACOITY,0,0,0,28,0,28,8,0,8,0,0,0,36,0,36
PUNJAB,2003,ROBBERY,0,0,0,19,0,19,4,0,4,0,0,0,23,0,23
PUNJAB,2003,BURGLARY,0,0,0,10,0,10,4,0,4,0,0,0,14,0,14
PUNJAB,2003,THEFTS,0,0,0,172,0,172,73,2,75,82,10,92,327,12,339
PUNJAB,2003,EXTORTION,0,0,0,0,0,0,0,0,0,0,0,0,0,0,0
PUNJAB,2003,RIOTS,0,0,0,22,0,22,0,0,0,0,0,0,22,0,22
PUNJAB,2003,ARSON,0,0,0,33,0,33,12,0,12,8,0,8,53,0,53
PUNJAB,2003,CRIMINAL BREACH OF TRUST,0,0,0,22,0,22,19,1,20,3,0,3,44,1,45
PUNJAB,2003,CHEATING,0,0,0,90,0,90,24,0,24,8,0,8,122,0,122
PUNJAB,2003,COUNTER FEITING,0,0,0,2,0,2,5,0,5,0,0,0,7,0,7
PUNJAB,2003,DOWRY DEATHS,0,0,0,8,0,8,17,0,17,5,0,5,30,0,30
PUNJAB,2003,MOLESTATION,0,0,0,4,1,5,9,2,11,13,2,15,26,5,31
PUNJAB,2003,EVE-TEASING,0,0,0,3,0,3,5,0,5,2,0,2,10,0,10
PUNJAB,2003,CRUELTY BY HUSBAND OR RELATIVE OF HUSBAND,0,0,0,10,3,13,14,2,16,10,3,13,34,8,42
PUNJAB,2003,OTHER IPC CRIMES,0,0,0,106,0,106,50,0,50,61,0,61,217,0,217
PUNJAB,2003,TOTAL IPC,0,0,0,1415,37,1452,995,40,1035,408,31,439,2818,108,2926
PUNJAB,2004,MURDER,0,0,0,455,5,460,420,24,444,199,10,209,1074,39,1113
PUNJAB,2004,ATTEMPT TO COMMIT MURDER,0,0,0,170,4,174,175,5,180,40,6,46,385,15,400
PUNJAB,2004,C.H. NOT AMOUNTING TO MURDER,0,0,0,120,2,122,90,1,91,15,0,15,225,3,228
PUNJAB,2004,RAPE,0,0,0,125,26,151,65,3,68,0,0,0,190,29,219
PUNJAB,2004,KIDNAPPING AND ABDUCTION,0,0,0,30,0,30,10,0,10,0,0,0,40,0,40
PUNJAB,2004,DACOITY,0,0,0,35,0,35,28,0,28,3,0,3,66,0,66
PUNJAB,2004,PREP. AND ASSEMBLY FOR DACOITY,0,0,0,31,0,31,12,0,12,0,0,0,43,0,43
PUNJAB,2004,ROBBERY,0,0,0,28,0,28,5,0,5,0,0,0,33,0,33
PUNJAB,2004,BURGLARY,0,0,0,11,0,11,5,0,5,0,0,0,16,0,16
PUNJAB,2004,THEFTS,0,0,0,180,0,180,83,2,85,96,10,106,359,12,371
PUNJAB,2004,EXTORTION,0,0,0,0,0,0,0,0,0,0,0,0,0,0,0
PUNJAB,2004,RIOTS,0,0,0,25,0,25,0,1,1,0,0,0,25,1,26
PUNJAB,2004,ARSON,0,0,0,36,0,36,21,0,21,12,0,12,69,0,69
PUNJAB,2004,CRIMINAL BREACH OF TRUST,0,0,0,30,0,30,29,1,30,5,0,5,64,1,65
PUNJAB,2004,CHEATING,0,0,0,98,0,98,29,0,29,16,0,16,143,0,143
PUNJAB,2004,COUNTER FEITING,0,0,0,4,0,4,6,0,6,0,0,0,10,0,10
PUNJAB,2004,DOWRY DEATHS,0,0,0,10,1,11,28,0,28,14,0,14,52,1,53
PUNJAB,2004,MOLESTATION,0,0,0,9,1,10,17,2,19,25,3,28,51,6,57
PUNJAB,2004,EVE-TEASING,0,0,0,5,0,5,6,0,6,3,3,6,14,3,17
PUNJAB,2004,CRUELTY BY HUSBAND OR RELATIVE OF HUSBAND,0,0,0,15,4,19,26,0,26,18,5,23,59,9,68
PUNJAB,2004,OTHER IPC CRIMES,0,0,0,122,0,122,65,0,65,79,0,79,266,0,266
PUNJAB,2004,TOTAL IPC,0,0,0,1539,43,1582,1120,39,1159,525,37,562,3184,119,3303
PUNJAB,2005,MURDER,0,0,0,275,6,281,431,22,453,395,10,405,1101,38,1139
PUNJAB,2005,ATTEMPT TO COMMIT MURDER,0,0,0,115,19,134,181,4,185,78,6,84,374,29,403
PUNJAB,2005,C.H. NOT AMOUNTING TO MURDER,0,0,0,88,4,92,88,1,89,36,0,36,212,5,217
PUNJAB,2005,RAPE,0,0,0,102,27,129,66,4,70,0,0,0,168,31,199
PUNJAB,2005,KIDNAPPING AND ABDUCTION,0,0,0,21,4,25,14,0,14,0,0,0,35,4,39
PUNJAB,2005,DACOITY,0,0,0,25,0,25,30,0,30,16,0,16,71,0,71
PUNJAB,2005,PREP. AND ASSEMBLY FOR DACOITY,0,0,0,28,0,28,14,0,14,0,0,0,42,0,42
PUNJAB,2005,ROBBERY,0,0,0,20,0,20,6,0,6,58,0,58,84,0,84
PUNJAB,2005,BURGLARY,0,0,0,12,0,12,7,0,7,0,0,0,19,0,19
PUNJAB,2005,THEFTS,0,0,0,102,0,102,84,1,85,196,2,198,382,3,385
PUNJAB,2005,EXTORTION,0,0,0,0,0,0,0,0,0,0,0,0,0,0,0
PUNJAB,2005,RIOTS,0,0,0,21,0,21,7,0,7,0,0,0,28,0,28
PUNJAB,2005,ARSON,0,0,0,38,0,38,20,0,20,52,6,58,110,6,116
PUNJAB,2005,CRIMINAL BREACH OF TRUST,0,0,0,28,0,28,27,1,28,24,0,24,79,1,80
PUNJAB,2005,CHEATING,0,0,0,80,0,80,24,0,24,38,0,38,142,0,142
PUNJAB,2005,COUNTER FEITING,0,0,0,3,0,3,5,0,5,0,0,0,8,0,8
PUNJAB,2005,DOWRY DEATHS,0,0,0,11,8,19,27,0,27,25,0,25,63,8,71
PUNJAB,2005,MOLESTATION,0,0,0,10,2,12,15,3,18,34,3,37,59,8,67
PUNJAB,2005,EVE-TEASING,0,0,0,4,5,9,5,0,5,13,4,17,22,9,31
PUNJAB,2005,CRUELTY BY HUSBAND OR RELATIVE OF HUSBAND,0,0,0,12,2,14,25,0,25,37,8,45,74,10,84
PUNJAB,2005,OTHER IPC CRIMES,0,0,0,60,0,60,56,0,56,80,0,80,196,0,196
PUNJAB,2005,TOTAL IPC,0,0,0,1055,77,1132,1132,36,1168,1082,39,1121,3269,152,3421
PUNJAB,2006,MURDER,0,0,0,281,9,290,265,16,281,66,20,86,612,45,657
PUNJAB,2006,ATTEMPT TO COMMIT MURDER,0,0,0,194,11,205,200,17,217,57,27,84,451,55,506
PUNJAB,2006,C.H. NOT AMOUNTING TO MURDER,0,0,0,71,5,76,166,9,175,60,0,60,297,14,311
PUNJAB,2006,RAPE,0,0,0,192,6,198,167,13,180,6,0,6,365,19,384
PUNJAB,2006,KIDNAPPING AND ABDUCTION,0,0,0,60,0,60,26,0,26,0,0,0,86,0,86
PUNJAB,2006,DACOITY,0,0,0,75,0,75,10,0,10,18,0,18,103,0,103
PUNJAB,2006,PREP. AND ASSEMBLY FOR DACOITY,0,0,0,43,0,43,12,0,12,0,0,0,55,0,55
PUNJAB,2006,ROBBERY,0,0,0,90,0,90,19,0,19,22,0,22,131,0,131
PUNJAB,2006,BURGLARY,0,0,0,33,0,33,20,0,20,0,0,0,53,0,53
PUNJAB,2006,THEFTS,0,0,0,162,0,162,56,19,75,44,0,44,262,19,281
PUNJAB,2006,EXTORTION,0,0,0,0,0,0,0,0,0,0,0,0,0,0,0
PUNJAB,2006,RIOTS,0,0,0,27,0,27,0,0,0,0,0,0,27,0,27
PUNJAB,2006,ARSON,0,0,0,13,0,13,5,0,5,0,0,0,18,0,18
PUNJAB,2006,CRIMINAL BREACH OF TRUST,0,0,0,7,0,7,5,2,7,27,0,27,39,2,41
PUNJAB,2006,CHEATING,0,0,0,43,0,43,3,0,3,7,0,7,53,0,53
PUNJAB,2006,COUNTER FEITING,0,0,0,9,0,9,2,0,2,0,0,0,11,0,11
PUNJAB,2006,DOWRY DEATHS,0,0,0,47,2,49,21,0,21,3,0,3,71,2,73
PUNJAB,2006,MOLESTATION,0,0,0,6,2,8,2,0,2,3,2,5,11,4,15
PUNJAB,2006,EVE-TEASING,0,0,0,7,2,9,9,0,9,0,0,0,16,2,18
PUNJAB,2006,CRUELTY BY HUSBAND OR RELATIVE OF HUSBAND,0,0,0,55,10,65,8,0,8,8,7,15,71,17,88
PUNJAB,2006,OTHER IPC CRIMES,0,0,0,173,0,173,81,0,81,131,0,131,385,0,385
PUNJAB,2006,TOTAL IPC,0,0,0,1588,47,1635,1077,76,1153,452,56,508,3117,179,3296
PUNJAB,2007,MURDER,0,0,0,232,18,250,264,9,273,186,12,198,682,39,721
PUNJAB,2007,ATTEMPT TO COMMIT MURDER,0,0,0,161,19,180,199,10,209,267,18,285,627,47,674
PUNJAB,2007,C.H. NOT AMOUNTING TO MURDER,0,0,0,29,4,33,160,4,164,180,0,180,369,8,377
PUNJAB,2007,RAPE,0,0,0,82,6,88,166,8,174,4,0,4,252,14,266
PUNJAB,2007,KIDNAPPING AND ABDUCTION,0,0,0,18,0,18,25,0,25,0,0,0,43,0,43
PUNJAB,2007,DACOITY,0,0,0,73,0,73,10,0,10,13,0,13,96,0,96
PUNJAB,2007,PREP. AND ASSEMBLY FOR DACOITY,0,0,0,12,0,12,12,0,12,0,0,0,24,0,24
PUNJAB,2007,ROBBERY,0,0,0,28,0,28,18,0,18,18,0,18,64,0,64
PUNJAB,2007,BURGLARY,0,0,0,20,0,20,19,0,19,0,0,0,39,0,39
PUNJAB,2007,THEFTS,0,0,0,59,0,59,55,15,70,39,0,39,153,15,168
PUNJAB,2007,EXTORTION,0,0,0,0,0,0,0,0,0,0,0,0,0,0,0
PUNJAB,2007,RIOTS,0,0,0,15,0,15,0,0,0,0,0,0,15,0,15
PUNJAB,2007,ARSON,0,0,0,12,0,12,4,0,4,0,0,0,16,0,16
PUNJAB,2007,CRIMINAL BREACH OF TRUST,0,0,0,5,0,5,5,1,6,23,0,23,33,1,34
PUNJAB,2007,CHEATING,0,0,0,42,0,42,2,0,2,2,0,2,46,0,46
PUNJAB,2007,COUNTER FEITING,0,0,0,8,0,8,2,0,2,0,0,0,10,0,10
PUNJAB,2007,DOWRY DEATHS,0,0,0,25,7,32,20,0,20,1,0,1,46,7,53
PUNJAB,2007,MOLESTATION,0,0,0,5,2,7,2,0,2,1,0,1,8,2,10
PUNJAB,2007,EVE-TEASING,0,0,0,6,2,8,8,0,8,0,0,0,14,2,16
PUNJAB,2007,CRUELTY BY HUSBAND OR RELATIVE OF HUSBAND,0,0,0,21,4,25,7,0,7,4,0,4,32,4,36
PUNJAB,2007,OTHER IPC CRIMES,0,0,0,71,0,71,77,0,77,227,0,227,375,0,375
PUNJAB,2007,TOTAL IPC,0,0,0,924,62,986,1055,47,1102,965,30,995,2944,139,3083
PUNJAB,2008,MURDER,0,0,0,242,19,261,254,12,266,198,22,220,694,53,747
PUNJAB,2008,ATTEMPT TO COMMIT MURDER,0,0,0,165,20,185,223,12,235,287,24,311,675,56,731
PUNJAB,2008,C.H. NOT AMOUNTING TO MURDER,0,0,0,33,5,38,180,4,184,185,0,185,398,9,407
PUNJAB,2008,RAPE,0,0,0,87,8,95,186,9,195,4,0,4,277,17,294
PUNJAB,2008,KIDNAPPING AND ABDUCTION,0,0,0,23,0,23,16,0,16,0,0,0,39,0,39
PUNJAB,2008,DACOITY,0,0,0,69,0,69,9,0,9,14,0,14,92,0,92
PUNJAB,2008,PREP. AND ASSEMBLY FOR DACOITY,0,0,0,11,0,11,13,0,13,0,0,0,24,0,24
PUNJAB,2008,ROBBERY,0,0,0,19,0,19,16,0,16,21,0,21,56,0,56
PUNJAB,2008,BURGLARY,0,0,0,33,0,33,29,0,29,0,0,0,62,0,62
PUNJAB,2008,THEFTS,0,0,0,70,0,70,75,17,92,41,0,41,186,17,203
PUNJAB,2008,EXTORTION,0,0,0,0,0,0,0,0,0,0,0,0,0,0,0
PUNJAB,2008,RIOTS,0,0,0,13,0,13,0,0,0,0,0,0,13,0,13
PUNJAB,2008,ARSON,0,0,0,13,0,13,3,0,3,0,0,0,16,0,16
PUNJAB,2008,CRIMINAL BREACH OF TRUST,0,0,0,9,0,9,6,1,7,24,0,24,39,1,40
PUNJAB,2008,CHEATING,0,0,0,65,0,65,8,0,8,6,3,9,79,3,82
PUNJAB,2008,COUNTER FEITING,0,0,0,11,0,11,3,0,3,0,0,0,14,0,14
PUNJAB,2008,DOWRY DEATHS,0,0,0,31,6,37,16,0,16,4,0,4,51,6,57
PUNJAB,2008,MOLESTATION,0,0,0,6,2,8,1,0,1,2,0,2,9,2,11
PUNJAB,2008,EVE-TEASING,0,0,0,7,3,10,7,0,7,0,0,0,14,3,17
PUNJAB,2008,CRUELTY BY HUSBAND OR RELATIVE OF HUSBAND,0,0,0,23,4,27,8,0,8,5,0,5,36,4,40
PUNJAB,2008,OTHER IPC CRIMES,0,0,0,91,0,91,97,0,97,259,5,264,447,5,452
PUNJAB,2008,TOTAL IPC,0,0,0,1021,67,1088,1150,55,1205,1050,54,1104,3221,176,3397
PUNJAB,2009,MURDER,0,0,0,469,32,501,291,19,310,33,9,42,793,60,853
PUNJAB,2009,ATTEMPT TO COMMIT MURDER,0,0,0,319,39,358,239,22,261,13,2,15,571,63,634
PUNJAB,2009,C.H. NOT AMOUNTING TO MURDER,0,0,0,129,8,137,42,4,46,7,1,8,178,13,191
PUNJAB,2009,RAPE,0,0,0,216,0,216,97,3,100,0,0,0,313,3,316
PUNJAB,2009,KIDNAPPING AND ABDUCTION,0,0,0,96,9,105,62,3,65,0,0,0,158,12,170
PUNJAB,2009,DACOITY,0,0,0,83,0,83,16,0,16,15,0,15,114,0,114
PUNJAB,2009,PREP. AND ASSEMBLY FOR DACOITY,0,0,0,14,0,14,19,0,19,0,0,0,33,0,33
PUNJAB,2009,ROBBERY,0,0,0,27,0,27,21,0,21,7,0,7,55,0,55
PUNJAB,2009,BURGLARY,0,0,0,76,0,76,67,0,67,0,0,0,143,0,143
PUNJAB,2009,THEFTS,0,0,0,116,0,116,89,21,110,9,0,9,214,21,235
PUNJAB,2009,EXTORTION,0,0,0,0,0,0,0,0,0,0,0,0,0,0,0
PUNJAB,2009,RIOTS,0,0,0,28,0,28,8,0,8,0,0,0,36,0,36
PUNJAB,2009,ARSON,0,0,0,44,0,44,10,2,12,0,0,0,54,2,56
PUNJAB,2009,CRIMINAL BREACH OF TRUST,0,0,0,109,0,109,69,0,69,3,0,3,181,0,181
PUNJAB,2009,CHEATING,0,0,0,180,0,180,98,3,101,0,1,1,278,4,282
PUNJAB,2009,COUNTER FEITING,0,0,0,33,0,33,19,2,21,0,0,0,52,2,54
PUNJAB,2009,DOWRY DEATHS,0,0,0,63,21,84,31,17,48,11,0,11,105,38,143
PUNJAB,2009,MOLESTATION,0,0,0,11,3,14,9,1,10,2,0,2,22,4,26
PUNJAB,2009,EVE-TEASING,0,0,0,15,4,19,11,0,11,0,0,0,26,4,30
PUNJAB,2009,CRUELTY BY HUSBAND OR RELATIVE OF HUSBAND,0,0,0,37,9,46,18,2,20,3,6,9,58,17,75
PUNJAB,2009,OTHER IPC CRIMES,0,0,0,219,0,219,103,0,103,0,0,0,322,0,322
PUNJAB,2009,TOTAL IPC,0,0,0,2284,125,2409,1319,99,1418,103,19,122,3706,243,3949
PUNJAB,2010,MURDER,0,0,0,485,33,518,316,18,334,32,8,40,833,59,892
PUNJAB,2010,ATTEMPT TO COMMIT MURDER,0,0,0,340,37,377,264,20,284,13,2,15,617,59,676
PUNJAB,2010,C.H. NOT AMOUNTING TO MURDER,0,0,0,142,8,150,90,4,94,7,1,8,239,13,252
PUNJAB,2010,RAPE,0,0,0,237,0,237,112,0,112,0,0,0,349,0,349
PUNJAB,2010,KIDNAPPING AND ABDUCTION,0,0,0,112,10,122,115,5,120,0,0,0,227,15,242
PUNJAB,2010,DACOITY,0,0,0,104,0,104,31,0,31,16,0,16,151,0,151
PUNJAB,2010,PREP. AND ASSEMBLY FOR DACOITY,0,0,0,18,0,18,29,0,29,0,0,0,47,0,47
PUNJAB,2010,ROBBERY,0,0,0,45,0,45,37,0,37,8,0,8,90,0,90
PUNJAB,2010,BURGLARY,0,0,0,97,0,97,86,0,86,0,0,0,183,0,183
PUNJAB,2010,THEFTS,0,0,0,152,0,152,179,18,197,14,0,14,345,18,363
PUNJAB,2010,EXTORTION,0,0,0,0,0,0,0,0,0,0,0,0,0,0,0
PUNJAB,2010,RIOTS,0,0,0,49,0,49,18,0,18,0,0,0,67,0,67
PUNJAB,2010,ARSON,0,0,0,65,0,65,20,1,21,0,0,0,85,1,86
PUNJAB,2010,CRIMINAL BREACH OF TRUST,0,0,0,130,0,130,89,0,89,5,0,5,224,0,224
PUNJAB,2010,CHEATING,0,0,0,216,0,216,156,2,158,2,1,3,374,3,377
PUNJAB,2010,COUNTER FEITING,0,0,0,54,0,54,39,2,41,0,0,0,93,2,95
PUNJAB,2010,DOWRY DEATHS,0,0,0,84,23,107,84,15,99,10,2,12,178,40,218
PUNJAB,2010,MOLESTATION,0,0,0,32,3,35,29,1,30,0,0,0,61,4,65
PUNJAB,2010,EVE-TEASING,0,0,0,36,3,39,22,0,22,0,0,0,58,3,61
PUNJAB,2010,CRUELTY BY HUSBAND OR RELATIVE OF HUSBAND,0,0,0,58,8,66,51,2,53,1,4,5,110,14,124
PUNJAB,2010,OTHER IPC CRIMES,0,0,0,249,0,249,254,0,254,2,0,2,505,0,505
PUNJAB,2010,TOTAL IPC,0,0,0,2705,125,2830,2021,88,2109,110,18,128,4836,231,5067
PUNJAB,2011,MURDER,0,0,0,463,40,503,320,20,340,34,10,44,817,70,887
PUNJAB,2011,ATTEMPT TO COMMIT MURDER,0,0,0,310,40,350,265,25,290,15,1,16,590,66,656
PUNJAB,2011,C.H. NOT AMOUNTING TO MURDER,0,0,0,130,10,140,190,20,210,10,0,10,330,30,360
PUNJAB,2011,RAPE,0,0,0,154,0,154,115,0,115,0,0,0,269,0,269
PUNJAB,2011,KIDNAPPING AND ABDUCTION,0,0,0,115,20,135,130,15,145,0,0,0,245,35,280
PUNJAB,2011,DACOITY,0,0,0,209,0,209,35,0,35,6,0,6,250,0,250
PUNJAB,2011,PREP. AND ASSEMBLY FOR DACOITY,0,0,0,20,0,20,129,0,129,0,0,0,149,0,149
PUNJAB,2011,ROBBERY,0,0,0,62,0,62,140,0,140,0,0,0,202,0,202
PUNJAB,2011,BURGLARY,0,0,0,120,0,120,70,0,70,0,0,0,190,0,190
PUNJAB,2011,THEFTS,0,0,0,170,0,170,0,0,0,0,0,0,170,0,170
PUNJAB,2011,EXTORTION,0,0,0,0,0,0,180,24,204,5,0,5,185,24,209
PUNJAB,2011,RIOTS,0,0,0,152,0,152,120,0,120,0,0,0,272,0,272
PUNJAB,2011,ARSON,0,0,0,70,0,70,25,0,25,2,0,2,97,0,97
PUNJAB,2011,CRIMINAL BREACH OF TRUST,0,0,0,150,0,150,60,0,60,0,0,0,210,0,210
PUNJAB,2011,CHEATING,0,0,0,216,0,216,190,5,195,5,0,5,411,5,416
PUNJAB,2011,COUNTER FEITING,0,0,0,117,0,117,145,5,150,5,0,5,267,5,272
PUNJAB,2011,DOWRY DEATHS,0,0,0,90,30,120,90,20,110,10,2,12,190,52,242
PUNJAB,2011,MOLESTATION,0,0,0,40,30,70,31,0,31,0,2,2,71,32,103
PUNJAB,2011,EVE-TEASING,0,0,0,40,2,42,25,0,25,0,0,0,65,2,67
PUNJAB,2011,CRUELTY BY HUSBAND OR RELATIVE OF HUSBAND,0,0,0,60,3,63,55,5,60,2,1,3,117,9,126
PUNJAB,2011,OTHER IPC CRIMES,0,0,0,104,16,120,20,6,26,6,3,9,130,25,155
PUNJAB,2011,TOTAL IPC,0,0,0,2792,191,2983,2335,145,2480,100,19,119,5227,355,5582
PUNJAB,2012,MURDER,0,0,0,405,18,423,742,33,775,251,19,270,1398,70,1468
PUNJAB,2012,ATTEMPT TO COMMIT MURDER,0,0,0,84,5,89,170,7,177,83,2,85,337,14,351
PUNJAB,2012,C.H. NOT AMOUNTING TO MURDER,0,0,0,68,4,72,114,0,114,48,2,50,230,6,236
PUNJAB,2012,RAPE,0,0,0,97,2,99,118,3,121,42,1,43,257,6,263
PUNJAB,2012,KIDNAPPING AND ABDUCTION,0,0,0,72,5,77,98,7,105,29,4,33,199,16,215
PUNJAB,2012,DACOITY,0,0,0,63,0,63,67,0,67,26,0,26,156,0,156
PUNJAB,2012,PREP. AND ASSEMBLY FOR DACOITY,0,0,0,46,0,46,72,0,72,15,0,15,133,0,133
PUNJAB,2012,ROBBERY,0,0,0,82,0,82,107,0,107,33,0,33,222,0,222
PUNJAB,2012,BURGLARY,0,0,0,81,0,81,54,0,54,18,0,18,153,0,153
PUNJAB,2012,THEFTS,0,0,0,142,3,145,155,3,158,28,0,28,325,6,331
PUNJAB,2012,EXTORTION,0,0,0,42,3,45,54,3,57,15,1,16,111,7,118
PUNJAB,2012,RIOTS,0,0,0,34,1,35,34,1,35,16,0,16,84,2,86
PUNJAB,2012,ARSON,0,0,0,5,0,5,25,0,25,7,0,7,37,0,37
PUNJAB,2012,CRIMINAL BREACH OF TRUST,0,0,0,23,0,23,65,1,66,16,1,17,104,2,106
PUNJAB,2012,CHEATING,0,0,0,45,0,45,73,3,76,32,1,33,150,4,154
PUNJAB,2012,COUNTER FEITING,0,0,0,35,0,35,47,0,47,17,1,18,99,1,100
PUNJAB,2012,DOWRY DEATHS,0,0,0,116,20,136,201,32,233,81,20,101,398,72,470
PUNJAB,2012,MOLESTATION,0,0,0,2,0,2,5,0,5,3,0,3,10,0,10
PUNJAB,2012,EVE-TEASING,0,0,0,8,0,8,5,0,5,2,0,2,15,0,15
PUNJAB,2012,CRUELTY BY HUSBAND OR RELATIVE OF HUSBAND,0,0,0,14,0,14,58,0,58,18,0,18,90,0,90
PUNJAB,2012,OTHER IPC CRIMES,0,0,0,63,12,75,75,11,86,28,2,30,166,25,191
PUNJAB,2012,TOTAL IPC,0,0,0,1527,73,1600,2339,104,2443,808,54,862,4674,231,4905
RAJASTHAN,2001,MURDER,4,0,4,636,5,641,1234,29,1263,338,8,346,2212,42,2254
RAJASTHAN,2001,ATTEMPT TO COMMIT MURDER,0,0,0,110,1,111,104,8,112,40,1,41,254,10,264
RAJASTHAN,2001,C.H. NOT AMOUNTING TO MURDER,0,0,0,34,0,34,56,9,65,10,3,13,100,12,112
RAJASTHAN,2001,RAPE,2,0,2,110,0,110,140,1,141,30,0,30,282,1,283
RAJASTHAN,2001,KIDNAPPING AND ABDUCTION,0,0,0,23,0,23,19,0,19,1,0,1,43,0,43
RAJASTHAN,2001,DACOITY,0,0,0,15,0,15,28,0,28,1,0,1,44,0,44
RAJASTHAN,2001,PREP. AND ASSEMBLY FOR DACOITY,0,0,0,4,0,4,0,0,0,0,0,0,4,0,4
RAJASTHAN,2001,ROBBERY,0,0,0,14,0,14,12,0,12,0,0,0,26,0,26
RAJASTHAN,2001,BURGLARY,1,0,1,15,0,15,17,0,17,2,0,2,35,0,35
RAJASTHAN,2001,THEFTS,0,0,0,39,0,39,34,0,34,8,0,8,81,0,81
RAJASTHAN,2001,EXTORTION,0,0,0,0,0,0,0,0,0,0,0,0,0,0,0
RAJASTHAN,2001,RIOTS,0,0,0,7,0,7,5,0,5,1,0,1,13,0,13
RAJASTHAN,2001,ARSON,0,0,0,1,0,1,7,0,7,0,0,0,8,0,8
RAJASTHAN,2001,CRIMINAL BREACH OF TRUST,0,0,0,0,0,0,0,0,0,0,0,0,0,0,0
RAJASTHAN,2001,CHEATING,0,0,0,5,0,5,11,0,11,1,0,1,17,0,17
RAJASTHAN,2001,COUNTER FEITING,0,0,0,3,0,3,4,1,5,1,0,1,8,1,9
RAJASTHAN,2001,DOWRY DEATHS,0,0,0,60,0,60,90,16,106,24,4,28,174,20,194
RAJASTHAN,2001,MOLESTATION,0,0,0,0,0,0,0,0,0,0,0,0,0,0,0
RAJASTHAN,2001,EVE-TEASING,0,0,0,0,0,0,0,0,0,0,0,0,0,0,0
RAJASTHAN,2001,CRUELTY BY HUSBAND OR RELATIVE OF HUSBAND,2,0,2,42,3,45,20,2,22,0,0,0,64,5,69
RAJASTHAN,2001,OTHER IPC CRIMES,0,0,0,35,1,36,63,0,63,19,0,19,117,1,118
RAJASTHAN,2001,TOTAL IPC,9,0,9,1153,10,1163,1844,66,1910,476,16,492,3482,92,3574
RAJASTHAN,2002,MURDER,0,0,0,1059,27,1086,1396,79,1475,433,2,435,2888,108,2996
RAJASTHAN,2002,ATTEMPT TO COMMIT MURDER,0,0,0,84,5,89,117,19,136,49,5,54,250,29,279
RAJASTHAN,2002,C.H. NOT AMOUNTING TO MURDER,0,0,0,27,1,28,31,2,33,8,0,8,66,3,69
RAJASTHAN,2002,RAPE,0,0,0,178,0,178,115,2,117,25,0,25,318,2,320
RAJASTHAN,2002,KIDNAPPING AND ABDUCTION,0,0,0,13,0,13,24,0,24,1,0,1,38,0,38
RAJASTHAN,2002,DACOITY,0,0,0,62,0,62,59,0,59,6,0,6,127,0,127
RAJASTHAN,2002,PREP. AND ASSEMBLY FOR DACOITY,0,0,0,0,0,0,0,0,0,0,0,0,0,0,0
RAJASTHAN,2002,ROBBERY,0,0,0,17,0,17,16,0,16,5,0,5,38,0,38
RAJASTHAN,2002,BURGLARY,0,0,0,9,0,9,6,0,6,0,0,0,15,0,15
RAJASTHAN,2002,THEFTS,0,0,0,71,2,73,64,4,68,4,0,4,139,6,145
RAJASTHAN,2002,EXTORTION,0,0,0,2,0,2,2,0,2,0,0,0,4,0,4
RAJASTHAN,2002,RIOTS,0,0,0,13,0,13,11,0,11,2,0,2,26,0,26
RAJASTHAN,2002,ARSON,0,0,0,0,0,0,0,0,0,0,0,0,0,0,0
RAJASTHAN,2002,CRIMINAL BREACH OF TRUST,0,0,0,3,0,3,6,0,6,0,0,0,9,0,9
RAJASTHAN,2002,CHEATING,0,0,0,8,1,9,5,2,7,1,0,1,14,3,17
RAJASTHAN,2002,COUNTER FEITING,0,0,0,12,0,12,14,0,14,4,0,4,30,0,30
RAJASTHAN,2002,DOWRY DEATHS,0,0,0,81,3,84,76,4,80,54,3,57,211,10,221
RAJASTHAN,2002,MOLESTATION,0,0,0,3,0,3,2,0,2,0,0,0,5,0,5
RAJASTHAN,2002,EVE-TEASING,0,0,0,0,0,0,0,0,0,0,0,0,0,0,0
RAJASTHAN,2002,CRUELTY BY HUSBAND OR RELATIVE OF HUSBAND,0,0,0,2,1,3,5,2,7,0,1,1,7,4,11
RAJASTHAN,2002,OTHER IPC CRIMES,0,0,0,25,0,25,29,1,30,2,0,2,56,1,57
RAJASTHAN,2002,TOTAL IPC,0,0,0,1669,40,1709,1978,115,2093,594,11,605,4241,166,4407
RAJASTHAN,2003,MURDER,0,0,0,1427,24,1451,1727,60,1787,583,12,595,3737,96,3833
RAJASTHAN,2003,ATTEMPT TO COMMIT MURDER,0,0,0,158,8,166,113,22,135,51,4,55,322,34,356
RAJASTHAN,2003,C.H. NOT AMOUNTING TO MURDER,0,0,0,36,7,43,51,8,59,19,0,19,106,15,121
RAJASTHAN,2003,RAPE,0,0,0,224,0,224,111,0,111,25,0,25,360,0,360
RAJASTHAN,2003,KIDNAPPING AND ABDUCTION,0,0,0,11,0,11,15,0,15,0,0,0,26,0,26
RAJASTHAN,2003,DACOITY,0,0,0,73,0,73,45,0,45,6,0,6,124,0,124
RAJASTHAN,2003,PREP. AND ASSEMBLY FOR DACOITY,0,0,0,10,0,10,0,0,0,0,0,0,10,0,10
RAJASTHAN,2003,ROBBERY,0,0,0,13,0,13,10,0,10,3,0,3,26,0,26
RAJASTHAN,2003,BURGLARY,0,0,0,18,0,18,7,0,7,1,0,1,26,0,26
RAJASTHAN,2003,THEFTS,0,0,0,89,4,93,47,2,49,6,0,6,142,6,148
RAJASTHAN,2003,EXTORTION,0,0,0,8,0,8,2,0,2,1,0,1,11,0,11
RAJASTHAN,2003,RIOTS,0,0,0,14,0,14,33,0,33,6,0,6,53,0,53
RAJASTHAN,2003,ARSON,0,0,0,0,0,0,0,0,0,0,0,0,0,0,0
RAJASTHAN,2003,CRIMINAL BREACH OF TRUST,0,0,0,4,0,4,4,0,4,1,0,1,9,0,9
RAJASTHAN,2003,CHEATING,0,0,0,15,0,15,13,2,15,5,0,5,33,2,35
RAJASTHAN,2003,COUNTER FEITING,0,0,0,10,0,10,14,0,14,6,0,6,30,0,30
RAJASTHAN,2003,DOWRY DEATHS,0,0,0,73,3,76,84,7,91,39,2,41,196,12,208
RAJASTHAN,2003,MOLESTATION,0,0,0,0,0,0,0,0,0,0,0,0,0,0,0
RAJASTHAN,2003,EVE-TEASING,0,0,0,0,0,0,0,0,0,0,0,0,0,0,0
RAJASTHAN,2003,CRUELTY BY HUSBAND OR RELATIVE OF HUSBAND,0,0,0,5,1,6,4,1,5,1,0,1,10,2,12
RAJASTHAN,2003,OTHER IPC CRIMES,0,0,0,48,0,48,36,0,36,10,0,10,94,0,94
RAJASTHAN,2003,TOTAL IPC,0,0,0,2236,47,2283,2316,102,2418,763,18,781,5315,167,5482
RAJASTHAN,2004,MURDER,0,0,0,1382,13,1395,1578,40,1618,552,16,568,3512,69,3581
RAJASTHAN,2004,ATTEMPT TO COMMIT MURDER,0,0,0,69,4,73,132,12,144,55,6,61,256,22,278
RAJASTHAN,2004,C.H. NOT AMOUNTING TO MURDER,0,0,0,9,0,9,41,0,41,8,0,8,58,0,58
RAJASTHAN,2004,RAPE,0,0,0,124,0,124,129,1,130,41,1,42,294,2,296
RAJASTHAN,2004,KIDNAPPING AND ABDUCTION,0,0,0,28,0,28,25,0,25,1,0,1,54,0,54
RAJASTHAN,2004,DACOITY,0,0,0,119,0,119,82,3,85,21,3,24,222,6,228
RAJASTHAN,2004,PREP. AND ASSEMBLY FOR DACOITY,0,0,0,88,2,90,49,3,52,23,0,23,160,5,165
RAJASTHAN,2004,ROBBERY,0,0,0,36,0,36,19,1,20,6,2,8,61,3,64
RAJASTHAN,2004,BURGLARY,0,0,0,10,0,10,15,0,15,4,0,4,29,0,29
RAJASTHAN,2004,THEFTS,0,0,0,76,2,78,59,5,64,14,4,18,149,11,160
RAJASTHAN,2004,EXTORTION,0,0,0,4,0,4,2,0,2,3,0,3,9,0,9
RAJASTHAN,2004,RIOTS,0,0,0,7,0,7,6,0,6,0,0,0,13,0,13
RAJASTHAN,2004,ARSON,0,0,0,0,0,0,0,0,0,0,0,0,0,0,0
RAJASTHAN,2004,CRIMINAL BREACH OF TRUST,0,0,0,0,1,1,0,2,2,1,1,2,1,4,5
RAJASTHAN,2004,CHEATING,0,0,0,1,0,1,9,0,9,3,0,3,13,0,13
RAJASTHAN,2004,COUNTER FEITING,0,0,0,18,0,18,9,1,10,3,0,3,30,1,31
RAJASTHAN,2004,DOWRY DEATHS,0,0,0,49,4,53,75,14,89,38,4,42,162,22,184
RAJASTHAN,2004,MOLESTATION,0,0,0,1,0,1,4,0,4,0,0,0,5,0,5
RAJASTHAN,2004,EVE-TEASING,0,0,0,0,0,0,0,0,0,0,0,0,0,0,0
RAJASTHAN,2004,CRUELTY BY HUSBAND OR RELATIVE OF HUSBAND,0,0,0,9,0,9,5,2,7,6,1,7,20,3,23
RAJASTHAN,2004,OTHER IPC CRIMES,0,0,0,13,3,16,25,9,34,17,4,21,55,16,71
RAJASTHAN,2004,TOTAL IPC,0,0,0,2043,29,2072,2264,93,2357,796,42,838,5103,164,5267
RAJASTHAN,2005,MURDER,0,0,0,1187,29,1216,1657,73,1730,415,10,425,3259,112,3371
RAJASTHAN,2005,ATTEMPT TO COMMIT MURDER,0,0,0,97,1,98,105,2,107,23,1,24,225,4,229
RAJASTHAN,2005,C.H. NOT AMOUNTING TO MURDER,0,0,0,29,1,30,41,2,43,18,1,19,88,4,92
RAJASTHAN,2005,RAPE,0,0,0,221,0,221,141,3,144,41,1,42,403,4,407
RAJASTHAN,2005,KIDNAPPING AND ABDUCTION,0,0,0,11,0,11,11,1,12,2,0,2,24,1,25
RAJASTHAN,2005,DACOITY,0,0,0,58,0,58,48,0,48,12,0,12,118,0,118
RAJASTHAN,2005,PREP. AND ASSEMBLY FOR DACOITY,0,0,0,0,0,0,0,0,0,0,0,0,0,0,0
RAJASTHAN,2005,ROBBERY,0,0,0,22,0,22,20,0,20,2,0,2,44,0,44
RAJASTHAN,2005,BURGLARY,0,0,0,11,0,11,8,0,8,7,0,7,26,0,26
RAJASTHAN,2005,THEFTS,0,0,0,97,1,98,54,0,54,7,0,7,158,1,159
RAJASTHAN,2005,EXTORTION,0,0,0,3,0,3,1,0,1,0,0,0,4,0,4
RAJASTHAN,2005,RIOTS,0,0,0,1,0,1,2,0,2,1,0,1,4,0,4
RAJASTHAN,2005,ARSON,0,0,0,1,0,1,0,0,0,0,0,0,1,0,1
RAJASTHAN,2005,CRIMINAL BREACH OF TRUST,0,0,0,2,0,2,3,0,3,1,0,1,6,0,6
RAJASTHAN,2005,CHEATING,0,0,0,5,0,5,12,0,12,5,0,5,22,0,22
RAJASTHAN,2005,COUNTER FEITING,0,0,0,7,0,7,7,0,7,4,0,4,18,0,18
RAJASTHAN,2005,DOWRY DEATHS,0,0,0,90,0,90,100,0,100,26,0,26,216,0,216
RAJASTHAN,2005,MOLESTATION,0,0,0,1,0,1,1,0,1,1,0,1,3,0,3
RAJASTHAN,2005,EVE-TEASING,0,0,0,1,0,1,2,0,2,0,1,1,3,1,4
RAJASTHAN,2005,CRUELTY BY HUSBAND OR RELATIVE OF HUSBAND,0,0,0,6,0,6,4,1,5,2,0,2,12,1,13
RAJASTHAN,2005,OTHER IPC CRIMES,0,0,0,34,0,34,25,2,27,9,1,10,68,3,71
RAJASTHAN,2005,TOTAL IPC,0,0,0,1884,32,1916,2242,84,2326,576,15,591,4702,131,4833
RAJASTHAN,2006,MURDER,0,0,0,835,17,852,1937,62,1999,489,31,520,3261,110,3371
RAJASTHAN,2006,ATTEMPT TO COMMIT MURDER,0,0,0,87,1,88,112,0,112,26,0,26,225,1,226
RAJASTHAN,2006,C.H. NOT AMOUNTING TO MURDER,0,0,0,26,0,26,37,0,37,7,0,7,70,0,70
RAJASTHAN,2006,RAPE,0,0,0,195,0,195,117,1,118,32,0,32,344,1,345
RAJASTHAN,2006,KIDNAPPING AND ABDUCTION,0,0,0,26,0,26,21,0,21,3,0,3,50,0,50
RAJASTHAN,2006,DACOITY,0,0,0,84,0,84,61,0,61,9,0,9,154,0,154
RAJASTHAN,2006,PREP. AND ASSEMBLY FOR DACOITY,0,0,0,0,0,0,0,0,0,0,0,0,0,0,0
RAJASTHAN,2006,ROBBERY,0,0,0,35,0,35,17,0,17,2,0,2,54,0,54
RAJASTHAN,2006,BURGLARY,0,0,0,7,0,7,1,0,1,0,0,0,8,0,8
RAJASTHAN,2006,THEFTS,0,0,0,132,1,133,99,3,102,14,0,14,245,4,249
RAJASTHAN,2006,EXTORTION,0,0,0,1,0,1,0,0,0,0,0,0,1,0,1
RAJASTHAN,2006,RIOTS,0,0,0,9,0,9,2,0,2,0,0,0,11,0,11
RAJASTHAN,2006,ARSON,0,0,0,0,0,0,0,0,0,0,0,0,0,0,0
RAJASTHAN,2006,CRIMINAL BREACH OF TRUST,0,0,0,0,0,0,2,0,2,0,0,0,2,0,2
RAJASTHAN,2006,CHEATING,0,0,0,14,0,14,12,0,12,1,0,1,27,0,27
RAJASTHAN,2006,COUNTER FEITING,0,0,0,9,0,9,10,0,10,4,0,4,23,0,23
RAJASTHAN,2006,DOWRY DEATHS,0,0,0,107,7,114,135,27,162,22,22,44,264,56,320
RAJASTHAN,2006,MOLESTATION,0,0,0,0,0,0,0,0,0,0,0,0,0,0,0
RAJASTHAN,2006,EVE-TEASING,0,0,0,0,0,0,1,0,1,0,0,0,1,0,1
RAJASTHAN,2006,CRUELTY BY HUSBAND OR RELATIVE OF HUSBAND,0,0,0,2,0,2,3,0,3,0,0,0,5,0,5
RAJASTHAN,2006,OTHER IPC CRIMES,0,0,0,61,0,61,67,0,67,3,0,3,131,0,131
RAJASTHAN,2006,TOTAL IPC,0,0,0,1630,26,1656,2634,93,2727,612,53,665,4876,172,5048
RAJASTHAN,2007,MURDER,0,0,0,924,14,938,1977,76,2053,600,27,627,3501,117,3618
RAJASTHAN,2007,ATTEMPT TO COMMIT MURDER,0,0,0,68,2,70,86,2,88,14,0,14,168,4,172
RAJASTHAN,2007,C.H. NOT AMOUNTING TO MURDER,0,0,0,26,0,26,77,0,77,17,0,17,120,0,120
RAJASTHAN,2007,RAPE,0,0,0,171,2,173,127,1,128,26,0,26,324,3,327
RAJASTHAN,2007,KIDNAPPING AND ABDUCTION,0,0,0,28,2,30,25,0,25,10,1,11,63,3,66
RAJASTHAN,2007,DACOITY,0,0,0,58,0,58,69,0,69,8,0,8,135,0,135
RAJASTHAN,2007,PREP. AND ASSEMBLY FOR DACOITY,0,0,0,12,0,12,3,0,3,1,0,1,16,0,16
RAJASTHAN,2007,ROBBERY,0,0,0,44,0,44,17,0,17,16,0,16,77,0,77
RAJASTHAN,2007,BURGLARY,0,0,0,6,0,6,1,0,1,0,0,0,7,0,7
RAJASTHAN,2007,THEFTS,0,0,0,187,5,192,112,0,112,39,0,39,338,5,343
RAJASTHAN,2007,EXTORTION,0,0,0,0,0,0,1,0,1,0,0,0,1,0,1
RAJASTHAN,2007,RIOTS,0,0,0,4,0,4,0,0,0,0,0,0,4,0,4
RAJASTHAN,2007,ARSON,0,0,0,0,0,0,0,0,0,0,0,0,0,0,0
RAJASTHAN,2007,CRIMINAL BREACH OF TRUST,0,0,0,6,0,6,7,0,7,4,0,4,17,0,17
RAJASTHAN,2007,CHEATING,0,0,0,22,0,22,16,0,16,14,0,14,52,0,52
RAJASTHAN,2007,COUNTER FEITING,0,0,0,4,0,4,4,0,4,2,0,2,10,0,10
RAJASTHAN,2007,DOWRY DEATHS,0,0,0,86,16,102,85,9,94,10,17,27,181,42,223
RAJASTHAN,2007,MOLESTATION,0,0,0,0,0,0,2,0,2,0,0,0,2,0,2
RAJASTHAN,2007,EVE-TEASING,0,0,0,1,0,1,0,0,0,0,0,0,1,0,1
RAJASTHAN,2007,CRUELTY BY HUSBAND OR RELATIVE OF HUSBAND,0,0,0,7,0,7,11,0,11,4,0,4,22,0,22
RAJASTHAN,2007,OTHER IPC CRIMES,0,0,0,25,1,26,67,0,67,9,1,10,101,2,103
RAJASTHAN,2007,TOTAL IPC,0,0,0,1679,42,1721,2687,88,2775,774,46,820,5140,176,5316
RAJASTHAN,2008,MURDER,0,0,0,948,10,958,1902,85,1987,560,31,591,3410,126,3536
RAJASTHAN,2008,ATTEMPT TO COMMIT MURDER,0,0,0,88,0,88,112,2,114,21,1,22,221,3,224
RAJASTHAN,2008,C.H. NOT AMOUNTING TO MURDER,0,0,0,31,0,31,71,1,72,13,2,15,115,3,118
RAJASTHAN,2008,RAPE,0,0,0,202,4,206,144,1,145,38,0,38,384,5,389
RAJASTHAN,2008,KIDNAPPING AND ABDUCTION,0,0,0,42,1,43,41,3,44,10,0,10,93,4,97
RAJASTHAN,2008,DACOITY,0,0,0,40,0,40,35,0,35,11,0,11,86,0,86
RAJASTHAN,2008,PREP. AND ASSEMBLY FOR DACOITY,0,0,0,21,0,21,18,0,18,11,0,11,50,0,50
RAJASTHAN,2008,ROBBERY,0,0,0,27,0,27,21,0,21,8,0,8,56,0,56
RAJASTHAN,2008,BURGLARY,0,0,0,21,0,21,6,0,6,13,0,13,40,0,40
RAJASTHAN,2008,THEFTS,0,0,0,155,1,156,77,0,77,8,0,8,240,1,241
RAJASTHAN,2008,EXTORTION,0,0,0,22,0,22,18,0,18,11,0,11,51,0,51
RAJASTHAN,2008,RIOTS,0,0,0,10,0,10,24,0,24,6,0,6,40,0,40
RAJASTHAN,2008,ARSON,0,0,0,8,0,8,2,0,2,0,0,0,10,0,10
RAJASTHAN,2008,CRIMINAL BREACH OF TRUST,0,0,0,8,0,8,6,0,6,0,0,0,14,0,14
RAJASTHAN,2008,CHEATING,0,0,0,29,0,29,22,1,23,6,0,6,57,1,58
RAJASTHAN,2008,COUNTER FEITING,0,0,0,15,0,15,8,0,8,7,0,7,30,0,30
RAJASTHAN,2008,DOWRY DEATHS,0,0,0,75,1,76,92,31,123,24,18,42,191,50,241
RAJASTHAN,2008,MOLESTATION,0,0,0,2,0,2,1,0,1,1,0,1,4,0,4
RAJASTHAN,2008,EVE-TEASING,0,0,0,4,0,4,3,0,3,0,0,0,7,0,7
RAJASTHAN,2008,CRUELTY BY HUSBAND OR RELATIVE OF HUSBAND,0,0,0,22,0,22,32,0,32,5,0,5,59,0,59
RAJASTHAN,2008,OTHER IPC CRIMES,0,0,0,62,1,63,43,0,43,14,0,14,119,1,120
RAJASTHAN,2008,TOTAL IPC,0,0,0,1832,18,1850,2678,124,2802,767,52,819,5277,194,5471
RAJASTHAN,2009,MURDER,0,0,0,1014,41,1055,1994,90,2084,663,27,690,3671,158,3829
RAJASTHAN,2009,ATTEMPT TO COMMIT MURDER,0,0,0,94,0,94,123,1,124,26,0,26,243,1,244
RAJASTHAN,2009,C.H. NOT AMOUNTING TO MURDER,0,0,0,34,0,34,50,0,50,14,0,14,98,0,98
RAJASTHAN,2009,RAPE,0,0,0,202,2,204,171,5,176,47,0,47,420,7,427
RAJASTHAN,2009,KIDNAPPING AND ABDUCTION,0,0,0,44,2,46,63,3,66,8,1,9,115,6,121
RAJASTHAN,2009,DACOITY,0,0,0,37,0,37,68,0,68,10,0,10,115,0,115
RAJASTHAN,2009,PREP. AND ASSEMBLY FOR DACOITY,0,0,0,8,0,8,6,0,6,4,0,4,18,0,18
RAJASTHAN,2009,ROBBERY,0,0,0,30,0,30,26,0,26,10,0,10,66,0,66
RAJASTHAN,2009,BURGLARY,0,0,0,1,0,1,0,0,0,0,0,0,1,0,1
RAJASTHAN,2009,THEFTS,0,0,0,110,0,110,128,2,130,14,0,14,252,2,254
RAJASTHAN,2009,EXTORTION,0,0,0,6,0,6,3,0,3,0,0,0,9,0,9
RAJASTHAN,2009,RIOTS,0,0,0,2,0,2,1,0,1,0,0,0,3,0,3
RAJASTHAN,2009,ARSON,0,0,0,0,0,0,1,0,1,0,0,0,1,0,1
RAJASTHAN,2009,CRIMINAL BREACH OF TRUST,0,0,0,5,0,5,3,0,3,0,0,0,8,0,8
RAJASTHAN,2009,CHEATING,0,0,0,35,0,35,40,0,40,18,0,18,93,0,93
RAJASTHAN,2009,COUNTER FEITING,0,0,0,9,0,9,15,1,16,5,0,5,29,1,30
RAJASTHAN,2009,DOWRY DEATHS,0,0,0,63,0,63,92,23,115,38,0,38,193,23,216
RAJASTHAN,2009,MOLESTATION,0,0,0,1,0,1,5,0,5,0,0,0,6,0,6
RAJASTHAN,2009,EVE-TEASING,0,0,0,0,0,0,0,0,0,0,0,0,0,0,0
RAJASTHAN,2009,CRUELTY BY HUSBAND OR RELATIVE OF HUSBAND,0,0,0,5,0,5,17,0,17,6,0,6,28,0,28
RAJASTHAN,2009,OTHER IPC CRIMES,0,0,0,37,8,45,61,0,61,12,0,12,110,8,118
RAJASTHAN,2009,TOTAL IPC,0,0,0,1737,53,1790,2867,125,2992,875,28,903,5479,206,5685
RAJASTHAN,2010,MURDER,0,0,0,1113,32,1145,1886,81,1967,556,41,597,3555,154,3709
RAJASTHAN,2010,ATTEMPT TO COMMIT MURDER,0,0,0,45,1,46,75,1,76,11,0,11,131,2,133
RAJASTHAN,2010,C.H. NOT AMOUNTING TO MURDER,0,0,0,33,0,33,45,0,45,25,0,25,103,0,103
RAJASTHAN,2010,RAPE,0,0,0,120,2,122,143,2,145,38,0,38,301,4,305
RAJASTHAN,2010,KIDNAPPING AND ABDUCTION,0,0,0,26,0,26,33,2,35,11,0,11,70,2,72
RAJASTHAN,2010,DACOITY,0,0,0,52,0,52,57,0,57,13,0,13,122,0,122
RAJASTHAN,2010,PREP. AND ASSEMBLY FOR DACOITY,0,0,0,7,0,7,7,0,7,6,0,6,20,0,20
RAJASTHAN,2010,ROBBERY,0,0,0,34,0,34,34,0,34,5,0,5,73,0,73
RAJASTHAN,2010,BURGLARY,0,0,0,6,0,6,0,0,0,0,0,0,6,0,6
RAJASTHAN,2010,THEFTS,0,0,0,113,0,113,94,2,96,17,0,17,224,2,226
RAJASTHAN,2010,EXTORTION,0,0,0,3,0,3,2,0,2,0,0,0,5,0,5
RAJASTHAN,2010,RIOTS,0,0,0,8,0,8,3,0,3,1,0,1,12,0,12
RAJASTHAN,2010,ARSON,0,0,0,0,0,0,1,0,1,0,0,0,1,0,1
RAJASTHAN,2010,CRIMINAL BREACH OF TRUST,0,0,0,3,0,3,2,0,2,0,0,0,5,0,5
RAJASTHAN,2010,CHEATING,0,0,0,17,0,17,38,2,40,11,0,11,66,2,68
RAJASTHAN,2010,COUNTER FEITING,0,0,0,7,0,7,11,1,12,4,0,4,22,1,23
RAJASTHAN,2010,DOWRY DEATHS,0,0,0,83,0,83,74,15,89,29,18,47,186,33,219
RAJASTHAN,2010,MOLESTATION,0,0,0,6,0,6,2,0,2,2,0,2,10,0,10
RAJASTHAN,2010,EVE-TEASING,0,0,0,0,0,0,0,3,3,0,0,0,0,3,3
RAJASTHAN,2010,CRUELTY BY HUSBAND OR RELATIVE OF HUSBAND,0,0,0,5,0,5,10,0,10,3,0,3,18,0,18
RAJASTHAN,2010,OTHER IPC CRIMES,0,0,0,52,0,52,78,0,78,22,0,22,152,0,152
RAJASTHAN,2010,TOTAL IPC,0,0,0,1733,35,1768,2595,109,2704,754,59,813,5082,203,5285
RAJASTHAN,2011,MURDER,0,0,0,1011,30,1041,1708,83,1791,523,39,562,3242,152,3394
RAJASTHAN,2011,ATTEMPT TO COMMIT MURDER,0,0,0,96,0,96,62,0,62,49,1,50,207,1,208
RAJASTHAN,2011,C.H. NOT AMOUNTING TO MURDER,0,0,0,28,0,28,54,0,54,36,0,36,118,0,118
RAJASTHAN,2011,RAPE,0,0,0,166,0,166,76,7,83,39,0,39,281,7,288
RAJASTHAN,2011,KIDNAPPING AND ABDUCTION,0,0,0,33,0,33,41,3,44,26,0,26,100,3,103
RAJASTHAN,2011,DACOITY,0,0,0,51,0,51,39,0,39,7,0,7,97,0,97
RAJASTHAN,2011,PREP. AND ASSEMBLY FOR DACOITY,0,0,0,7,0,7,19,0,19,9,0,9,35,0,35
RAJASTHAN,2011,ROBBERY,0,0,0,36,0,36,28,0,28,10,0,10,74,0,74
RAJASTHAN,2011,BURGLARY,0,0,0,12,0,12,6,0,6,8,0,8,26,0,26
RAJASTHAN,2011,THEFTS,0,0,0,142,1,143,54,3,57,6,0,6,202,4,206
RAJASTHAN,2011,EXTORTION,0,0,0,4,0,4,2,0,2,0,0,0,6,0,6
RAJASTHAN,2011,RIOTS,0,0,0,4,0,4,5,0,5,0,0,0,9,0,9
RAJASTHAN,2011,ARSON,0,0,0,4,0,4,4,0,4,0,0,0,8,0,8
RAJASTHAN,2011,CRIMINAL BREACH OF TRUST,0,0,0,0,0,0,1,0,1,0,0,0,1,0,1
RAJASTHAN,2011,CHEATING,0,0,0,26,0,26,27,0,27,16,0,16,69,0,69
RAJASTHAN,2011,COUNTER FEITING,0,0,0,4,0,4,9,1,10,11,0,11,24,1,25
RAJASTHAN,2011,DOWRY DEATHS,0,0,0,158,3,161,88,12,100,54,21,75,300,36,336
RAJASTHAN,2011,MOLESTATION,0,0,0,5,0,5,4,0,4,1,0,1,10,0,10
RAJASTHAN,2011,EVE-TEASING,0,0,0,1,0,1,0,0,0,0,0,0,1,0,1
RAJASTHAN,2011,CRUELTY BY HUSBAND OR RELATIVE OF HUSBAND,0,0,0,14,0,14,15,0,15,21,1,22,50,1,51
RAJASTHAN,2011,OTHER IPC CRIMES,0,0,0,37,0,37,59,0,59,8,0,8,104,0,104
RAJASTHAN,2011,TOTAL IPC,0,0,0,1839,34,1873,2301,109,2410,824,62,886,4964,205,5169
RAJASTHAN,2012,MURDER,0,0,0,893,65,958,1720,71,1791,475,42,517,3088,178,3266
RAJASTHAN,2012,ATTEMPT TO COMMIT MURDER,0,0,0,85,0,85,88,2,90,23,0,23,196,2,198
RAJASTHAN,2012,C.H. NOT AMOUNTING TO MURDER,0,0,0,31,0,31,56,0,56,12,0,12,99,0,99
RAJASTHAN,2012,RAPE,0,0,0,176,7,183,144,2,146,22,1,23,342,10,352
RAJASTHAN,2012,KIDNAPPING AND ABDUCTION,0,0,0,34,0,34,40,3,43,12,0,12,86,3,89
RAJASTHAN,2012,DACOITY,0,0,0,36,0,36,43,0,43,12,0,12,91,0,91
RAJASTHAN,2012,PREP. AND ASSEMBLY FOR DACOITY,0,0,0,18,0,18,18,0,18,8,0,8,44,0,44
RAJASTHAN,2012,ROBBERY,0,0,0,36,0,36,60,0,60,6,0,6,102,0,102
RAJASTHAN,2012,BURGLARY,0,0,0,20,0,20,10,0,10,2,0,2,32,0,32
RAJASTHAN,2012,THEFTS,0,0,0,91,2,93,98,3,101,9,0,9,198,5,203
RAJASTHAN,2012,EXTORTION,0,0,0,10,0,10,15,0,15,2,0,2,27,0,27
RAJASTHAN,2012,RIOTS,0,0,0,14,0,14,14,0,14,4,0,4,32,0,32
RAJASTHAN,2012,ARSON,0,0,0,3,0,3,5,0,5,1,0,1,9,0,9
RAJASTHAN,2012,CRIMINAL BREACH OF TRUST,0,0,0,1,0,1,0,0,0,1,0,1,2,0,2
RAJASTHAN,2012,CHEATING,0,0,0,14,0,14,29,0,29,5,0,5,48,0,48
RAJASTHAN,2012,COUNTER FEITING,0,0,0,7,0,7,14,0,14,0,0,0,21,0,21
RAJASTHAN,2012,DOWRY DEATHS,0,0,0,59,2,61,103,14,117,26,5,31,188,21,209
RAJASTHAN,2012,MOLESTATION,0,0,0,3,0,3,4,0,4,1,0,1,8,0,8
RAJASTHAN,2012,EVE-TEASING,0,0,0,5,0,5,6,0,6,0,0,0,11,0,11
RAJASTHAN,2012,CRUELTY BY HUSBAND OR RELATIVE OF HUSBAND,0,0,0,4,0,4,3,4,7,1,2,3,8,6,14
RAJASTHAN,2012,OTHER IPC CRIMES,0,0,0,46,0,46,42,0,42,11,0,11,99,0,99
RAJASTHAN,2012,TOTAL IPC,0,0,0,1586,76,1662,2512,99,2611,633,50,683,4731,225,4956
SIKKIM,2001,MURDER,0,0,0,6,0,6,5,0,5,4,0,4,15,0,15
SIKKIM,2001,ATTEMPT TO COMMIT MURDER,0,0,0,1,0,1,2,0,2,0,0,0,3,0,3
SIKKIM,2001,C.H. NOT AMOUNTING TO MURDER,0,0,0,3,0,3,0,0,0,4,0,4,7,0,7
SIKKIM,2001,RAPE,0,0,0,8,0,8,3,0,3,1,0,1,12,0,12
SIKKIM,2001,KIDNAPPING AND ABDUCTION,0,0,0,0,0,0,2,0,2,0,0,0,2,0,2
SIKKIM,2001,DACOITY,0,0,0,0,0,0,0,0,0,0,0,0,0,0,0
SIKKIM,2001,PREP. AND ASSEMBLY FOR DACOITY,0,0,0,0,0,0,0,0,0,0,0,0,0,0,0
SIKKIM,2001,ROBBERY,0,0,0,0,0,0,0,0,0,0,0,0,0,0,0
SIKKIM,2001,BURGLARY,0,0,0,0,0,0,1,0,1,0,0,0,1,0,1
SIKKIM,2001,THEFTS,0,0,0,7,0,7,3,0,3,1,0,1,11,0,11
SIKKIM,2001,EXTORTION,0,0,0,5,0,5,0,0,0,0,0,0,5,0,5
SIKKIM,2001,RIOTS,0,0,0,0,0,0,0,0,0,0,0,0,0,0,0
SIKKIM,2001,ARSON,0,0,0,0,0,0,0,0,0,0,0,0,0,0,0
SIKKIM,2001,CRIMINAL BREACH OF TRUST,0,0,0,0,0,0,1,0,1,0,0,0,1,0,1
SIKKIM,2001,CHEATING,0,0,0,0,0,0,5,0,5,2,0,2,7,0,7
SIKKIM,2001,COUNTER FEITING,0,0,0,0,0,0,0,0,0,0,0,0,0,0,0
SIKKIM,2001,DOWRY DEATHS,0,0,0,0,0,0,0,0,0,0,0,0,0,0,0
SIKKIM,2001,MOLESTATION,0,0,0,0,0,0,0,0,0,0,0,0,0,0,0
SIKKIM,2001,EVE-TEASING,0,0,0,0,0,0,0,0,0,0,0,0,0,0,0
SIKKIM,2001,CRUELTY BY HUSBAND OR RELATIVE OF HUSBAND,0,0,0,0,0,0,0,0,0,0,0,0,0,0,0
SIKKIM,2001,OTHER IPC CRIMES,0,0,0,5,0,5,4,0,4,4,0,4,13,0,13
SIKKIM,2001,TOTAL IPC,0,0,0,35,0,35,26,0,26,16,0,16,77,0,77
SIKKIM,2002,MURDER,0,0,0,8,0,8,5,0,5,2,0,2,15,0,15
SIKKIM,2002,ATTEMPT TO COMMIT MURDER,0,0,0,2,0,2,3,0,3,0,0,0,5,0,5
SIKKIM,2002,C.H. NOT AMOUNTING TO MURDER,0,0,0,1,0,1,2,0,2,3,0,3,6,0,6
SIKKIM,2002,RAPE,0,0,0,2,0,2,3,0,3,2,0,2,7,0,7
SIKKIM,2002,KIDNAPPING AND ABDUCTION,0,0,0,0,0,0,0,0,0,0,0,0,0,0,0
SIKKIM,2002,DACOITY,0,0,0,0,0,0,0,0,0,0,0,0,0,0,0
SIKKIM,2002,PREP. AND ASSEMBLY FOR DACOITY,0,0,0,0,0,0,0,0,0,0,0,0,0,0,0
SIKKIM,2002,ROBBERY,0,0,0,8,0,8,2,0,2,0,0,0,10,0,10
SIKKIM,2002,BURGLARY,0,0,0,2,0,2,0,0,0,0,0,0,2,0,2
SIKKIM,2002,THEFTS,0,0,0,10,0,10,5,0,5,4,0,4,19,0,19
SIKKIM,2002,EXTORTION,0,0,0,0,0,0,0,0,0,0,0,0,0,0,0
SIKKIM,2002,RIOTS,0,0,0,0,0,0,0,0,0,0,0,0,0,0,0
SIKKIM,2002,ARSON,0,0,0,0,0,0,0,0,0,0,0,0,0,0,0
SIKKIM,2002,CRIMINAL BREACH OF TRUST,0,0,0,0,0,0,0,0,0,0,0,0,0,0,0
SIKKIM,2002,CHEATING,0,0,0,0,0,0,2,0,2,0,0,0,2,0,2
SIKKIM,2002,COUNTER FEITING,0,0,0,0,0,0,0,0,0,0,0,0,0,0,0
SIKKIM,2002,DOWRY DEATHS,0,0,0,0,0,0,0,0,0,0,0,0,0,0,0
SIKKIM,2002,MOLESTATION,0,0,0,0,0,0,0,0,0,0,0,0,0,0,0
SIKKIM,2002,EVE-TEASING,0,0,0,0,0,0,0,0,0,0,0,0,0,0,0
SIKKIM,2002,CRUELTY BY HUSBAND OR RELATIVE OF HUSBAND,0,0,0,0,0,0,0,0,0,0,0,0,0,0,0
SIKKIM,2002,OTHER IPC CRIMES,0,0,0,2,0,2,1,0,1,4,0,4,7,0,7
SIKKIM,2002,TOTAL IPC,0,0,0,35,0,35,23,0,23,15,0,15,73,0,73
SIKKIM,2003,MURDER,0,0,0,17,1,18,8,0,8,2,0,2,27,1,28
SIKKIM,2003,ATTEMPT TO COMMIT MURDER,0,0,0,4,0,4,2,0,2,0,0,0,6,0,6
SIKKIM,2003,C.H. NOT AMOUNTING TO MURDER,0,0,0,0,0,0,0,0,0,0,0,0,0,0,0
SIKKIM,2003,RAPE,0,0,0,0,0,0,0,0,0,0,0,0,0,0,0
SIKKIM,2003,KIDNAPPING AND ABDUCTION,0,0,0,0,0,0,0,0,0,0,0,0,0,0,0
SIKKIM,2003,DACOITY,0,0,0,0,0,0,0,0,0,0,0,0,0,0,0
SIKKIM,2003,PREP. AND ASSEMBLY FOR DACOITY,0,0,0,0,0,0,0,0,0,0,0,0,0,0,0
SIKKIM,2003,ROBBERY,0,0,0,0,0,0,0,0,0,0,0,0,0,0,0
SIKKIM,2003,BURGLARY,0,0,0,6,0,6,0,0,0,0,0,0,6,0,6
SIKKIM,2003,THEFTS,2,0,2,10,0,10,6,0,6,5,0,5,23,0,23
SIKKIM,2003,EXTORTION,0,0,0,0,0,0,0,0,0,0,0,0,0,0,0
SIKKIM,2003,RIOTS,0,0,0,0,0,0,0,0,0,0,0,0,0,0,0
SIKKIM,2003,ARSON,0,0,0,0,0,0,0,0,0,0,0,0,0,0,0
SIKKIM,2003,CRIMINAL BREACH OF TRUST,0,0,0,0,0,0,0,0,0,0,0,0,0,0,0
SIKKIM,2003,CHEATING,0,0,0,0,0,0,0,1,1,0,0,0,0,1,1
SIKKIM,2003,COUNTER FEITING,0,0,0,0,0,0,0,0,0,0,0,0,0,0,0
SIKKIM,2003,DOWRY DEATHS,0,0,0,0,0,0,0,0,0,0,0,0,0,0,0
SIKKIM,2003,MOLESTATION,0,0,0,0,0,0,0,0,0,0,0,0,0,0,0
SIKKIM,2003,EVE-TEASING,0,0,0,0,0,0,0,0,0,0,0,0,0,0,0
SIKKIM,2003,CRUELTY BY HUSBAND OR RELATIVE OF HUSBAND,0,0,0,0,0,0,0,0,0,0,0,0,0,0,0
SIKKIM,2003,OTHER IPC CRIMES,0,0,0,7,0,7,9,0,9,0,0,0,16,0,16
SIKKIM,2003,TOTAL IPC,2,0,2,44,1,45,25,1,26,7,0,7,78,2,80
SIKKIM,2004,MURDER,0,0,0,12,0,12,14,1,15,1,0,1,27,1,28
SIKKIM,2004,ATTEMPT TO COMMIT MURDER,0,0,0,1,0,1,0,0,0,0,0,0,1,0,1
SIKKIM,2004,C.H. NOT AMOUNTING TO MURDER,0,0,0,7,1,8,3,0,3,0,0,0,10,1,11
SIKKIM,2004,RAPE,0,0,0,8,0,8,2,0,2,1,0,1,11,0,11
SIKKIM,2004,KIDNAPPING AND ABDUCTION,0,0,0,0,0,0,0,0,0,0,0,0,0,0,0
SIKKIM,2004,DACOITY,0,0,0,0,0,0,0,0,0,0,0,0,0,0,0
SIKKIM,2004,PREP. AND ASSEMBLY FOR DACOITY,0,0,0,0,0,0,0,0,0,0,0,0,0,0,0
SIKKIM,2004,ROBBERY,0,0,0,0,0,0,0,0,0,0,0,0,0,0,0
SIKKIM,2004,BURGLARY,0,0,0,4,0,4,0,0,0,0,0,0,4,0,4
SIKKIM,2004,THEFTS,0,0,0,1,0,1,2,0,2,0,0,0,3,0,3
SIKKIM,2004,EXTORTION,0,0,0,0,0,0,0,0,0,0,0,0,0,0,0
SIKKIM,2004,RIOTS,0,0,0,0,0,0,0,0,0,0,0,0,0,0,0
SIKKIM,2004,ARSON,0,0,0,0,0,0,0,0,0,0,0,0,0,0,0
SIKKIM,2004,CRIMINAL BREACH OF TRUST,0,0,0,0,0,0,0,0,0,0,0,0,0,0,0
SIKKIM,2004,CHEATING,0,0,0,0,0,0,0,0,0,0,0,0,0,0,0
SIKKIM,2004,COUNTER FEITING,0,0,0,0,0,0,0,0,0,0,0,0,0,0,0
SIKKIM,2004,DOWRY DEATHS,0,0,0,0,0,0,0,0,0,0,0,0,0,0,0
SIKKIM,2004,MOLESTATION,0,0,0,0,0,0,0,0,0,0,0,0,0,0,0
SIKKIM,2004,EVE-TEASING,0,0,0,0,0,0,0,0,0,0,0,0,0,0,0
SIKKIM,2004,CRUELTY BY HUSBAND OR RELATIVE OF HUSBAND,0,0,0,0,0,0,0,0,0,0,0,0,0,0,0
SIKKIM,2004,OTHER IPC CRIMES,0,0,0,2,0,2,2,0,2,1,0,1,5,0,5
SIKKIM,2004,TOTAL IPC,0,0,0,35,1,36,23,1,24,3,0,3,61,2,63
SIKKIM,2005,MURDER,0,0,0,13,0,13,14,1,15,1,0,1,28,1,29
SIKKIM,2005,ATTEMPT TO COMMIT MURDER,0,0,0,1,0,1,0,0,0,0,0,0,1,0,1
SIKKIM,2005,C.H. NOT AMOUNTING TO MURDER,0,0,0,7,1,8,3,0,3,0,0,0,10,1,11
SIKKIM,2005,RAPE,0,0,0,9,0,9,3,0,3,1,0,1,13,0,13
SIKKIM,2005,KIDNAPPING AND ABDUCTION,0,0,0,0,0,0,0,0,0,0,0,0,0,0,0
SIKKIM,2005,DACOITY,0,0,0,0,0,0,0,0,0,0,0,0,0,0,0
SIKKIM,2005,PREP. AND ASSEMBLY FOR DACOITY,0,0,0,0,0,0,0,0,0,0,0,0,0,0,0
SIKKIM,2005,ROBBERY,0,0,0,4,0,4,0,0,0,0,0,0,4,0,4
SIKKIM,2005,BURGLARY,0,0,0,6,0,6,2,0,2,0,0,0,8,0,8
SIKKIM,2005,THEFTS,0,0,0,0,0,0,0,0,0,0,0,0,0,0,0
SIKKIM,2005,EXTORTION,0,0,0,0,0,0,0,0,0,0,0,0,0,0,0
SIKKIM,2005,RIOTS,0,0,0,0,0,0,0,0,0,0,0,0,0,0,0
SIKKIM,2005,ARSON,0,0,0,0,0,0,0,0,0,1,0,1,1,0,1
SIKKIM,2005,CRIMINAL BREACH OF TRUST,0,0,0,0,0,0,0,0,0,0,0,0,0,0,0
SIKKIM,2005,CHEATING,0,0,0,0,0,0,0,0,0,0,0,0,0,0,0
SIKKIM,2005,COUNTER FEITING,0,0,0,0,0,0,0,0,0,0,0,0,0,0,0
SIKKIM,2005,DOWRY DEATHS,0,0,0,0,0,0,0,0,0,0,0,0,0,0,0
SIKKIM,2005,MOLESTATION,0,0,0,0,0,0,0,0,0,0,0,0,0,0,0
SIKKIM,2005,EVE-TEASING,0,0,0,0,0,0,0,0,0,0,0,0,0,0,0
SIKKIM,2005,CRUELTY BY HUSBAND OR RELATIVE OF HUSBAND,0,0,0,0,0,0,0,0,0,0,0,0,0,0,0
SIKKIM,2005,OTHER IPC CRIMES,0,0,0,3,0,3,2,0,2,1,0,1,6,0,6
SIKKIM,2005,TOTAL IPC,0,0,0,43,1,44,24,1,25,4,0,4,71,2,73
SIKKIM,2006,MURDER,0,0,0,16,0,16,12,0,12,2,0,2,30,0,30
SIKKIM,2006,ATTEMPT TO COMMIT MURDER,0,0,0,0,0,0,0,0,0,0,0,0,0,0,0
SIKKIM,2006,C.H. NOT AMOUNTING TO MURDER,0,0,0,8,1,9,5,0,5,0,0,0,13,1,14
SIKKIM,2006,RAPE,0,0,0,7,0,7,1,0,1,1,0,1,9,0,9
SIKKIM,2006,KIDNAPPING AND ABDUCTION,0,0,0,0,0,0,0,0,0,0,0,0,0,0,0
SIKKIM,2006,DACOITY,0,0,0,0,0,0,0,0,0,0,0,0,0,0,0
SIKKIM,2006,PREP. AND ASSEMBLY FOR DACOITY,0,0,0,0,0,0,0,0,0,0,0,0,0,0,0
SIKKIM,2006,ROBBERY,0,0,0,1,0,1,0,0,0,0,0,0,1,0,1
SIKKIM,2006,BURGLARY,0,0,0,17,0,17,2,0,2,0,0,0,19,0,19
SIKKIM,2006,THEFTS,0,0,0,12,0,12,1,0,1,0,0,0,13,0,13
SIKKIM,2006,EXTORTION,0,0,0,0,0,0,0,0,0,0,0,0,0,0,0
SIKKIM,2006,RIOTS,0,0,0,0,0,0,0,0,0,0,0,0,0,0,0
SIKKIM,2006,ARSON,0,0,0,0,0,0,0,0,0,0,0,0,0,0,0
SIKKIM,2006,CRIMINAL BREACH OF TRUST,0,0,0,0,0,0,0,0,0,0,0,0,0,0,0
SIKKIM,2006,CHEATING,0,0,0,0,0,0,1,0,1,0,0,0,1,0,1
SIKKIM,2006,COUNTER FEITING,0,0,0,0,0,0,0,0,0,0,0,0,0,0,0
SIKKIM,2006,DOWRY DEATHS,0,0,0,0,0,0,0,0,0,0,0,0,0,0,0
SIKKIM,2006,MOLESTATION,0,0,0,0,0,0,0,0,0,0,0,0,0,0,0
SIKKIM,2006,EVE-TEASING,0,0,0,0,0,0,0,0,0,0,0,0,0,0,0
SIKKIM,2006,CRUELTY BY HUSBAND OR RELATIVE OF HUSBAND,0,0,0,0,0,0,0,0,0,0,0,0,0,0,0
SIKKIM,2006,OTHER IPC CRIMES,0,0,0,2,0,2,0,0,0,0,0,0,2,0,2
SIKKIM,2006,TOTAL IPC,0,0,0,63,1,64,22,0,22,3,0,3,88,1,89
SIKKIM,2007,MURDER,0,0,0,12,0,12,13,0,13,4,0,4,29,0,29
SIKKIM,2007,ATTEMPT TO COMMIT MURDER,0,0,0,0,0,0,0,0,0,0,0,0,0,0,0
SIKKIM,2007,C.H. NOT AMOUNTING TO MURDER,0,0,0,9,0,9,8,1,9,0,0,0,17,1,18
SIKKIM,2007,RAPE,0,0,0,2,0,2,4,0,4,1,0,1,7,0,7
SIKKIM,2007,KIDNAPPING AND ABDUCTION,0,0,0,0,0,0,0,0,0,0,0,0,0,0,0
SIKKIM,2007,DACOITY,0,0,0,0,0,0,0,0,0,0,0,0,0,0,0
SIKKIM,2007,PREP. AND ASSEMBLY FOR DACOITY,0,0,0,0,0,0,0,0,0,0,0,0,0,0,0
SIKKIM,2007,ROBBERY,0,0,0,3,0,3,0,0,0,0,0,0,3,0,3
SIKKIM,2007,BURGLARY,0,0,0,12,0,12,0,0,0,0,0,0,12,0,12
SIKKIM,2007,THEFTS,0,0,0,4,0,4,1,0,1,1,0,1,6,0,6
SIKKIM,2007,EXTORTION,0,0,0,0,0,0,0,0,0,0,0,0,0,0,0
SIKKIM,2007,RIOTS,0,0,0,0,0,0,0,0,0,0,0,0,0,0,0
SIKKIM,2007,ARSON,0,0,0,0,0,0,0,0,0,0,0,0,0,0,0
SIKKIM,2007,CRIMINAL BREACH OF TRUST,0,0,0,0,0,0,0,0,0,0,0,0,0,0,0
SIKKIM,2007,CHEATING,0,0,0,3,0,3,0,0,0,0,0,0,3,0,3
SIKKIM,2007,COUNTER FEITING,0,0,0,0,0,0,0,0,0,0,0,0,0,0,0
SIKKIM,2007,DOWRY DEATHS,0,0,0,0,0,0,0,0,0,0,0,0,0,0,0
SIKKIM,2007,MOLESTATION,0,0,0,0,0,0,0,0,0,0,0,0,0,0,0
SIKKIM,2007,EVE-TEASING,0,0,0,0,0,0,0,0,0,0,0,0,0,0,0
SIKKIM,2007,CRUELTY BY HUSBAND OR RELATIVE OF HUSBAND,0,0,0,0,0,0,0,0,0,0,0,0,0,0,0
SIKKIM,2007,OTHER IPC CRIMES,0,0,0,0,0,0,0,0,0,0,0,0,0,0,0
SIKKIM,2007,TOTAL IPC,0,0,0,45,0,45,26,1,27,6,0,6,77,1,78
SIKKIM,2008,MURDER,0,0,0,12,0,12,14,0,14,5,0,5,31,0,31
SIKKIM,2008,ATTEMPT TO COMMIT MURDER,0,0,0,0,0,0,0,0,0,0,0,0,0,0,0
SIKKIM,2008,C.H. NOT AMOUNTING TO MURDER,0,0,0,6,0,6,3,1,4,0,0,0,9,1,10
SIKKIM,2008,RAPE,0,0,0,4,0,4,2,0,2,1,0,1,7,0,7
SIKKIM,2008,KIDNAPPING AND ABDUCTION,0,0,0,0,0,0,0,0,0,0,0,0,0,0,0
SIKKIM,2008,DACOITY,0,0,0,0,0,0,0,0,0,0,0,0,0,0,0
SIKKIM,2008,PREP. AND ASSEMBLY FOR DACOITY,0,0,0,0,0,0,0,0,0,0,0,0,0,0,0
SIKKIM,2008,ROBBERY,0,0,0,0,0,0,0,0,0,0,0,0,0,0,0
SIKKIM,2008,BURGLARY,0,0,0,8,0,8,0,0,0,0,0,0,8,0,8
SIKKIM,2008,THEFTS,0,0,0,2,0,2,1,0,1,1,0,1,4,0,4
SIKKIM,2008,EXTORTION,0,0,0,0,0,0,0,0,0,0,0,0,0,0,0
SIKKIM,2008,RIOTS,0,0,0,0,0,0,0,0,0,0,0,0,0,0,0
SIKKIM,2008,ARSON,0,0,0,0,0,0,0,0,0,0,0,0,0,0,0
SIKKIM,2008,CRIMINAL BREACH OF TRUST,0,0,0,0,0,0,0,0,0,0,0,0,0,0,0
SIKKIM,2008,CHEATING,0,0,0,0,0,0,0,0,0,0,0,0,0,0,0
SIKKIM,2008,COUNTER FEITING,0,0,0,0,0,0,0,0,0,0,0,0,0,0,0
SIKKIM,2008,DOWRY DEATHS,0,0,0,0,0,0,0,0,0,0,0,0,0,0,0
SIKKIM,2008,MOLESTATION,0,0,0,0,0,0,0,0,0,0,0,0,0,0,0
SIKKIM,2008,EVE-TEASING,0,0,0,0,0,0,0,0,0,0,0,0,0,0,0
SIKKIM,2008,CRUELTY BY HUSBAND OR RELATIVE OF HUSBAND,0,0,0,0,0,0,0,0,0,0,0,0,0,0,0
SIKKIM,2008,OTHER IPC CRIMES,0,0,0,1,0,1,1,0,1,0,0,0,2,0,2
SIKKIM,2008,TOTAL IPC,0,0,0,33,0,33,21,1,22,7,0,7,61,1,62
SIKKIM,2009,MURDER,0,0,0,14,0,14,13,0,13,5,0,5,32,0,32
SIKKIM,2009,ATTEMPT TO COMMIT MURDER,0,0,0,0,0,0,0,0,0,0,0,0,0,0,0
SIKKIM,2009,C.H. NOT AMOUNTING TO MURDER,0,0,0,3,0,3,1,1,2,1,0,1,5,1,6
SIKKIM,2009,RAPE,0,0,0,4,0,4,3,0,3,1,0,1,8,0,8
SIKKIM,2009,KIDNAPPING AND ABDUCTION,0,0,0,0,0,0,0,0,0,0,0,0,0,0,0
SIKKIM,2009,DACOITY,0,0,0,0,0,0,0,0,0,0,0,0,0,0,0
SIKKIM,2009,PREP. AND ASSEMBLY FOR DACOITY,0,0,0,0,0,0,0,0,0,0,0,0,0,0,0
SIKKIM,2009,ROBBERY,0,0,0,0,0,0,0,0,0,0,0,0,0,0,0
SIKKIM,2009,BURGLARY,0,0,0,9,0,9,1,0,1,0,0,0,10,0,10
SIKKIM,2009,THEFTS,0,0,0,3,0,3,3,0,3,0,0,0,6,0,6
SIKKIM,2009,EXTORTION,0,0,0,0,0,0,0,0,0,0,0,0,0,0,0
SIKKIM,2009,RIOTS,0,0,0,0,0,0,0,0,0,0,0,0,0,0,0
SIKKIM,2009,ARSON,0,0,0,0,0,0,0,0,0,0,0,0,0,0,0
SIKKIM,2009,CRIMINAL BREACH OF TRUST,0,0,0,0,0,0,0,0,0,0,0,0,0,0,0
SIKKIM,2009,CHEATING,0,0,0,0,0,0,0,0,0,0,0,0,0,0,0
SIKKIM,2009,COUNTER FEITING,0,0,0,0,0,0,0,0,0,0,0,0,0,0,0
SIKKIM,2009,DOWRY DEATHS,0,0,0,0,0,0,0,0,0,0,0,0,0,0,0
SIKKIM,2009,MOLESTATION,0,0,0,0,0,0,0,0,0,0,0,0,0,0,0
SIKKIM,2009,EVE-TEASING,0,0,0,0,0,0,0,0,0,0,0,0,0,0,0
SIKKIM,2009,CRUELTY BY HUSBAND OR RELATIVE OF HUSBAND,0,0,0,0,0,0,0,0,0,0,0,0,0,0,0
SIKKIM,2009,OTHER IPC CRIMES,0,0,0,2,0,2,1,0,1,0,0,0,3,0,3
SIKKIM,2009,TOTAL IPC,0,0,0,35,0,35,22,1,23,7,0,7,64,1,65
SIKKIM,2010,MURDER,0,0,0,8,1,9,19,0,19,4,0,4,31,1,32
SIKKIM,2010,ATTEMPT TO COMMIT MURDER,0,0,0,0,0,0,0,0,0,0,0,0,0,0,0
SIKKIM,2010,C.H. NOT AMOUNTING TO MURDER,0,0,0,3,0,3,0,0,0,1,1,2,4,1,5
SIKKIM,2010,RAPE,0,0,0,1,0,1,3,0,3,1,0,1,5,0,5
SIKKIM,2010,KIDNAPPING AND ABDUCTION,0,0,0,1,0,1,0,0,0,0,0,0,1,0,1
SIKKIM,2010,DACOITY,0,0,0,0,0,0,0,0,0,0,0,0,0,0,0
SIKKIM,2010,PREP. AND ASSEMBLY FOR DACOITY,0,0,0,0,0,0,0,0,0,0,0,0,0,0,0
SIKKIM,2010,ROBBERY,0,0,0,0,0,0,0,0,0,0,0,0,0,0,0
SIKKIM,2010,BURGLARY,0,0,0,10,0,10,0,0,0,0,0,0,10,0,10
SIKKIM,2010,THEFTS,0,0,0,2,0,2,2,0,2,0,0,0,4,0,4
SIKKIM,2010,EXTORTION,0,0,0,1,0,1,0,0,0,0,0,0,1,0,1
SIKKIM,2010,RIOTS,0,0,0,0,0,0,0,0,0,0,0,0,0,0,0
SIKKIM,2010,ARSON,0,0,0,0,0,0,0,0,0,0,0,0,0,0,0
SIKKIM,2010,CRIMINAL BREACH OF TRUST,0,0,0,0,0,0,0,0,0,0,0,0,0,0,0
SIKKIM,2010,CHEATING,0,0,0,0,0,0,0,0,0,0,0,0,0,0,0
SIKKIM,2010,COUNTER FEITING,0,0,0,0,0,0,0,0,0,0,0,0,0,0,0
SIKKIM,2010,DOWRY DEATHS,0,0,0,0,0,0,0,0,0,0,0,0,0,0,0
SIKKIM,2010,MOLESTATION,0,0,0,2,0,2,3,0,3,0,0,0,5,0,5
SIKKIM,2010,EVE-TEASING,0,0,0,0,0,0,0,0,0,0,0,0,0,0,0
SIKKIM,2010,CRUELTY BY HUSBAND OR RELATIVE OF HUSBAND,0,0,0,0,0,0,0,0,0,0,0,0,0,0,0
SIKKIM,2010,OTHER IPC CRIMES,0,0,0,2,0,2,2,0,2,0,0,0,4,0,4
SIKKIM,2010,TOTAL IPC,0,0,0,30,1,31,29,0,29,6,1,7,65,2,67
SIKKIM,2011,MURDER,0,0,0,4,1,5,28,0,28,5,0,5,37,1,38
SIKKIM,2011,ATTEMPT TO COMMIT MURDER,0,0,0,0,0,0,0,0,0,0,0,0,0,0,0
SIKKIM,2011,C.H. NOT AMOUNTING TO MURDER,0,0,0,2,0,2,2,0,2,0,0,0,4,0,4
SIKKIM,2011,RAPE,0,0,0,0,0,0,4,0,4,0,0,0,4,0,4
SIKKIM,2011,KIDNAPPING AND ABDUCTION,0,0,0,0,0,0,0,0,0,0,0,0,0,0,0
SIKKIM,2011,DACOITY,0,0,0,0,0,0,0,0,0,0,0,0,0,0,0
SIKKIM,2011,PREP. AND ASSEMBLY FOR DACOITY,0,0,0,0,0,0,0,0,0,0,0,0,0,0,0
SIKKIM,2011,ROBBERY,0,0,0,0,0,0,0,0,0,0,0,0,0,0,0
SIKKIM,2011,BURGLARY,0,0,0,3,0,3,0,0,0,0,0,0,3,0,3
SIKKIM,2011,THEFTS,0,0,0,7,0,7,1,0,1,0,0,0,8,0,8
SIKKIM,2011,EXTORTION,0,0,0,0,0,0,0,0,0,0,0,0,0,0,0
SIKKIM,2011,RIOTS,0,0,0,0,0,0,0,0,0,0,0,0,0,0,0
SIKKIM,2011,ARSON,0,0,0,0,0,0,0,0,0,0,0,0,0,0,0
SIKKIM,2011,CRIMINAL BREACH OF TRUST,0,0,0,0,0,0,0,0,0,0,0,0,0,0,0
SIKKIM,2011,CHEATING,0,0,0,0,0,0,1,0,1,0,0,0,1,0,1
SIKKIM,2011,COUNTER FEITING,0,0,0,0,0,0,0,0,0,0,0,0,0,0,0
SIKKIM,2011,DOWRY DEATHS,0,0,0,0,0,0,0,0,0,0,0,0,0,0,0
SIKKIM,2011,MOLESTATION,0,0,0,0,0,0,0,0,0,0,0,0,0,0,0
SIKKIM,2011,EVE-TEASING,0,0,0,0,0,0,0,0,0,0,0,0,0,0,0
SIKKIM,2011,CRUELTY BY HUSBAND OR RELATIVE OF HUSBAND,0,0,0,0,0,0,0,0,0,0,0,0,0,0,0
SIKKIM,2011,OTHER IPC CRIMES,0,0,0,3,0,3,2,0,2,0,0,0,5,0,5
SIKKIM,2011,TOTAL IPC,0,0,0,19,1,20,38,0,38,5,0,5,62,1,63
SIKKIM,2012,MURDER,0,0,0,8,0,8,24,1,25,5,0,5,37,1,38
SIKKIM,2012,ATTEMPT TO COMMIT MURDER,0,0,0,1,0,1,0,0,0,0,0,0,1,0,1
SIKKIM,2012,C.H. NOT AMOUNTING TO MURDER,0,0,0,4,0,4,6,0,6,0,0,0,10,0,10
SIKKIM,2012,RAPE,0,0,0,7,0,7,3,0,3,0,0,0,10,0,10
SIKKIM,2012,KIDNAPPING AND ABDUCTION,0,0,0,1,0,1,0,0,0,0,0,0,1,0,1
SIKKIM,2012,DACOITY,0,0,0,0,0,0,0,0,0,0,0,0,0,0,0
SIKKIM,2012,PREP. AND ASSEMBLY FOR DACOITY,0,0,0,0,0,0,0,0,0,0,0,0,0,0,0
SIKKIM,2012,ROBBERY,0,0,0,0,0,0,0,0,0,0,0,0,0,0,0
SIKKIM,2012,BURGLARY,0,0,0,0,0,0,0,0,0,0,0,0,0,0,0
SIKKIM,2012,THEFTS,0,0,0,6,0,6,2,0,2,0,0,0,8,0,8
SIKKIM,2012,EXTORTION,0,0,0,0,0,0,1,0,1,0,0,0,1,0,1
SIKKIM,2012,RIOTS,0,0,0,0,0,0,0,0,0,0,0,0,0,0,0
SIKKIM,2012,ARSON,0,0,0,0,0,0,0,0,0,0,0,0,0,0,0
SIKKIM,2012,CRIMINAL BREACH OF TRUST,0,0,0,0,0,0,1,0,1,1,0,1,2,0,2
SIKKIM,2012,CHEATING,0,0,0,0,0,0,0,0,0,2,0,2,2,0,2
SIKKIM,2012,COUNTER FEITING,0,0,0,1,0,1,0,0,0,0,0,0,1,0,1
SIKKIM,2012,DOWRY DEATHS,0,0,0,0,0,0,0,0,0,0,0,0,0,0,0
SIKKIM,2012,MOLESTATION,0,0,0,0,0,0,0,0,0,0,0,0,0,0,0
SIKKIM,2012,EVE-TEASING,0,0,0,0,0,0,0,0,0,0,0,0,0,0,0
SIKKIM,2012,CRUELTY BY HUSBAND OR RELATIVE OF HUSBAND,0,0,0,1,0,1,0,0,0,0,0,0,1,0,1
SIKKIM,2012,OTHER IPC CRIMES,0,0,0,0,0,0,0,0,0,0,0,0,0,0,0
SIKKIM,2012,TOTAL IPC,0,0,0,29,0,29,37,1,38,8,0,8,74,1,75
TAMILNADU,2001,MURDER,29,0,29,1290,16,1306,1090,74,1164,352,16,368,2761,106,2867
TAMILNADU,2001,ATTEMPT TO COMMIT MURDER,4,0,4,148,2,150,38,1,39,12,0,12,202,3,205
TAMILNADU,2001,C.H. NOT AMOUNTING TO MURDER,0,0,0,34,5,39,43,7,50,3,0,3,80,12,92
TAMILNADU,2001,RAPE,4,0,4,204,0,204,14,0,14,4,0,4,226,0,226
TAMILNADU,2001,KIDNAPPING AND ABDUCTION,0,0,0,4,0,4,4,0,4,1,0,1,9,0,9
TAMILNADU,2001,DACOITY,1,0,1,42,0,42,25,0,25,5,0,5,73,0,73
TAMILNADU,2001,PREP. AND ASSEMBLY FOR DACOITY,0,0,0,9,0,9,7,0,7,1,0,1,17,0,17
TAMILNADU,2001,ROBBERY,0,0,0,107,0,107,52,0,52,5,0,5,164,0,164
TAMILNADU,2001,BURGLARY,0,0,0,52,0,52,61,0,61,2,0,2,115,0,115
TAMILNADU,2001,THEFTS,22,0,22,162,4,166,82,1,83,13,0,13,279,5,284
TAMILNADU,2001,EXTORTION,0,0,0,0,0,0,6,0,6,0,0,0,6,0,6
TAMILNADU,2001,RIOTS,0,0,0,13,0,13,0,0,0,0,0,0,13,0,13
TAMILNADU,2001,ARSON,0,0,0,0,0,0,0,0,0,0,0,0,0,0,0
TAMILNADU,2001,CRIMINAL BREACH OF TRUST,0,0,0,2,0,2,0,0,0,0,0,0,2,0,2
TAMILNADU,2001,CHEATING,0,0,0,26,0,26,11,1,12,0,0,0,37,1,38
TAMILNADU,2001,COUNTER FEITING,0,0,0,8,0,8,4,0,4,0,0,0,12,0,12
TAMILNADU,2001,DOWRY DEATHS,0,0,0,4,0,4,0,0,0,0,0,0,4,0,4
TAMILNADU,2001,MOLESTATION,0,0,0,0,0,0,0,0,0,0,0,0,0,0,0
TAMILNADU,2001,EVE-TEASING,0,0,0,0,0,0,0,0,0,0,0,0,0,0,0
TAMILNADU,2001,CRUELTY BY HUSBAND OR RELATIVE OF HUSBAND,0,0,0,0,0,0,0,0,0,2,1,3,2,1,3
TAMILNADU,2001,OTHER IPC CRIMES,0,0,0,20,5,25,5,9,14,2,2,4,27,16,43
TAMILNADU,2001,TOTAL IPC,60,0,60,2125,32,2157,1442,93,1535,402,19,421,4029,144,4173
TAMILNADU,2002,MURDER,13,0,13,1580,25,1605,1538,76,1614,296,17,313,3427,118,3545
TAMILNADU,2002,ATTEMPT TO COMMIT MURDER,3,0,3,175,0,175,59,0,59,17,0,17,254,0,254
TAMILNADU,2002,C.H. NOT AMOUNTING TO MURDER,6,0,6,32,2,34,33,9,42,5,2,7,76,13,89
TAMILNADU,2002,RAPE,0,0,0,82,0,82,15,0,15,4,0,4,101,0,101
TAMILNADU,2002,KIDNAPPING AND ABDUCTION,0,0,0,14,3,17,16,2,18,14,1,15,44,6,50
TAMILNADU,2002,DACOITY,0,0,0,38,0,38,12,0,12,4,0,4,54,0,54
TAMILNADU,2002,PREP. AND ASSEMBLY FOR DACOITY,0,0,0,13,0,13,12,0,12,10,0,10,35,0,35
TAMILNADU,2002,ROBBERY,0,0,0,195,3,198,93,0,93,12,0,12,300,3,303
TAMILNADU,2002,BURGLARY,0,0,0,30,0,30,34,1,35,30,0,30,94,1,95
TAMILNADU,2002,THEFTS,28,0,28,448,2,450,86,8,94,33,0,33,595,10,605
TAMILNADU,2002,EXTORTION,0,0,0,0,0,0,0,0,0,0,0,0,0,0,0
TAMILNADU,2002,RIOTS,0,0,0,0,0,0,0,0,0,0,0,0,0,0,0
TAMILNADU,2002,ARSON,0,0,0,0,0,0,0,0,0,0,0,0,0,0,0
TAMILNADU,2002,CRIMINAL BREACH OF TRUST,0,0,0,0,0,0,0,0,0,0,0,0,0,0,0
TAMILNADU,2002,CHEATING,0,0,0,7,0,7,8,0,8,0,0,0,15,0,15
TAMILNADU,2002,COUNTER FEITING,0,0,0,15,0,15,2,0,2,0,0,0,17,0,17
TAMILNADU,2002,DOWRY DEATHS,0,0,0,3,0,3,0,3,3,0,0,0,3,3,6
TAMILNADU,2002,MOLESTATION,0,0,0,0,0,0,0,0,0,0,0,0,0,0,0
TAMILNADU,2002,EVE-TEASING,0,0,0,0,0,0,0,0,0,0,0,0,0,0,0
TAMILNADU,2002,CRUELTY BY HUSBAND OR RELATIVE OF HUSBAND,0,0,0,6,0,6,0,1,1,0,0,0,6,1,7
TAMILNADU,2002,OTHER IPC CRIMES,0,0,0,21,3,24,7,5,12,2,1,3,30,9,39
TAMILNADU,2002,TOTAL IPC,50,0,50,2659,38,2697,1915,105,2020,427,21,448,5051,164,5215
TAMILNADU,2003,MURDER,0,0,0,1626,22,1648,1680,78,1758,272,22,294,3578,122,3700
TAMILNADU,2003,ATTEMPT TO COMMIT MURDER,0,0,0,195,0,195,68,0,68,20,0,20,283,0,283
TAMILNADU,2003,C.H. NOT AMOUNTING TO MURDER,0,0,0,43,4,47,41,11,52,7,2,9,91,17,108
TAMILNADU,2003,RAPE,0,0,0,86,0,86,17,0,17,6,0,6,109,0,109
TAMILNADU,2003,KIDNAPPING AND ABDUCTION,0,0,0,16,4,20,19,4,23,18,2,20,53,10,63
TAMILNADU,2003,DACOITY,0,0,0,42,0,42,14,0,14,6,0,6,62,0,62
TAMILNADU,2003,PREP. AND ASSEMBLY FOR DACOITY,0,0,0,15,0,15,14,0,14,15,0,15,44,0,44
TAMILNADU,2003,ROBBERY,0,0,0,198,5,203,97,0,97,16,0,16,311,5,316
TAMILNADU,2003,BURGLARY,0,0,0,37,0,37,37,2,39,17,0,17,91,2,93
TAMILNADU,2003,THEFTS,0,0,0,366,7,373,450,7,457,45,0,45,861,14,875
TAMILNADU,2003,EXTORTION,0,0,0,0,0,0,0,0,0,0,0,0,0,0,0
TAMILNADU,2003,RIOTS,0,0,0,0,0,0,0,0,0,0,0,0,0,0,0
TAMILNADU,2003,ARSON,0,0,0,0,0,0,0,0,0,0,0,0,0,0,0
TAMILNADU,2003,CRIMINAL BREACH OF TRUST,0,0,0,0,0,0,0,0,0,0,0,0,0,0,0
TAMILNADU,2003,CHEATING,0,0,0,9,0,9,9,0,9,0,0,0,18,0,18
TAMILNADU,2003,COUNTER FEITING,0,0,0,17,0,17,4,0,4,0,0,0,21,0,21
TAMILNADU,2003,DOWRY DEATHS,0,0,0,5,0,5,0,0,0,0,0,0,5,0,5
TAMILNADU,2003,MOLESTATION,0,0,0,0,0,0,0,0,0,0,0,0,0,0,0
TAMILNADU,2003,EVE-TEASING,0,0,0,0,0,0,0,0,0,0,0,0,0,0,0
TAMILNADU,2003,CRUELTY BY HUSBAND OR RELATIVE OF HUSBAND,0,0,0,8,0,8,0,0,0,0,0,0,8,0,8
TAMILNADU,2003,OTHER IPC CRIMES,0,0,0,25,3,28,10,3,13,7,1,8,42,7,49
TAMILNADU,2003,TOTAL IPC,0,0,0,2688,45,2733,2460,105,2565,429,27,456,5577,177,5754
TAMILNADU,2004,MURDER,0,0,0,1724,23,1747,1710,83,1793,476,9,485,3910,115,4025
TAMILNADU,2004,ATTEMPT TO COMMIT MURDER,0,0,0,206,4,210,212,3,215,31,1,32,449,8,457
TAMILNADU,2004,C.H. NOT AMOUNTING TO MURDER,0,0,0,148,3,151,132,12,144,17,2,19,297,17,314
TAMILNADU,2004,RAPE,0,0,0,45,0,45,70,0,70,0,0,0,115,0,115
TAMILNADU,2004,KIDNAPPING AND ABDUCTION,0,0,0,9,0,9,9,0,9,0,0,0,18,0,18
TAMILNADU,2004,DACOITY,0,0,0,176,0,176,208,0,208,0,0,0,384,0,384
TAMILNADU,2004,PREP. AND ASSEMBLY FOR DACOITY,0,0,0,16,0,16,17,0,17,0,0,0,33,0,33
TAMILNADU,2004,ROBBERY,0,0,0,215,0,215,177,0,177,0,0,0,392,0,392
TAMILNADU,2004,BURGLARY,0,0,0,18,0,18,16,0,16,0,0,0,34,0,34
TAMILNADU,2004,THEFTS,0,0,0,226,4,230,157,3,160,8,0,8,391,7,398
TAMILNADU,2004,EXTORTION,0,0,0,0,0,0,0,0,0,0,0,0,0,0,0
TAMILNADU,2004,RIOTS,0,0,0,0,0,0,0,0,0,0,0,0,0,0,0
TAMILNADU,2004,ARSON,0,0,0,0,0,0,0,0,0,0,0,0,0,0,0
TAMILNADU,2004,CRIMINAL BREACH OF TRUST,0,0,0,0,0,0,0,0,0,0,0,0,0,0,0
TAMILNADU,2004,CHEATING,0,0,0,47,3,50,35,1,36,0,0,0,82,4,86
TAMILNADU,2004,COUNTER FEITING,0,0,0,7,1,8,8,0,8,0,0,0,15,1,16
TAMILNADU,2004,DOWRY DEATHS,0,0,0,11,3,14,7,5,12,0,0,0,18,8,26
TAMILNADU,2004,MOLESTATION,0,0,0,0,0,0,0,0,0,0,0,0,0,0,0
TAMILNADU,2004,EVE-TEASING,0,0,0,0,0,0,0,0,0,0,0,0,0,0,0
TAMILNADU,2004,CRUELTY BY HUSBAND OR RELATIVE OF HUSBAND,0,0,0,0,2,2,0,4,4,0,0,0,0,6,6
TAMILNADU,2004,OTHER IPC CRIMES,0,0,0,141,0,141,101,0,101,0,0,0,242,0,242
TAMILNADU,2004,TOTAL IPC,0,0,0,2989,43,3032,2859,111,2970,532,12,544,6380,166,6546
TAMILNADU,2005,MURDER,0,0,0,768,0,768,1490,89,1579,439,11,450,2697,100,2797
TAMILNADU,2005,ATTEMPT TO COMMIT MURDER,0,0,0,244,15,259,465,52,517,76,15,91,785,82,867
TAMILNADU,2005,C.H. NOT AMOUNTING TO MURDER,0,0,0,128,3,131,116,3,119,40,0,40,284,6,290
TAMILNADU,2005,RAPE,0,0,0,162,0,162,125,0,125,13,0,13,300,0,300
TAMILNADU,2005,KIDNAPPING AND ABDUCTION,0,0,0,70,0,70,83,4,87,16,0,16,169,4,173
TAMILNADU,2005,DACOITY,0,0,0,140,2,142,78,2,80,3,0,3,221,4,225
TAMILNADU,2005,PREP. AND ASSEMBLY FOR DACOITY,0,0,0,0,0,0,2,2,4,1,0,1,3,2,5
TAMILNADU,2005,ROBBERY,0,0,0,190,0,190,158,7,165,20,0,20,368,7,375
TAMILNADU,2005,BURGLARY,0,0,0,60,0,60,286,6,292,0,0,0,346,6,352
TAMILNADU,2005,THEFTS,0,0,0,396,2,398,369,8,377,174,2,176,939,12,951
TAMILNADU,2005,EXTORTION,0,0,0,0,0,0,1,0,1,0,0,0,1,0,1
TAMILNADU,2005,RIOTS,0,0,0,0,0,0,4,0,4,2,0,2,6,0,6
TAMILNADU,2005,ARSON,0,0,0,0,0,0,1,0,1,0,0,0,1,0,1
TAMILNADU,2005,CRIMINAL BREACH OF TRUST,0,0,0,0,0,0,0,0,0,0,0,0,0,0,0
TAMILNADU,2005,CHEATING,0,0,0,46,0,46,64,0,64,11,0,11,121,0,121
TAMILNADU,2005,COUNTER FEITING,0,0,0,0,0,0,0,0,0,0,0,0,0,0,0
TAMILNADU,2005,DOWRY DEATHS,0,0,0,5,0,5,2,0,2,0,0,0,7,0,7
TAMILNADU,2005,MOLESTATION,0,0,0,0,0,0,0,0,0,0,0,0,0,0,0
TAMILNADU,2005,EVE-TEASING,0,0,0,0,0,0,0,0,0,0,0,0,0,0,0
TAMILNADU,2005,CRUELTY BY HUSBAND OR RELATIVE OF HUSBAND,0,0,0,10,0,10,0,5,5,0,2,2,10,7,17
TAMILNADU,2005,OTHER IPC CRIMES,0,0,0,137,0,137,81,8,89,74,0,74,292,8,300
TAMILNADU,2005,TOTAL IPC,0,0,0,2356,22,2378,3325,186,3511,869,30,899,6550,238,6788
TAMILNADU,2006,MURDER,0,0,0,668,7,675,1315,64,1379,337,16,353,2320,87,2407
TAMILNADU,2006,ATTEMPT TO COMMIT MURDER,0,0,0,242,5,247,440,12,452,72,5,77,754,22,776
TAMILNADU,2006,C.H. NOT AMOUNTING TO MURDER,0,0,0,107,2,109,85,3,88,45,0,45,237,5,242
TAMILNADU,2006,RAPE,0,0,0,145,0,145,116,0,116,12,0,12,273,0,273
TAMILNADU,2006,KIDNAPPING AND ABDUCTION,0,0,0,65,0,65,76,0,76,16,0,16,157,0,157
TAMILNADU,2006,DACOITY,0,0,0,120,2,122,65,2,67,3,0,3,188,4,192
TAMILNADU,2006,PREP. AND ASSEMBLY FOR DACOITY,0,0,0,0,0,0,0,0,0,0,0,0,0,0,0
TAMILNADU,2006,ROBBERY,0,0,0,195,0,195,147,5,152,31,0,31,373,5,378
TAMILNADU,2006,BURGLARY,0,0,0,0,0,0,176,4,180,0,0,0,176,4,180
TAMILNADU,2006,THEFTS,0,0,0,416,2,418,332,7,339,135,4,139,883,13,896
TAMILNADU,2006,EXTORTION,0,0,0,0,0,0,1,0,1,0,0,0,1,0,1
TAMILNADU,2006,RIOTS,0,0,0,0,0,0,4,0,4,0,0,0,4,0,4
TAMILNADU,2006,ARSON,0,0,0,0,0,0,1,0,1,0,0,0,1,0,1
TAMILNADU,2006,CRIMINAL BREACH OF TRUST,0,0,0,0,0,0,0,0,0,0,0,0,0,0,0
TAMILNADU,2006,CHEATING,0,0,0,32,0,32,56,0,56,7,1,8,95,1,96
TAMILNADU,2006,COUNTER FEITING,0,0,0,0,0,0,0,0,0,0,0,0,0,0,0
TAMILNADU,2006,DOWRY DEATHS,0,0,0,5,0,5,3,0,3,0,0,0,8,0,8
TAMILNADU,2006,MOLESTATION,0,0,0,0,0,0,0,0,0,0,0,0,0,0,0
TAMILNADU,2006,EVE-TEASING,0,0,0,0,0,0,0,0,0,0,0,0,0,0,0
TAMILNADU,2006,CRUELTY BY HUSBAND OR RELATIVE OF HUSBAND,0,0,0,0,0,0,0,0,0,0,0,0,0,0,0
TAMILNADU,2006,OTHER IPC CRIMES,0,0,0,125,0,125,96,0,96,6,3,9,227,3,230
TAMILNADU,2006,TOTAL IPC,0,0,0,2120,18,2138,2913,97,3010,664,29,693,5697,144,5841
TAMILNADU,2007,MURDER,0,0,0,677,11,688,2310,88,2398,258,10,268,3245,109,3354
TAMILNADU,2007,ATTEMPT TO COMMIT MURDER,0,0,0,104,13,117,718,12,730,31,3,34,853,28,881
TAMILNADU,2007,C.H. NOT AMOUNTING TO MURDER,0,0,0,15,0,15,125,7,132,28,0,28,168,7,175
TAMILNADU,2007,RAPE,0,0,0,30,0,30,29,0,29,14,0,14,73,0,73
TAMILNADU,2007,KIDNAPPING AND ABDUCTION,0,0,0,0,0,0,0,0,0,0,0,0,0,0,0
TAMILNADU,2007,DACOITY,0,0,0,49,0,49,66,1,67,42,0,42,157,1,158
TAMILNADU,2007,PREP. AND ASSEMBLY FOR DACOITY,0,0,0,0,0,0,57,0,57,0,0,0,57,0,57
TAMILNADU,2007,ROBBERY,0,0,0,294,0,294,79,0,79,72,0,72,445,0,445
TAMILNADU,2007,BURGLARY,0,0,0,47,0,47,15,0,15,0,0,0,62,0,62
TAMILNADU,2007,THEFTS,0,0,0,298,2,300,397,6,403,46,8,54,741,16,757
TAMILNADU,2007,EXTORTION,0,0,0,0,0,0,0,0,0,0,0,0,0,0,0
TAMILNADU,2007,RIOTS,0,0,0,0,0,0,0,0,0,0,0,0,0,0,0
TAMILNADU,2007,ARSON,0,0,0,0,0,0,0,0,0,0,0,0,0,0,0
TAMILNADU,2007,CRIMINAL BREACH OF TRUST,0,0,0,0,0,0,2,0,2,2,0,2,4,0,4
TAMILNADU,2007,CHEATING,0,0,0,0,0,0,0,0,0,0,1,1,0,1,1
TAMILNADU,2007,COUNTER FEITING,0,0,0,15,0,15,30,0,30,0,1,1,45,1,46
TAMILNADU,2007,DOWRY DEATHS,0,0,0,18,0,18,16,2,18,0,0,0,34,2,36
TAMILNADU,2007,MOLESTATION,0,0,0,0,0,0,0,0,0,0,0,0,0,0,0
TAMILNADU,2007,EVE-TEASING,0,0,0,0,0,0,0,0,0,0,0,0,0,0,0
TAMILNADU,2007,CRUELTY BY HUSBAND OR RELATIVE OF HUSBAND,0,0,0,0,0,0,4,0,4,0,8,8,4,8,12
TAMILNADU,2007,OTHER IPC CRIMES,0,0,0,0,0,0,4,0,4,0,1,1,4,1,5
TAMILNADU,2007,TOTAL IPC,0,0,0,1547,26,1573,3852,116,3968,493,32,525,5892,174,6066
TAMILNADU,2008,MURDER,0,0,0,979,18,997,1367,78,1445,246,8,254,2592,104,2696
TAMILNADU,2008,ATTEMPT TO COMMIT MURDER,0,0,0,49,0,49,95,4,99,20,1,21,164,5,169
TAMILNADU,2008,C.H. NOT AMOUNTING TO MURDER,0,0,0,61,0,61,63,6,69,62,3,65,186,9,195
TAMILNADU,2008,RAPE,0,0,0,45,0,45,33,0,33,6,0,6,84,0,84
TAMILNADU,2008,KIDNAPPING AND ABDUCTION,0,0,0,14,0,14,7,0,7,4,0,4,25,0,25
TAMILNADU,2008,DACOITY,0,0,0,63,1,64,64,1,65,12,0,12,139,2,141
TAMILNADU,2008,PREP. AND ASSEMBLY FOR DACOITY,0,0,0,13,0,13,15,1,16,6,0,6,34,1,35
TAMILNADU,2008,ROBBERY,0,0,0,97,2,99,85,0,85,13,0,13,195,2,197
TAMILNADU,2008,BURGLARY,0,0,0,23,1,24,9,0,9,7,0,7,39,1,40
TAMILNADU,2008,THEFTS,0,0,0,164,2,166,173,4,177,39,0,39,376,6,382
TAMILNADU,2008,EXTORTION,0,0,0,7,0,7,8,0,8,2,1,3,17,1,18
TAMILNADU,2008,RIOTS,0,0,0,8,0,8,5,0,5,8,0,8,21,0,21
TAMILNADU,2008,ARSON,0,0,0,2,0,2,2,0,2,1,0,1,5,0,5
TAMILNADU,2008,CRIMINAL BREACH OF TRUST,0,0,0,0,0,0,3,0,3,0,0,0,3,0,3
TAMILNADU,2008,CHEATING,0,0,0,13,1,14,44,0,44,7,1,8,64,2,66
TAMILNADU,2008,COUNTER FEITING,0,0,0,0,0,0,0,0,0,0,0,0,0,0,0
TAMILNADU,2008,DOWRY DEATHS,0,0,0,8,0,8,6,0,6,6,4,10,20,4,24
TAMILNADU,2008,MOLESTATION,0,0,0,2,0,2,1,0,1,1,0,1,4,0,4
TAMILNADU,2008,EVE-TEASING,0,0,0,2,0,2,3,0,3,1,0,1,6,0,6
TAMILNADU,2008,CRUELTY BY HUSBAND OR RELATIVE OF HUSBAND,0,0,0,15,1,16,21,0,21,2,2,4,38,3,41
TAMILNADU,2008,OTHER IPC CRIMES,0,0,0,326,9,335,458,13,471,12,1,13,796,23,819
TAMILNADU,2008,TOTAL IPC,0,0,0,1891,35,1926,2462,107,2569,455,21,476,4808,163,4971
TAMILNADU,2009,MURDER,0,0,0,945,24,969,1592,64,1656,387,9,396,2924,97,3021
TAMILNADU,2009,ATTEMPT TO COMMIT MURDER,0,0,0,55,0,55,86,2,88,48,1,49,189,3,192
TAMILNADU,2009,C.H. NOT AMOUNTING TO MURDER,0,0,0,51,0,51,75,0,75,85,1,86,211,1,212
TAMILNADU,2009,RAPE,0,0,0,55,0,55,28,3,31,5,0,5,88,3,91
TAMILNADU,2009,KIDNAPPING AND ABDUCTION,0,0,0,26,0,26,10,0,10,3,0,3,39,0,39
TAMILNADU,2009,DACOITY,0,0,0,63,1,64,41,2,43,26,0,26,130,3,133
TAMILNADU,2009,PREP. AND ASSEMBLY FOR DACOITY,0,0,0,36,0,36,30,0,30,18,0,18,84,0,84
TAMILNADU,2009,ROBBERY,0,0,0,129,1,130,79,2,81,49,1,50,257,4,261
TAMILNADU,2009,BURGLARY,0,0,0,37,0,37,19,0,19,28,0,28,84,0,84
TAMILNADU,2009,THEFTS,0,0,0,145,8,153,127,9,136,73,1,74,345,18,363
TAMILNADU,2009,EXTORTION,0,0,0,17,0,17,9,0,9,7,0,7,33,0,33
TAMILNADU,2009,RIOTS,0,0,0,2,0,2,0,0,0,10,0,10,12,0,12
TAMILNADU,2009,ARSON,0,0,0,0,0,0,5,0,5,3,0,3,8,0,8
TAMILNADU,2009,CRIMINAL BREACH OF TRUST,0,0,0,2,0,2,2,0,2,0,0,0,4,0,4
TAMILNADU,2009,CHEATING,0,0,0,28,2,30,17,2,19,14,1,15,59,5,64
TAMILNADU,2009,COUNTER FEITING,0,0,0,2,0,2,7,2,9,4,0,4,13,2,15
TAMILNADU,2009,DOWRY DEATHS,0,0,0,21,2,23,7,9,16,8,3,11,36,14,50
TAMILNADU,2009,MOLESTATION,0,0,0,0,0,0,0,0,0,0,0,0,0,0,0
TAMILNADU,2009,EVE-TEASING,0,0,0,2,0,2,3,0,3,1,0,1,6,0,6
TAMILNADU,2009,CRUELTY BY HUSBAND OR RELATIVE OF HUSBAND,0,0,0,19,1,20,23,2,25,13,5,18,55,8,63
TAMILNADU,2009,OTHER IPC CRIMES,0,0,0,15,0,15,10,1,11,10,0,10,35,1,36
TAMILNADU,2009,TOTAL IPC,0,0,0,1650,39,1689,2170,98,2268,792,22,814,4612,159,4771
TAMILNADU,2010,MURDER,0,0,0,891,54,945,1575,43,1618,388,14,402,2854,111,2965
TAMILNADU,2010,ATTEMPT TO COMMIT MURDER,0,0,0,102,0,102,127,3,130,54,2,56,283,5,288
TAMILNADU,2010,C.H. NOT AMOUNTING TO MURDER,0,0,0,11,0,11,47,8,55,75,3,78,133,11,144
TAMILNADU,2010,RAPE,0,0,0,31,1,32,68,0,68,20,0,20,119,1,120
TAMILNADU,2010,KIDNAPPING AND ABDUCTION,0,0,0,15,0,15,28,2,30,1,0,1,44,2,46
TAMILNADU,2010,DACOITY,0,0,0,63,0,63,91,0,91,26,0,26,180,0,180
TAMILNADU,2010,PREP. AND ASSEMBLY FOR DACOITY,0,0,0,6,0,6,2,0,2,17,0,17,25,0,25
TAMILNADU,2010,ROBBERY,0,0,0,93,3,96,105,0,105,41,0,41,239,3,242
TAMILNADU,2010,BURGLARY,0,0,0,47,4,51,69,0,69,22,0,22,138,4,142
TAMILNADU,2010,THEFTS,0,0,0,102,10,112,87,5,92,50,0,50,239,15,254
TAMILNADU,2010,EXTORTION,0,0,0,17,0,17,33,2,35,0,0,0,50,2,52
TAMILNADU,2010,RIOTS,0,0,0,37,0,37,46,0,46,22,0,22,105,0,105
TAMILNADU,2010,ARSON,0,0,0,0,0,0,70,0,70,1,0,1,71,0,71
TAMILNADU,2010,CRIMINAL BREACH OF TRUST,0,0,0,0,0,0,4,0,4,0,0,0,4,0,4
TAMILNADU,2010,CHEATING,0,0,0,8,0,8,94,1,95,4,0,4,106,1,107
TAMILNADU,2010,COUNTER FEITING,0,0,0,0,0,0,1,0,1,0,0,0,1,0,1
TAMILNADU,2010,DOWRY DEATHS,0,0,0,1,0,1,14,0,14,2,0,2,17,0,17
TAMILNADU,2010,MOLESTATION,0,0,0,3,0,3,16,0,16,0,0,0,19,0,19
TAMILNADU,2010,EVE-TEASING,0,0,0,0,0,0,18,0,18,0,0,0,18,0,18
TAMILNADU,2010,CRUELTY BY HUSBAND OR RELATIVE OF HUSBAND,0,0,0,4,0,4,39,4,43,2,3,5,45,7,52
TAMILNADU,2010,OTHER IPC CRIMES,0,0,0,9,0,9,8,1,9,3,0,3,20,1,21
TAMILNADU,2010,TOTAL IPC,0,0,0,1440,72,1512,2542,69,2611,728,22,750,4710,163,4873
TAMILNADU,2011,MURDER,0,0,0,586,22,608,1393,98,1491,385,15,400,2364,135,2499
TAMILNADU,2011,ATTEMPT TO COMMIT MURDER,0,0,0,314,0,314,462,4,466,145,0,145,921,4,925
TAMILNADU,2011,C.H. NOT AMOUNTING TO MURDER,0,0,0,36,1,37,62,8,70,45,2,47,143,11,154
TAMILNADU,2011,RAPE,0,0,0,27,0,27,80,0,80,18,0,18,125,0,125
TAMILNADU,2011,KIDNAPPING AND ABDUCTION,0,0,0,15,1,16,37,0,37,19,0,19,71,1,72
TAMILNADU,2011,DACOITY,0,0,0,37,0,37,88,0,88,52,0,52,177,0,177
TAMILNADU,2011,PREP. AND ASSEMBLY FOR DACOITY,0,0,0,4,0,4,8,0,8,23,0,23,35,0,35
TAMILNADU,2011,ROBBERY,0,0,0,73,0,73,113,1,114,36,0,36,222,1,223
TAMILNADU,2011,BURGLARY,0,0,0,23,0,23,52,0,52,23,0,23,98,0,98
TAMILNADU,2011,THEFTS,0,0,0,83,5,88,117,0,117,59,0,59,259,5,264
TAMILNADU,2011,EXTORTION,0,0,0,0,0,0,12,0,12,9,0,9,21,0,21
TAMILNADU,2011,RIOTS,0,0,0,23,0,23,16,0,16,8,0,8,47,0,47
TAMILNADU,2011,ARSON,0,0,0,0,0,0,1,0,1,1,0,1,2,0,2
TAMILNADU,2011,CRIMINAL BREACH OF TRUST,0,0,0,0,0,0,11,0,11,0,0,0,11,0,11
TAMILNADU,2011,CHEATING,0,0,0,17,0,17,8,1,9,1,2,3,26,3,29
TAMILNADU,2011,COUNTER FEITING,0,0,0,3,0,3,19,0,19,0,0,0,22,0,22
TAMILNADU,2011,DOWRY DEATHS,0,0,0,1,0,1,13,2,15,3,0,3,17,2,19
TAMILNADU,2011,MOLESTATION,0,0,0,2,0,2,3,0,3,4,0,4,9,0,9
TAMILNADU,2011,EVE-TEASING,0,0,0,2,0,2,2,0,2,0,0,0,4,0,4
TAMILNADU,2011,CRUELTY BY HUSBAND OR RELATIVE OF HUSBAND,0,0,0,8,0,8,58,0,58,11,2,13,77,2,79
TAMILNADU,2011,OTHER IPC CRIMES,0,0,0,0,0,0,0,1,1,0,0,0,0,1,1
TAMILNADU,2011,TOTAL IPC,0,0,0,1254,29,1283,2555,115,2670,842,21,863,4651,165,4816
TAMILNADU,2012,MURDER,0,0,0,732,24,756,1657,76,1733,501,23,524,2890,123,3013
TAMILNADU,2012,ATTEMPT TO COMMIT MURDER,0,0,0,70,0,70,83,0,83,40,0,40,193,0,193
TAMILNADU,2012,C.H. NOT AMOUNTING TO MURDER,0,0,0,31,2,33,28,7,35,32,1,33,91,10,101
TAMILNADU,2012,RAPE,0,0,0,13,0,13,29,0,29,3,0,3,45,0,45
TAMILNADU,2012,KIDNAPPING AND ABDUCTION,0,0,0,56,0,56,56,1,57,39,0,39,151,1,152
TAMILNADU,2012,DACOITY,0,0,0,53,0,53,65,1,66,28,0,28,146,1,147
TAMILNADU,2012,PREP. AND ASSEMBLY FOR DACOITY,0,0,0,12,0,12,3,0,3,6,0,6,21,0,21
TAMILNADU,2012,ROBBERY,0,0,0,76,2,78,38,0,38,32,0,32,146,2,148
TAMILNADU,2012,BURGLARY,0,0,0,71,0,71,89,0,89,46,0,46,206,0,206
TAMILNADU,2012,THEFTS,0,0,0,83,1,84,94,4,98,45,0,45,222,5,227
TAMILNADU,2012,EXTORTION,0,0,0,4,0,4,2,0,2,10,0,10,16,0,16
TAMILNADU,2012,RIOTS,0,0,0,3,0,3,0,0,0,0,1,1,3,1,4
TAMILNADU,2012,ARSON,0,0,0,0,0,0,0,0,0,0,0,0,0,0,0
TAMILNADU,2012,CRIMINAL BREACH OF TRUST,0,0,0,7,0,7,13,0,13,0,0,0,20,0,20
TAMILNADU,2012,CHEATING,0,0,0,23,0,23,10,0,10,7,0,7,40,0,40
TAMILNADU,2012,COUNTER FEITING,0,0,0,6,0,6,11,0,11,0,0,0,17,0,17
TAMILNADU,2012,DOWRY DEATHS,0,0,0,12,2,14,17,2,19,3,0,3,32,4,36
TAMILNADU,2012,MOLESTATION,0,0,0,0,0,0,0,0,0,0,0,0,0,0,0
TAMILNADU,2012,EVE-TEASING,0,0,0,2,0,2,0,0,0,0,0,0,2,0,2
TAMILNADU,2012,CRUELTY BY HUSBAND OR RELATIVE OF HUSBAND,0,0,0,17,0,17,67,5,72,12,0,12,96,5,101
TAMILNADU,2012,OTHER IPC CRIMES,0,0,0,12,1,13,0,1,1,2,3,5,14,5,19
TAMILNADU,2012,TOTAL IPC,0,0,0,1283,32,1315,2262,97,2359,806,28,834,4351,157,4508
TRIPURA,2001,MURDER,1,0,1,12,1,13,8,1,9,10,0,10,31,2,33
TRIPURA,2001,ATTEMPT TO COMMIT MURDER,0,0,0,7,0,7,7,0,7,1,0,1,15,0,15
TRIPURA,2001,C.H. NOT AMOUNTING TO MURDER,0,0,0,10,0,10,14,0,14,0,0,0,24,0,24
TRIPURA,2001,RAPE,0,0,0,26,0,26,14,0,14,0,0,0,40,0,40
TRIPURA,2001,KIDNAPPING AND ABDUCTION,0,0,0,14,0,14,17,0,17,0,0,0,31,0,31
TRIPURA,2001,DACOITY,0,0,0,18,0,18,9,0,9,0,0,0,27,0,27
TRIPURA,2001,PREP. AND ASSEMBLY FOR DACOITY,0,0,0,0,0,0,0,0,0,0,0,0,0,0,0
TRIPURA,2001,ROBBERY,0,0,0,0,0,0,4,0,4,0,0,0,4,0,4
TRIPURA,2001,BURGLARY,0,0,0,0,0,0,0,0,0,0,0,0,0,0,0
TRIPURA,2001,THEFTS,0,0,0,7,0,7,4,0,4,0,0,0,11,0,11
TRIPURA,2001,EXTORTION,0,0,0,1,0,1,1,0,1,0,0,0,2,0,2
TRIPURA,2001,RIOTS,0,0,0,7,0,7,3,0,3,0,0,0,10,0,10
TRIPURA,2001,ARSON,0,0,0,8,0,8,4,0,4,0,0,0,12,0,12
TRIPURA,2001,CRIMINAL BREACH OF TRUST,0,0,0,0,0,0,0,0,0,0,0,0,0,0,0
TRIPURA,2001,CHEATING,0,0,0,1,0,1,1,0,1,0,0,0,2,0,2
TRIPURA,2001,COUNTER FEITING,0,0,0,0,0,0,0,0,0,0,0,0,0,0,0
TRIPURA,2001,DOWRY DEATHS,0,0,0,0,0,0,0,0,0,0,0,0,0,0,0
TRIPURA,2001,MOLESTATION,0,0,0,1,0,1,3,0,3,0,0,0,4,0,4
TRIPURA,2001,EVE-TEASING,0,0,0,0,0,0,0,0,0,0,0,0,0,0,0
TRIPURA,2001,CRUELTY BY HUSBAND OR RELATIVE OF HUSBAND,0,0,0,2,0,2,4,1,5,2,0,2,8,1,9
TRIPURA,2001,OTHER IPC CRIMES,0,0,0,20,0,20,14,0,14,0,0,0,34,0,34
TRIPURA,2001,TOTAL IPC,1,0,1,134,1,135,107,2,109,13,0,13,255,3,258
TRIPURA,2002,MURDER,6,0,6,42,2,44,60,0,60,12,0,12,120,2,122
TRIPURA,2002,ATTEMPT TO COMMIT MURDER,2,0,2,13,0,13,11,0,11,3,0,3,29,0,29
TRIPURA,2002,C.H. NOT AMOUNTING TO MURDER,6,1,7,10,0,10,0,0,0,0,0,0,16,1,17
TRIPURA,2002,RAPE,8,0,8,24,1,25,17,0,17,1,0,1,50,1,51
TRIPURA,2002,KIDNAPPING AND ABDUCTION,3,0,3,22,0,22,33,0,33,0,0,0,58,0,58
TRIPURA,2002,DACOITY,0,0,0,9,0,9,11,0,11,3,0,3,23,0,23
TRIPURA,2002,PREP. AND ASSEMBLY FOR DACOITY,0,0,0,0,0,0,2,0,2,0,0,0,2,0,2
TRIPURA,2002,ROBBERY,0,0,0,2,0,2,2,0,2,0,0,0,4,0,4
TRIPURA,2002,BURGLARY,0,0,0,2,0,2,0,0,0,0,0,0,2,0,2
TRIPURA,2002,THEFTS,2,0,2,8,0,8,13,0,13,0,0,0,23,0,23
TRIPURA,2002,EXTORTION,0,0,0,0,0,0,0,0,0,0,0,0,0,0,0
TRIPURA,2002,RIOTS,0,0,0,8,0,8,16,0,16,0,0,0,24,0,24
TRIPURA,2002,ARSON,0,0,0,2,0,2,3,0,3,1,0,1,6,0,6
TRIPURA,2002,CRIMINAL BREACH OF TRUST,0,0,0,0,0,0,1,0,1,0,0,0,1,0,1
TRIPURA,2002,CHEATING,0,0,0,1,0,1,2,0,2,0,0,0,3,0,3
TRIPURA,2002,COUNTER FEITING,0,0,0,0,0,0,0,0,0,0,0,0,0,0,0
TRIPURA,2002,DOWRY DEATHS,0,0,0,2,1,3,3,0,3,0,0,0,5,1,6
TRIPURA,2002,MOLESTATION,0,0,0,0,0,0,5,0,5,0,0,0,5,0,5
TRIPURA,2002,EVE-TEASING,0,0,0,5,0,5,0,0,0,2,0,2,7,0,7
TRIPURA,2002,CRUELTY BY HUSBAND OR RELATIVE OF HUSBAND,0,0,0,9,0,9,10,0,10,1,0,1,20,0,20
TRIPURA,2002,OTHER IPC CRIMES,0,0,0,9,0,9,13,0,13,2,0,2,24,0,24
TRIPURA,2002,TOTAL IPC,27,1,28,168,4,172,202,0,202,25,0,25,422,5,427
TRIPURA,2003,MURDER,1,0,1,105,0,105,125,2,127,24,1,25,255,3,258
TRIPURA,2003,ATTEMPT TO COMMIT MURDER,1,0,1,6,0,6,6,0,6,0,0,0,13,0,13
TRIPURA,2003,C.H. NOT AMOUNTING TO MURDER,0,0,0,1,0,1,7,0,7,2,1,3,10,1,11
TRIPURA,2003,RAPE,0,0,0,24,0,24,30,0,30,3,0,3,57,0,57
TRIPURA,2003,KIDNAPPING AND ABDUCTION,1,0,1,16,0,16,34,0,34,5,0,5,56,0,56
TRIPURA,2003,DACOITY,0,0,0,2,0,2,9,0,9,2,0,2,13,0,13
TRIPURA,2003,PREP. AND ASSEMBLY FOR DACOITY,0,0,0,1,0,1,2,0,2,0,0,0,3,0,3
TRIPURA,2003,ROBBERY,0,0,0,0,0,0,2,0,2,2,0,2,4,0,4
TRIPURA,2003,BURGLARY,0,0,0,1,0,1,4,0,4,0,0,0,5,0,5
TRIPURA,2003,THEFTS,0,0,0,5,0,5,6,0,6,0,0,0,11,0,11
TRIPURA,2003,EXTORTION,0,0,0,0,0,0,0,0,0,0,0,0,0,0,0
TRIPURA,2003,RIOTS,0,0,0,0,0,0,1,0,1,0,0,0,1,0,1
TRIPURA,2003,ARSON,0,0,0,2,0,2,6,0,6,0,0,0,8,0,8
TRIPURA,2003,CRIMINAL BREACH OF TRUST,0,0,0,0,0,0,0,0,0,0,0,0,0,0,0
TRIPURA,2003,CHEATING,0,0,0,0,0,0,2,0,2,1,0,1,3,0,3
TRIPURA,2003,COUNTER FEITING,0,0,0,1,0,1,5,0,5,1,0,1,7,0,7
TRIPURA,2003,DOWRY DEATHS,0,0,0,0,0,0,0,0,0,1,2,3,1,2,3
TRIPURA,2003,MOLESTATION,0,0,0,0,0,0,1,0,1,0,0,0,1,0,1
TRIPURA,2003,EVE-TEASING,0,0,0,0,0,0,2,0,2,3,0,3,5,0,5
TRIPURA,2003,CRUELTY BY HUSBAND OR RELATIVE OF HUSBAND,0,0,0,6,0,6,11,1,12,4,0,4,21,1,22
TRIPURA,2003,OTHER IPC CRIMES,0,0,0,2,0,2,3,0,3,2,0,2,7,0,7
TRIPURA,2003,TOTAL IPC,3,0,3,172,0,172,256,3,259,50,4,54,481,7,488
TRIPURA,2004,MURDER,1,0,1,74,0,74,173,4,177,29,0,29,277,4,281
TRIPURA,2004,ATTEMPT TO COMMIT MURDER,1,0,1,15,0,15,18,2,20,1,0,1,35,2,37
TRIPURA,2004,C.H. NOT AMOUNTING TO MURDER,0,0,0,0,0,0,0,0,0,0,0,0,0,0,0
TRIPURA,2004,RAPE,0,0,0,31,0,31,30,0,30,8,0,8,69,0,69
TRIPURA,2004,KIDNAPPING AND ABDUCTION,0,0,0,23,0,23,38,3,41,2,0,2,63,3,66
TRIPURA,2004,DACOITY,0,0,0,0,0,0,1,0,1,0,0,0,1,0,1
TRIPURA,2004,PREP. AND ASSEMBLY FOR DACOITY,0,0,0,0,0,0,0,0,0,0,0,0,0,0,0
TRIPURA,2004,ROBBERY,0,0,0,4,0,4,5,0,5,0,0,0,9,0,9
TRIPURA,2004,BURGLARY,0,0,0,3,0,3,3,0,3,0,0,0,6,0,6
TRIPURA,2004,THEFTS,0,0,0,1,0,1,0,0,0,0,0,0,1,0,1
TRIPURA,2004,EXTORTION,0,0,0,0,0,0,0,0,0,0,0,0,0,0,0
TRIPURA,2004,RIOTS,0,0,0,5,0,5,2,0,2,1,0,1,8,0,8
TRIPURA,2004,ARSON,0,0,0,4,0,4,10,0,10,0,0,0,14,0,14
TRIPURA,2004,CRIMINAL BREACH OF TRUST,0,0,0,0,0,0,0,0,0,0,0,0,0,0,0
TRIPURA,2004,CHEATING,0,0,0,3,0,3,1,0,1,0,0,0,4,0,4
TRIPURA,2004,COUNTER FEITING,0,0,0,2,0,2,2,0,2,0,0,0,4,0,4
TRIPURA,2004,DOWRY DEATHS,0,0,0,4,0,4,2,1,3,1,0,1,7,1,8
TRIPURA,2004,MOLESTATION,0,0,0,0,0,0,4,0,4,0,0,0,4,0,4
TRIPURA,2004,EVE-TEASING,0,0,0,0,0,0,0,0,0,0,0,0,0,0,0
TRIPURA,2004,CRUELTY BY HUSBAND OR RELATIVE OF HUSBAND,0,0,0,2,0,2,0,0,0,0,0,0,2,0,2
TRIPURA,2004,OTHER IPC CRIMES,0,0,0,12,0,12,6,2,8,2,0,2,20,2,22
TRIPURA,2004,TOTAL IPC,2,0,2,183,0,183,295,12,307,44,0,44,524,12,536
TRIPURA,2005,MURDER,0,0,0,99,0,99,207,3,210,67,4,71,373,7,380
TRIPURA,2005,ATTEMPT TO COMMIT MURDER,1,0,1,7,0,7,12,0,12,0,0,0,20,0,20
TRIPURA,2005,C.H. NOT AMOUNTING TO MURDER,0,0,0,9,0,9,18,0,18,0,0,0,27,0,27
TRIPURA,2005,RAPE,0,0,0,32,0,32,47,0,47,10,0,10,89,0,89
TRIPURA,2005,KIDNAPPING AND ABDUCTION,0,0,0,36,1,37,47,4,51,0,0,0,83,5,88
TRIPURA,2005,DACOITY,0,0,0,5,0,5,9,0,9,0,0,0,14,0,14
TRIPURA,2005,PREP. AND ASSEMBLY FOR DACOITY,0,0,0,1,0,1,3,0,3,0,0,0,4,0,4
TRIPURA,2005,ROBBERY,0,0,0,7,0,7,8,0,8,0,0,0,15,0,15
TRIPURA,2005,BURGLARY,0,0,0,2,0,2,2,0,2,0,0,0,4,0,4
TRIPURA,2005,THEFTS,0,0,0,9,0,9,1,0,1,0,0,0,10,0,10
TRIPURA,2005,EXTORTION,0,0,0,0,0,0,0,0,0,0,0,0,0,0,0
TRIPURA,2005,RIOTS,0,0,0,2,0,2,6,0,6,1,0,1,9,0,9
TRIPURA,2005,ARSON,0,0,0,1,0,1,8,0,8,2,0,2,11,0,11
TRIPURA,2005,CRIMINAL BREACH OF TRUST,0,0,0,2,0,2,1,0,1,0,0,0,3,0,3
TRIPURA,2005,CHEATING,0,0,0,0,0,0,1,0,1,0,0,0,1,0,1
TRIPURA,2005,COUNTER FEITING,0,0,0,4,0,4,0,0,0,0,0,0,4,0,4
TRIPURA,2005,DOWRY DEATHS,0,0,0,0,0,0,0,0,0,1,0,1,1,0,1
TRIPURA,2005,MOLESTATION,0,0,0,1,0,1,0,0,0,0,0,0,1,0,1
TRIPURA,2005,EVE-TEASING,0,0,0,1,0,1,0,0,0,0,0,0,1,0,1
TRIPURA,2005,CRUELTY BY HUSBAND OR RELATIVE OF HUSBAND,0,0,0,8,0,8,10,0,10,1,1,2,19,1,20
TRIPURA,2005,OTHER IPC CRIMES,0,0,0,18,0,18,17,0,17,3,1,4,38,1,39
TRIPURA,2005,TOTAL IPC,1,0,1,244,1,245,397,7,404,85,6,91,727,14,741
TRIPURA,2006,MURDER,2,0,2,84,0,84,170,3,173,51,3,54,307,6,313
TRIPURA,2006,ATTEMPT TO COMMIT MURDER,0,0,0,6,0,6,10,0,10,0,0,0,16,0,16
TRIPURA,2006,C.H. NOT AMOUNTING TO MURDER,4,0,4,11,0,11,3,0,3,0,0,0,18,0,18
TRIPURA,2006,RAPE,2,0,2,25,0,25,50,0,50,10,0,10,87,0,87
TRIPURA,2006,KIDNAPPING AND ABDUCTION,2,0,2,45,1,46,43,4,47,4,0,4,94,5,99
TRIPURA,2006,DACOITY,0,0,0,5,0,5,3,0,3,0,0,0,8,0,8
TRIPURA,2006,PREP. AND ASSEMBLY FOR DACOITY,0,0,0,0,0,0,0,0,0,0,0,0,0,0,0
TRIPURA,2006,ROBBERY,0,0,0,7,0,7,5,0,5,0,0,0,12,0,12
TRIPURA,2006,BURGLARY,0,0,0,0,0,0,4,0,4,0,0,0,4,0,4
TRIPURA,2006,THEFTS,0,0,0,4,0,4,3,0,3,0,0,0,7,0,7
TRIPURA,2006,EXTORTION,0,0,0,6,0,6,1,0,1,0,0,0,7,0,7
TRIPURA,2006,RIOTS,1,0,1,13,0,13,25,0,25,9,0,9,48,0,48
TRIPURA,2006,ARSON,0,0,0,1,0,1,6,0,6,2,0,2,9,0,9
TRIPURA,2006,CRIMINAL BREACH OF TRUST,0,0,0,0,0,0,2,0,2,0,0,0,2,0,2
TRIPURA,2006,CHEATING,0,0,0,0,0,0,0,0,0,0,0,0,0,0,0
TRIPURA,2006,COUNTER FEITING,0,0,0,6,0,6,0,0,0,0,0,0,6,0,6
TRIPURA,2006,DOWRY DEATHS,0,0,0,8,0,8,19,0,19,2,0,2,29,0,29
TRIPURA,2006,MOLESTATION,0,0,0,3,0,3,0,0,0,0,0,0,3,0,3
TRIPURA,2006,EVE-TEASING,0,0,0,0,0,0,0,0,0,0,0,0,0,0,0
TRIPURA,2006,CRUELTY BY HUSBAND OR RELATIVE OF HUSBAND,0,0,0,10,0,10,10,0,10,0,5,5,20,5,25
TRIPURA,2006,OTHER IPC CRIMES,0,0,0,18,0,18,23,1,24,3,0,3,44,1,45
TRIPURA,2006,TOTAL IPC,11,0,11,252,1,253,377,8,385,81,8,89,721,17,738
TRIPURA,2007,MURDER,0,0,0,105,1,106,201,8,209,59,0,59,365,9,374
TRIPURA,2007,ATTEMPT TO COMMIT MURDER,0,0,0,7,0,7,7,0,7,2,0,2,16,0,16
TRIPURA,2007,C.H. NOT AMOUNTING TO MURDER,0,0,0,17,0,17,24,0,24,7,0,7,48,0,48
TRIPURA,2007,RAPE,7,0,7,31,0,31,72,0,72,8,0,8,118,0,118
TRIPURA,2007,KIDNAPPING AND ABDUCTION,0,0,0,13,1,14,43,1,44,2,2,4,58,4,62
TRIPURA,2007,DACOITY,0,0,0,2,0,2,4,0,4,2,0,2,8,0,8
TRIPURA,2007,PREP. AND ASSEMBLY FOR DACOITY,0,0,0,2,0,2,0,0,0,0,0,0,2,0,2
TRIPURA,2007,ROBBERY,0,0,0,4,0,4,8,0,8,1,0,1,13,0,13
TRIPURA,2007,BURGLARY,0,0,0,2,0,2,1,0,1,0,0,0,3,0,3
TRIPURA,2007,THEFTS,0,0,0,3,0,3,2,0,2,1,0,1,6,0,6
TRIPURA,2007,EXTORTION,0,0,0,6,0,6,3,0,3,1,0,1,10,0,10
TRIPURA,2007,RIOTS,0,0,0,4,0,4,0,0,0,0,0,0,4,0,4
TRIPURA,2007,ARSON,0,0,0,4,0,4,5,0,5,2,0,2,11,0,11
TRIPURA,2007,CRIMINAL BREACH OF TRUST,0,0,0,1,0,1,3,0,3,1,0,1,5,0,5
TRIPURA,2007,CHEATING,0,0,0,1,0,1,0,0,0,0,0,0,1,0,1
TRIPURA,2007,COUNTER FEITING,0,0,0,1,0,1,1,0,1,0,9,9,2,9,11
TRIPURA,2007,DOWRY DEATHS,0,0,0,9,0,9,20,0,20,2,0,2,31,0,31
TRIPURA,2007,MOLESTATION,0,0,0,1,0,1,1,0,1,1,0,1,3,0,3
TRIPURA,2007,EVE-TEASING,0,0,0,0,0,0,0,0,0,0,0,0,0,0,0
TRIPURA,2007,CRUELTY BY HUSBAND OR RELATIVE OF HUSBAND,0,0,0,24,1,25,14,0,14,1,0,1,39,1,40
TRIPURA,2007,OTHER IPC CRIMES,0,0,0,10,0,10,14,0,14,6,0,6,30,0,30
TRIPURA,2007,TOTAL IPC,7,0,7,247,3,250,423,9,432,96,11,107,773,23,796
TRIPURA,2008,MURDER,0,0,0,87,1,88,198,3,201,10,3,13,295,7,302
TRIPURA,2008,ATTEMPT TO COMMIT MURDER,0,0,0,3,1,4,18,0,18,1,0,1,22,1,23
TRIPURA,2008,C.H. NOT AMOUNTING TO MURDER,0,0,0,0,0,0,2,0,2,1,1,2,3,1,4
TRIPURA,2008,RAPE,1,0,1,35,0,35,47,0,47,10,0,10,93,0,93
TRIPURA,2008,KIDNAPPING AND ABDUCTION,0,0,0,31,0,31,34,2,36,3,0,3,68,2,70
TRIPURA,2008,DACOITY,0,0,0,1,0,1,2,0,2,2,0,2,5,0,5
TRIPURA,2008,PREP. AND ASSEMBLY FOR DACOITY,0,0,0,0,0,0,0,0,0,0,0,0,0,0,0
TRIPURA,2008,ROBBERY,0,0,0,2,0,2,2,0,2,1,0,1,5,0,5
TRIPURA,2008,BURGLARY,0,0,0,0,0,0,1,0,1,1,0,1,2,0,2
TRIPURA,2008,THEFTS,0,0,0,10,0,10,18,0,18,1,0,1,29,0,29
TRIPURA,2008,EXTORTION,0,0,0,5,0,5,4,0,4,0,0,0,9,0,9
TRIPURA,2008,RIOTS,0,0,0,5,0,5,10,0,10,1,0,1,16,0,16
TRIPURA,2008,ARSON,0,0,0,3,0,3,8,0,8,1,0,1,12,0,12
TRIPURA,2008,CRIMINAL BREACH OF TRUST,0,0,0,2,0,2,3,0,3,0,0,0,5,0,5
TRIPURA,2008,CHEATING,0,0,0,1,0,1,0,0,0,0,0,0,1,0,1
TRIPURA,2008,COUNTER FEITING,0,0,0,6,0,6,4,0,4,0,0,0,10,0,10
TRIPURA,2008,DOWRY DEATHS,0,0,0,12,0,12,14,1,15,4,3,7,30,4,34
TRIPURA,2008,MOLESTATION,0,0,0,0,0,0,1,0,1,0,0,0,1,0,1
TRIPURA,2008,EVE-TEASING,0,0,0,0,0,0,1,0,1,0,0,0,1,0,1
TRIPURA,2008,CRUELTY BY HUSBAND OR RELATIVE OF HUSBAND,0,0,0,30,0,30,36,0,36,7,4,11,73,4,77
TRIPURA,2008,OTHER IPC CRIMES,2,0,2,56,0,56,36,0,36,13,0,13,107,0,107
TRIPURA,2008,TOTAL IPC,3,0,3,289,2,291,439,6,445,56,11,67,787,19,806
TRIPURA,2009,MURDER,0,0,0,56,0,56,198,2,200,50,2,52,304,4,308
TRIPURA,2009,ATTEMPT TO COMMIT MURDER,0,0,0,4,1,5,8,0,8,1,0,1,13,1,14
TRIPURA,2009,C.H. NOT AMOUNTING TO MURDER,0,0,0,11,0,11,25,1,26,5,0,5,41,1,42
TRIPURA,2009,RAPE,0,0,0,34,0,34,58,0,58,3,0,3,95,0,95
TRIPURA,2009,KIDNAPPING AND ABDUCTION,0,0,0,10,0,10,21,0,21,3,0,3,34,0,34
TRIPURA,2009,DACOITY,0,0,0,1,0,1,3,0,3,1,0,1,5,0,5
TRIPURA,2009,PREP. AND ASSEMBLY FOR DACOITY,0,0,0,0,0,0,0,0,0,0,0,0,0,0,0
TRIPURA,2009,ROBBERY,0,0,0,1,0,1,3,0,3,0,0,0,4,0,4
TRIPURA,2009,BURGLARY,0,0,0,2,0,2,1,0,1,0,0,0,3,0,3
TRIPURA,2009,THEFTS,0,0,0,6,0,6,1,0,1,0,0,0,7,0,7
TRIPURA,2009,EXTORTION,0,0,0,2,0,2,1,0,1,0,0,0,3,0,3
TRIPURA,2009,RIOTS,0,0,0,0,0,0,4,0,4,2,0,2,6,0,6
TRIPURA,2009,ARSON,0,0,0,1,0,1,0,0,0,0,0,0,1,0,1
TRIPURA,2009,CRIMINAL BREACH OF TRUST,0,0,0,1,0,1,0,0,0,0,0,0,1,0,1
TRIPURA,2009,CHEATING,0,0,0,0,0,0,0,0,0,0,0,0,0,0,0
TRIPURA,2009,COUNTER FEITING,0,0,0,0,0,0,0,0,0,0,0,0,0,0,0
TRIPURA,2009,DOWRY DEATHS,0,0,0,7,0,7,18,0,18,6,1,7,31,1,32
TRIPURA,2009,MOLESTATION,0,0,0,0,0,0,1,0,1,0,0,0,1,0,1
TRIPURA,2009,EVE-TEASING,0,0,0,0,0,0,0,0,0,0,0,0,0,0,0
TRIPURA,2009,CRUELTY BY HUSBAND OR RELATIVE OF HUSBAND,0,0,0,10,1,11,13,2,15,2,4,6,25,7,32
TRIPURA,2009,OTHER IPC CRIMES,0,0,0,13,0,13,15,0,15,8,0,8,36,0,36
TRIPURA,2009,TOTAL IPC,0,0,0,159,2,161,370,5,375,81,7,88,610,14,624
TRIPURA,2010,MURDER,0,0,0,49,1,50,191,2,193,37,3,40,277,6,283
TRIPURA,2010,ATTEMPT TO COMMIT MURDER,0,0,0,2,0,2,8,1,9,3,0,3,13,1,14
TRIPURA,2010,C.H. NOT AMOUNTING TO MURDER,0,0,0,8,0,8,25,1,26,2,0,2,35,1,36
TRIPURA,2010,RAPE,0,0,0,20,0,20,55,0,55,8,0,8,83,0,83
TRIPURA,2010,KIDNAPPING AND ABDUCTION,0,0,0,9,0,9,21,0,21,3,0,3,33,0,33
TRIPURA,2010,DACOITY,0,0,0,0,0,0,1,0,1,2,0,2,3,0,3
TRIPURA,2010,PREP. AND ASSEMBLY FOR DACOITY,0,0,0,0,0,0,0,0,0,0,0,0,0,0,0
TRIPURA,2010,ROBBERY,0,0,0,0,0,0,2,0,2,0,0,0,2,0,2
TRIPURA,2010,BURGLARY,0,0,0,1,0,1,2,0,2,0,0,0,3,0,3
TRIPURA,2010,THEFTS,0,0,0,3,0,3,1,0,1,0,0,0,4,0,4
TRIPURA,2010,EXTORTION,0,0,0,0,0,0,0,0,0,0,0,0,0,0,0
TRIPURA,2010,RIOTS,0,0,0,3,0,3,1,0,1,0,0,0,4,0,4
TRIPURA,2010,ARSON,0,0,0,1,0,1,0,0,0,0,0,0,1,0,1
TRIPURA,2010,CRIMINAL BREACH OF TRUST,0,0,0,0,0,0,1,0,1,1,0,1,2,0,2
TRIPURA,2010,CHEATING,0,0,0,1,0,1,0,0,0,0,0,0,1,0,1
TRIPURA,2010,COUNTER FEITING,0,0,0,0,0,0,3,0,3,0,0,0,3,0,3
TRIPURA,2010,DOWRY DEATHS,0,0,0,6,0,6,11,0,11,1,1,2,18,1,19
TRIPURA,2010,MOLESTATION,0,0,0,6,0,6,12,0,12,2,0,2,20,0,20
TRIPURA,2010,EVE-TEASING,0,0,0,0,0,0,2,0,2,1,0,1,3,0,3
TRIPURA,2010,CRUELTY BY HUSBAND OR RELATIVE OF HUSBAND,0,0,0,7,0,7,11,0,11,1,1,2,19,1,20
TRIPURA,2010,OTHER IPC CRIMES,0,0,0,5,0,5,5,0,5,3,0,3,13,0,13
TRIPURA,2010,TOTAL IPC,0,0,0,121,1,122,352,4,356,64,5,69,537,10,547
TRIPURA,2011,MURDER,0,0,0,46,1,47,183,4,187,52,3,55,281,8,289
TRIPURA,2011,ATTEMPT TO COMMIT MURDER,0,0,0,1,0,1,4,1,5,1,0,1,6,1,7
TRIPURA,2011,C.H. NOT AMOUNTING TO MURDER,0,0,0,17,0,17,20,1,21,5,0,5,42,1,43
TRIPURA,2011,RAPE,0,0,0,29,0,29,58,0,58,6,0,6,93,0,93
TRIPURA,2011,KIDNAPPING AND ABDUCTION,0,0,0,10,0,10,23,0,23,3,0,3,36,0,36
TRIPURA,2011,DACOITY,0,0,0,0,0,0,2,0,2,2,0,2,4,0,4
TRIPURA,2011,PREP. AND ASSEMBLY FOR DACOITY,0,0,0,2,0,2,1,0,1,0,0,0,3,0,3
TRIPURA,2011,ROBBERY,0,0,0,1,0,1,1,0,1,0,0,0,2,0,2
TRIPURA,2011,BURGLARY,0,0,0,0,0,0,1,0,1,0,0,0,1,0,1
TRIPURA,2011,THEFTS,0,0,0,5,0,5,1,0,1,0,0,0,6,0,6
TRIPURA,2011,EXTORTION,0,0,0,0,0,0,0,0,0,0,0,0,0,0,0
TRIPURA,2011,RIOTS,0,0,0,0,0,0,4,0,4,1,0,1,5,0,5
TRIPURA,2011,ARSON,0,0,0,0,0,0,1,0,1,0,0,0,1,0,1
TRIPURA,2011,CRIMINAL BREACH OF TRUST,0,0,0,0,0,0,0,0,0,0,0,0,0,0,0
TRIPURA,2011,CHEATING,0,0,0,0,0,0,3,0,3,0,0,0,3,0,3
TRIPURA,2011,COUNTER FEITING,0,0,0,1,0,1,1,0,1,0,0,0,2,0,2
TRIPURA,2011,DOWRY DEATHS,0,0,0,3,0,3,9,0,9,1,3,4,13,3,16
TRIPURA,2011,MOLESTATION,0,0,0,0,0,0,0,0,0,1,0,1,1,0,1
TRIPURA,2011,EVE-TEASING,0,0,0,0,0,0,0,0,0,0,0,0,0,0,0
TRIPURA,2011,CRUELTY BY HUSBAND OR RELATIVE OF HUSBAND,0,0,0,5,0,5,8,0,8,1,0,1,14,0,14
TRIPURA,2011,OTHER IPC CRIMES,0,0,0,1,0,1,2,0,2,0,0,0,3,0,3
TRIPURA,2011,TOTAL IPC,0,0,0,121,1,122,322,6,328,73,6,79,516,13,529
TRIPURA,2012,MURDER,0,0,0,44,1,45,187,4,191,47,2,49,278,7,285
TRIPURA,2012,ATTEMPT TO COMMIT MURDER,0,0,0,0,0,0,3,0,3,2,0,2,5,0,5
TRIPURA,2012,C.H. NOT AMOUNTING TO MURDER,0,0,0,6,0,6,15,0,15,3,0,3,24,0,24
TRIPURA,2012,RAPE,0,0,0,35,1,36,70,0,70,8,0,8,113,1,114
TRIPURA,2012,KIDNAPPING AND ABDUCTION,0,0,0,13,1,14,20,0,20,2,0,2,35,1,36
TRIPURA,2012,DACOITY,0,0,0,0,0,0,0,0,0,0,0,0,0,0,0
TRIPURA,2012,PREP. AND ASSEMBLY FOR DACOITY,0,0,0,0,0,0,0,0,0,0,0,0,0,0,0
TRIPURA,2012,ROBBERY,0,0,0,0,0,0,0,0,0,0,0,0,0,0,0
TRIPURA,2012,BURGLARY,0,0,0,0,0,0,1,0,1,0,0,0,1,0,1
TRIPURA,2012,THEFTS,0,0,0,5,0,5,1,1,2,0,0,0,6,1,7
TRIPURA,2012,EXTORTION,0,0,0,0,0,0,0,0,0,0,0,0,0,0,0
TRIPURA,2012,RIOTS,0,0,0,0,0,0,5,0,5,2,0,2,7,0,7
TRIPURA,2012,ARSON,0,0,0,0,0,0,0,0,0,0,0,0,0,0,0
TRIPURA,2012,CRIMINAL BREACH OF TRUST,0,0,0,0,0,0,0,0,0,0,0,0,0,0,0
TRIPURA,2012,CHEATING,0,0,0,1,0,1,1,0,1,1,0,1,3,0,3
TRIPURA,2012,COUNTER FEITING,0,0,0,0,0,0,1,0,1,0,0,0,1,0,1
TRIPURA,2012,DOWRY DEATHS,0,0,0,5,1,6,11,0,11,2,0,2,18,1,19
TRIPURA,2012,MOLESTATION,0,0,0,2,0,2,1,0,1,1,0,1,4,0,4
TRIPURA,2012,EVE-TEASING,0,0,0,0,0,0,0,0,0,0,0,0,0,0,0
TRIPURA,2012,CRUELTY BY HUSBAND OR RELATIVE OF HUSBAND,0,0,0,7,0,7,9,1,10,1,0,1,17,1,18
TRIPURA,2012,OTHER IPC CRIMES,0,0,0,2,0,2,3,0,3,1,0,1,6,0,6
TRIPURA,2012,TOTAL IPC,0,0,0,120,4,124,328,6,334,70,2,72,518,12,530
UTTAR PRADESH,2001,MURDER,1,0,1,582,7,589,1429,40,1469,544,28,572,2556,75,2631
UTTAR PRADESH,2001,ATTEMPT TO COMMIT MURDER,0,0,0,89,0,89,150,2,152,36,0,36,275,2,277
UTTAR PRADESH,2001,C.H. NOT AMOUNTING TO MURDER,0,0,0,63,0,63,94,0,94,27,3,30,184,3,187
UTTAR PRADESH,2001,RAPE,2,0,2,134,0,134,97,0,97,16,0,16,249,0,249
UTTAR PRADESH,2001,KIDNAPPING AND ABDUCTION,0,0,0,52,1,53,82,6,88,14,1,15,148,8,156
UTTAR PRADESH,2001,DACOITY,2,0,2,21,0,21,51,1,52,11,0,11,85,1,86
UTTAR PRADESH,2001,PREP. AND ASSEMBLY FOR DACOITY,0,0,0,3,0,3,7,0,7,2,0,2,12,0,12
UTTAR PRADESH,2001,ROBBERY,0,0,0,37,0,37,29,0,29,7,0,7,73,0,73
UTTAR PRADESH,2001,BURGLARY,1,0,1,10,0,10,4,0,4,1,0,1,16,0,16
UTTAR PRADESH,2001,THEFTS,5,0,5,97,0,97,61,0,61,11,0,11,174,0,174
UTTAR PRADESH,2001,EXTORTION,0,0,0,0,0,0,6,0,6,0,0,0,6,0,6
UTTAR PRADESH,2001,RIOTS,0,0,0,2,0,2,4,0,4,0,0,0,6,0,6
UTTAR PRADESH,2001,ARSON,0,0,0,0,0,0,0,0,0,0,0,0,0,0,0
UTTAR PRADESH,2001,CRIMINAL BREACH OF TRUST,0,0,0,1,0,1,1,0,1,1,0,1,3,0,3
UTTAR PRADESH,2001,CHEATING,0,0,0,2,0,2,5,0,5,0,0,0,7,0,7
UTTAR PRADESH,2001,COUNTER FEITING,0,0,0,2,0,2,5,0,5,0,0,0,7,0,7
UTTAR PRADESH,2001,DOWRY DEATHS,0,0,0,74,0,74,67,2,69,30,1,31,171,3,174
UTTAR PRADESH,2001,MOLESTATION,0,0,0,1,0,1,3,0,3,0,0,0,4,0,4
UTTAR PRADESH,2001,EVE-TEASING,0,0,0,0,0,0,0,0,0,0,0,0,0,0,0
UTTAR PRADESH,2001,CRUELTY BY HUSBAND OR RELATIVE OF HUSBAND,0,0,0,10,0,10,8,0,8,1,0,1,19,0,19
UTTAR PRADESH,2001,OTHER IPC CRIMES,2,0,2,44,0,44,59,1,60,2,0,2,107,1,108
UTTAR PRADESH,2001,TOTAL IPC,13,0,13,1224,8,1232,2162,52,2214,703,33,736,4102,93,4195
UTTAR PRADESH,2002,MURDER,1,0,1,546,9,555,1346,46,1392,515,5,520,2408,60,2468
UTTAR PRADESH,2002,ATTEMPT TO COMMIT MURDER,0,0,0,134,0,134,154,2,156,56,1,57,344,3,347
UTTAR PRADESH,2002,C.H. NOT AMOUNTING TO MURDER,0,0,0,66,3,69,52,6,58,57,0,57,175,9,184
UTTAR PRADESH,2002,RAPE,7,0,7,87,0,87,164,0,164,19,0,19,277,0,277
UTTAR PRADESH,2002,KIDNAPPING AND ABDUCTION,0,0,0,60,0,60,65,3,68,16,0,16,141,3,144
UTTAR PRADESH,2002,DACOITY,0,0,0,61,0,61,69,0,69,22,0,22,152,0,152
UTTAR PRADESH,2002,PREP. AND ASSEMBLY FOR DACOITY,0,0,0,42,0,42,25,0,25,2,0,2,69,0,69
UTTAR PRADESH,2002,ROBBERY,0,0,0,31,0,31,38,0,38,3,0,3,72,0,72
UTTAR PRADESH,2002,BURGLARY,0,0,0,36,0,36,25,0,25,3,0,3,64,0,64
UTTAR PRADESH,2002,THEFTS,5,0,5,123,2,125,60,0,60,49,0,49,237,2,239
UTTAR PRADESH,2002,EXTORTION,0,0,0,0,0,0,0,0,0,0,0,0,0,0,0
UTTAR PRADESH,2002,RIOTS,0,0,0,5,0,5,15,0,15,23,0,23,43,0,43
UTTAR PRADESH,2002,ARSON,0,0,0,13,0,13,14,0,14,0,0,0,27,0,27
UTTAR PRADESH,2002,CRIMINAL BREACH OF TRUST,0,0,0,4,0,4,3,0,3,3,0,3,10,0,10
UTTAR PRADESH,2002,CHEATING,0,0,0,1,0,1,5,0,5,0,0,0,6,0,6
UTTAR PRADESH,2002,COUNTER FEITING,0,0,0,8,0,8,9,0,9,3,0,3,20,0,20
UTTAR PRADESH,2002,DOWRY DEATHS,0,0,0,53,0,53,60,6,66,31,1,32,144,7,151
UTTAR PRADESH,2002,MOLESTATION,0,0,0,3,0,3,3,0,3,2,0,2,8,0,8
UTTAR PRADESH,2002,EVE-TEASING,0,0,0,9,0,9,3,0,3,6,0,6,18,0,18
UTTAR PRADESH,2002,CRUELTY BY HUSBAND OR RELATIVE OF HUSBAND,0,0,0,23,0,23,24,0,24,16,0,16,63,0,63
UTTAR PRADESH,2002,OTHER IPC CRIMES,0,0,0,0,0,0,0,0,0,0,0,0,0,0,0
UTTAR PRADESH,2002,TOTAL IPC,13,0,13,1305,14,1319,2134,63,2197,826,7,833,4278,84,4362
UTTAR PRADESH,2003,MURDER,40,0,40,541,9,550,806,19,825,723,15,738,2110,43,2153
UTTAR PRADESH,2003,ATTEMPT TO COMMIT MURDER,0,1,1,196,2,198,334,0,334,154,1,155,684,4,688
UTTAR PRADESH,2003,C.H. NOT AMOUNTING TO MURDER,3,0,3,140,1,141,172,6,178,93,2,95,408,9,417
UTTAR PRADESH,2003,RAPE,0,0,0,187,1,188,141,2,143,43,0,43,371,3,374
UTTAR PRADESH,2003,KIDNAPPING AND ABDUCTION,0,0,0,127,1,128,71,10,81,52,1,53,250,12,262
UTTAR PRADESH,2003,DACOITY,0,0,0,86,0,86,108,0,108,28,0,28,222,0,222
UTTAR PRADESH,2003,PREP. AND ASSEMBLY FOR DACOITY,0,0,0,35,0,35,36,0,36,9,0,9,80,0,80
UTTAR PRADESH,2003,ROBBERY,2,0,2,93,0,93,109,0,109,32,0,32,236,0,236
UTTAR PRADESH,2003,BURGLARY,0,0,0,25,1,26,17,0,17,5,0,5,47,1,48
UTTAR PRADESH,2003,THEFTS,2,0,2,141,0,141,71,0,71,38,0,38,252,0,252
UTTAR PRADESH,2003,EXTORTION,0,0,0,8,0,8,0,0,0,2,0,2,10,0,10
UTTAR PRADESH,2003,RIOTS,0,0,0,1,1,2,8,0,8,0,0,0,9,1,10
UTTAR PRADESH,2003,ARSON,0,0,0,1,0,1,12,0,12,0,0,0,13,0,13
UTTAR PRADESH,2003,CRIMINAL BREACH OF TRUST,0,0,0,2,0,2,31,2,33,2,0,2,35,2,37
UTTAR PRADESH,2003,CHEATING,0,0,0,14,2,16,20,0,20,6,0,6,40,2,42
UTTAR PRADESH,2003,COUNTER FEITING,0,0,0,18,0,18,14,2,16,4,2,6,36,4,40
UTTAR PRADESH,2003,DOWRY DEATHS,4,1,5,75,3,78,87,29,116,126,18,144,292,51,343
UTTAR PRADESH,2003,MOLESTATION,0,0,0,7,0,7,3,0,3,0,0,0,10,0,10
UTTAR PRADESH,2003,EVE-TEASING,0,0,0,0,0,0,0,0,0,0,0,0,0,0,0
UTTAR PRADESH,2003,CRUELTY BY HUSBAND OR RELATIVE OF HUSBAND,0,0,0,24,0,24,71,2,73,40,2,42,135,4,139
UTTAR PRADESH,2003,OTHER IPC CRIMES,0,0,0,0,0,0,0,0,0,0,0,0,0,0,0
UTTAR PRADESH,2003,TOTAL IPC,51,2,53,1721,21,1742,2111,72,2183,1357,41,1398,5240,136,5376
UTTAR PRADESH,2004,MURDER,0,0,0,522,15,537,907,24,931,664,19,683,2093,58,2151
UTTAR PRADESH,2004,ATTEMPT TO COMMIT MURDER,0,0,0,196,2,198,448,7,455,856,6,862,1500,15,1515
UTTAR PRADESH,2004,C.H. NOT AMOUNTING TO MURDER,0,0,0,100,2,102,183,6,189,78,0,78,361,8,369
UTTAR PRADESH,2004,RAPE,0,0,0,172,0,172,158,1,159,41,0,41,371,1,372
UTTAR PRADESH,2004,KIDNAPPING AND ABDUCTION,40,0,40,169,2,171,195,6,201,23,0,23,427,8,435
UTTAR PRADESH,2004,DACOITY,0,0,0,73,0,73,92,1,93,14,0,14,179,1,180
UTTAR PRADESH,2004,PREP. AND ASSEMBLY FOR DACOITY,0,0,0,18,0,18,13,0,13,2,0,2,33,0,33
UTTAR PRADESH,2004,ROBBERY,0,0,0,66,0,66,84,0,84,13,0,13,163,0,163
UTTAR PRADESH,2004,BURGLARY,0,0,0,58,1,59,49,2,51,17,0,17,124,3,127
UTTAR PRADESH,2004,THEFTS,0,0,0,89,2,91,71,0,71,20,0,20,180,2,182
UTTAR PRADESH,2004,EXTORTION,0,0,0,2,0,2,0,0,0,0,0,0,2,0,2
UTTAR PRADESH,2004,RIOTS,0,0,0,7,0,7,12,0,12,0,0,0,19,0,19
UTTAR PRADESH,2004,ARSON,0,0,0,6,0,6,2,0,2,1,0,1,9,0,9
UTTAR PRADESH,2004,CRIMINAL BREACH OF TRUST,0,0,0,9,3,12,11,1,12,0,0,0,20,4,24
UTTAR PRADESH,2004,CHEATING,0,0,0,5,0,5,3,1,4,4,0,4,12,1,13
UTTAR PRADESH,2004,COUNTER FEITING,0,0,0,19,0,19,23,0,23,29,0,29,71,0,71
UTTAR PRADESH,2004,DOWRY DEATHS,0,0,0,149,8,157,142,18,160,73,21,94,364,47,411
UTTAR PRADESH,2004,MOLESTATION,0,0,0,1,0,1,3,0,3,0,0,0,4,0,4
UTTAR PRADESH,2004,EVE-TEASING,0,0,0,0,0,0,1,0,1,0,0,0,1,0,1
UTTAR PRADESH,2004,CRUELTY BY HUSBAND OR RELATIVE OF HUSBAND,0,0,0,6,0,6,4,2,6,3,0,3,13,2,15
UTTAR PRADESH,2004,OTHER IPC CRIMES,0,0,0,24,1,25,14,3,17,8,0,8,46,4,50
UTTAR PRADESH,2004,TOTAL IPC,40,0,40,1691,36,1727,2415,72,2487,1846,46,1892,5992,154,6146
UTTAR PRADESH,2005,MURDER,0,0,0,359,5,364,1758,79,1837,991,24,1015,3108,108,3216
UTTAR PRADESH,2005,ATTEMPT TO COMMIT MURDER,0,0,0,334,3,337,779,2,781,722,1,723,1835,6,1841
UTTAR PRADESH,2005,C.H. NOT AMOUNTING TO MURDER,0,0,0,160,0,160,225,4,229,106,1,107,491,5,496
UTTAR PRADESH,2005,RAPE,12,0,12,324,1,325,304,2,306,71,0,71,711,3,714
UTTAR PRADESH,2005,KIDNAPPING AND ABDUCTION,1,0,1,163,2,165,175,5,180,54,1,55,393,8,401
UTTAR PRADESH,2005,DACOITY,0,0,0,65,0,65,115,0,115,28,0,28,208,0,208
UTTAR PRADESH,2005,PREP. AND ASSEMBLY FOR DACOITY,0,0,0,14,0,14,27,0,27,7,0,7,48,0,48
UTTAR PRADESH,2005,ROBBERY,0,0,0,61,0,61,101,0,101,48,0,48,210,0,210
UTTAR PRADESH,2005,BURGLARY,0,0,0,22,0,22,23,0,23,9,0,9,54,0,54
UTTAR PRADESH,2005,THEFTS,10,0,10,181,2,183,237,1,238,66,0,66,494,3,497
UTTAR PRADESH,2005,EXTORTION,0,0,0,8,0,8,9,0,9,3,0,3,20,0,20
UTTAR PRADESH,2005,RIOTS,0,0,0,0,0,0,5,0,5,0,0,0,5,0,5
UTTAR PRADESH,2005,ARSON,0,0,0,1,0,1,0,0,0,9,0,9,10,0,10
UTTAR PRADESH,2005,CRIMINAL BREACH OF TRUST,0,0,0,2,0,2,4,0,4,3,0,3,9,0,9
UTTAR PRADESH,2005,CHEATING,1,0,1,4,0,4,5,0,5,7,0,7,17,0,17
UTTAR PRADESH,2005,COUNTER FEITING,0,0,0,3,0,3,6,0,6,8,0,8,17,0,17
UTTAR PRADESH,2005,DOWRY DEATHS,0,0,0,292,10,302,466,41,507,253,12,265,1011,63,1074
UTTAR PRADESH,2005,MOLESTATION,0,0,0,1,0,1,6,0,6,2,0,2,9,0,9
UTTAR PRADESH,2005,EVE-TEASING,0,0,0,3,0,3,2,0,2,1,0,1,6,0,6
UTTAR PRADESH,2005,CRUELTY BY HUSBAND OR RELATIVE OF HUSBAND,0,0,0,7,2,9,30,2,32,28,0,28,65,4,69
UTTAR PRADESH,2005,OTHER IPC CRIMES,0,0,0,43,0,43,38,5,43,6,0,6,87,5,92
UTTAR PRADESH,2005,TOTAL IPC,24,0,24,2047,25,2072,4315,141,4456,2422,39,2461,8808,205,9013
UTTAR PRADESH,2006,MURDER,18,0,18,1301,22,1323,2813,107,2920,1384,46,1430,5516,175,5691
UTTAR PRADESH,2006,ATTEMPT TO COMMIT MURDER,3,0,3,695,16,711,1243,22,1265,638,3,641,2579,41,2620
UTTAR PRADESH,2006,C.H. NOT AMOUNTING TO MURDER,7,0,7,147,3,150,301,7,308,116,6,122,571,16,587
UTTAR PRADESH,2006,RAPE,0,0,0,505,0,505,348,3,351,52,0,52,905,3,908
UTTAR PRADESH,2006,KIDNAPPING AND ABDUCTION,0,0,0,231,4,235,298,14,312,59,3,62,588,21,609
UTTAR PRADESH,2006,DACOITY,0,0,0,74,0,74,109,0,109,28,0,28,211,0,211
UTTAR PRADESH,2006,PREP. AND ASSEMBLY FOR DACOITY,0,0,0,45,0,45,59,3,62,14,0,14,118,3,121
UTTAR PRADESH,2006,ROBBERY,0,0,0,80,0,80,99,2,101,40,0,40,219,2,221
UTTAR PRADESH,2006,BURGLARY,0,0,0,22,0,22,35,0,35,9,0,9,66,0,66
UTTAR PRADESH,2006,THEFTS,0,0,0,185,5,190,247,4,251,69,1,70,501,10,511
UTTAR PRADESH,2006,EXTORTION,0,0,0,37,0,37,24,0,24,14,0,14,75,0,75
UTTAR PRADESH,2006,RIOTS,0,0,0,8,0,8,4,0,4,0,0,0,12,0,12
UTTAR PRADESH,2006,ARSON,0,0,0,3,0,3,3,0,3,0,0,0,6,0,6
UTTAR PRADESH,2006,CRIMINAL BREACH OF TRUST,0,0,0,1,0,1,5,0,5,2,0,2,8,0,8
UTTAR PRADESH,2006,CHEATING,0,0,0,144,0,144,91,2,93,43,0,43,278,2,280
UTTAR PRADESH,2006,COUNTER FEITING,0,0,0,18,0,18,26,0,26,30,0,30,74,0,74
UTTAR PRADESH,2006,DOWRY DEATHS,0,0,0,265,35,300,306,65,371,151,18,169,722,118,840
UTTAR PRADESH,2006,MOLESTATION,0,0,0,5,0,5,4,0,4,6,0,6,15,0,15
UTTAR PRADESH,2006,EVE-TEASING,0,0,0,2,0,2,0,0,0,0,0,0,2,0,2
UTTAR PRADESH,2006,CRUELTY BY HUSBAND OR RELATIVE OF HUSBAND,0,0,0,16,1,17,15,1,16,11,1,12,42,3,45
UTTAR PRADESH,2006,OTHER IPC CRIMES,0,0,0,111,2,113,89,6,95,34,2,36,234,10,244
UTTAR PRADESH,2006,TOTAL IPC,28,0,28,3895,88,3983,6119,236,6355,2700,80,2780,12742,404,13146
UTTAR PRADESH,2007,MURDER,0,0,0,1662,32,1694,4281,105,4386,1997,70,2067,7940,207,8147
UTTAR PRADESH,2007,ATTEMPT TO COMMIT MURDER,0,0,0,602,10,612,2014,26,2040,1022,5,1027,3638,41,3679
UTTAR PRADESH,2007,C.H. NOT AMOUNTING TO MURDER,0,0,0,192,1,193,372,17,389,196,4,200,760,22,782
UTTAR PRADESH,2007,RAPE,0,0,0,669,1,670,444,1,445,85,0,85,1198,2,1200
UTTAR PRADESH,2007,KIDNAPPING AND ABDUCTION,0,0,0,347,8,355,359,15,374,113,2,115,819,25,844
UTTAR PRADESH,2007,DACOITY,0,0,0,109,0,109,162,1,163,55,0,55,326,1,327
UTTAR PRADESH,2007,PREP. AND ASSEMBLY FOR DACOITY,0,0,0,25,0,25,30,0,30,6,0,6,61,0,61
UTTAR PRADESH,2007,ROBBERY,0,0,0,85,0,85,102,0,102,28,0,28,215,0,215
UTTAR PRADESH,2007,BURGLARY,0,0,0,13,0,13,36,0,36,4,0,4,53,0,53
UTTAR PRADESH,2007,THEFTS,2,0,2,147,0,147,141,1,142,44,0,44,334,1,335
UTTAR PRADESH,2007,EXTORTION,0,0,0,0,0,0,0,0,0,0,0,0,0,0,0
UTTAR PRADESH,2007,RIOTS,0,0,0,0,0,0,1,0,1,2,0,2,3,0,3
UTTAR PRADESH,2007,ARSON,0,0,0,9,0,9,9,0,9,3,0,3,21,0,21
UTTAR PRADESH,2007,CRIMINAL BREACH OF TRUST,0,0,0,12,0,12,11,0,11,1,0,1,24,0,24
UTTAR PRADESH,2007,CHEATING,0,0,0,0,0,0,23,2,25,4,0,4,27,2,29
UTTAR PRADESH,2007,COUNTER FEITING,0,0,0,30,0,30,44,0,44,37,0,37,111,0,111
UTTAR PRADESH,2007,DOWRY DEATHS,0,0,0,416,23,439,367,104,471,197,39,236,980,166,1146
UTTAR PRADESH,2007,MOLESTATION,0,0,0,5,1,6,4,0,4,0,0,0,9,1,10
UTTAR PRADESH,2007,EVE-TEASING,0,0,0,0,0,0,0,0,0,0,0,0,0,0,0
UTTAR PRADESH,2007,CRUELTY BY HUSBAND OR RELATIVE OF HUSBAND,0,0,0,43,1,44,96,4,100,53,0,53,192,5,197
UTTAR PRADESH,2007,OTHER IPC CRIMES,0,0,0,50,3,53,80,4,84,21,0,21,151,7,158
UTTAR PRADESH,2007,TOTAL IPC,2,0,2,4416,80,4496,8576,280,8856,3868,120,3988,16862,480,17342
UTTAR PRADESH,2008,MURDER,0,0,0,1054,26,1080,3941,90,4031,1850,85,1935,6845,201,7046
UTTAR PRADESH,2008,ATTEMPT TO COMMIT MURDER,0,0,0,589,3,592,1910,11,1921,1128,4,1132,3627,18,3645
UTTAR PRADESH,2008,C.H. NOT AMOUNTING TO MURDER,0,0,0,279,5,284,456,24,480,233,20,253,968,49,1017
UTTAR PRADESH,2008,RAPE,0,0,0,603,0,603,643,2,645,180,2,182,1426,4,1430
UTTAR PRADESH,2008,KIDNAPPING AND ABDUCTION,0,0,0,294,10,304,241,13,254,105,3,108,640,26,666
UTTAR PRADESH,2008,DACOITY,0,0,0,101,0,101,168,1,169,98,0,98,367,1,368
UTTAR PRADESH,2008,PREP. AND ASSEMBLY FOR DACOITY,0,0,0,22,0,22,27,0,27,11,0,11,60,0,60
UTTAR PRADESH,2008,ROBBERY,0,0,0,118,0,118,128,0,128,25,0,25,271,0,271
UTTAR PRADESH,2008,BURGLARY,0,0,0,56,0,56,40,0,40,24,0,24,120,0,120
UTTAR PRADESH,2008,THEFTS,0,0,0,248,5,253,179,3,182,50,1,51,477,9,486
UTTAR PRADESH,2008,EXTORTION,0,0,0,12,0,12,14,0,14,6,0,6,32,0,32
UTTAR PRADESH,2008,RIOTS,0,0,0,5,0,5,2,0,2,0,0,0,7,0,7
UTTAR PRADESH,2008,ARSON,0,0,0,12,0,12,13,0,13,3,0,3,28,0,28
UTTAR PRADESH,2008,CRIMINAL BREACH OF TRUST,0,0,0,3,0,3,11,5,16,10,0,10,24,5,29
UTTAR PRADESH,2008,CHEATING,0,0,0,15,0,15,10,1,11,5,0,5,30,1,31
UTTAR PRADESH,2008,COUNTER FEITING,0,0,0,14,0,14,40,3,43,9,1,10,63,4,67
UTTAR PRADESH,2008,DOWRY DEATHS,0,0,0,454,23,477,563,94,657,349,77,426,1366,194,1560
UTTAR PRADESH,2008,MOLESTATION,0,0,0,8,0,8,7,1,8,6,1,7,21,2,23
UTTAR PRADESH,2008,EVE-TEASING,0,0,0,2,0,2,1,0,1,0,0,0,3,0,3
UTTAR PRADESH,2008,CRUELTY BY HUSBAND OR RELATIVE OF HUSBAND,0,0,0,56,4,60,62,4,66,64,1,65,182,9,191
UTTAR PRADESH,2008,OTHER IPC CRIMES,0,0,0,156,1,157,756,9,765,185,15,200,1097,25,1122
UTTAR PRADESH,2008,TOTAL IPC,0,0,0,4101,77,4178,9212,261,9473,4341,210,4551,17654,548,18202
UTTAR PRADESH,2009,MURDER,0,0,0,2226,44,2270,5921,120,6041,3222,89,3311,11369,253,11622
UTTAR PRADESH,2009,ATTEMPT TO COMMIT MURDER,0,0,0,771,3,774,837,9,846,296,1,297,1904,13,1917
UTTAR PRADESH,2009,C.H. NOT AMOUNTING TO MURDER,0,0,0,240,6,246,401,23,424,254,6,260,895,35,930
UTTAR PRADESH,2009,RAPE,0,0,0,664,0,664,785,4,789,273,0,273,1722,4,1726
UTTAR PRADESH,2009,KIDNAPPING AND ABDUCTION,0,0,0,222,8,230,411,17,428,205,5,210,838,30,868
UTTAR PRADESH,2009,DACOITY,0,0,0,88,0,88,209,0,209,78,0,78,375,0,375
UTTAR PRADESH,2009,PREP. AND ASSEMBLY FOR DACOITY,0,0,0,28,0,28,42,0,42,33,0,33,103,0,103
UTTAR PRADESH,2009,ROBBERY,0,0,0,126,0,126,164,0,164,69,0,69,359,0,359
UTTAR PRADESH,2009,BURGLARY,0,0,0,45,0,45,59,1,60,35,0,35,139,1,140
UTTAR PRADESH,2009,THEFTS,0,0,0,224,1,225,276,2,278,94,1,95,594,4,598
UTTAR PRADESH,2009,EXTORTION,0,0,0,17,0,17,29,0,29,16,0,16,62,0,62
UTTAR PRADESH,2009,RIOTS,0,0,0,4,0,4,8,0,8,5,1,6,17,1,18
UTTAR PRADESH,2009,ARSON,0,0,0,11,0,11,9,0,9,5,0,5,25,0,25
UTTAR PRADESH,2009,CRIMINAL BREACH OF TRUST,0,0,0,11,0,11,16,0,16,17,0,17,44,0,44
UTTAR PRADESH,2009,CHEATING,0,0,0,8,0,8,21,1,22,9,0,9,38,1,39
UTTAR PRADESH,2009,COUNTER FEITING,0,0,0,19,0,19,56,0,56,26,2,28,101,2,103
UTTAR PRADESH,2009,DOWRY DEATHS,0,0,0,465,35,500,867,147,1014,624,105,729,1956,287,2243
UTTAR PRADESH,2009,MOLESTATION,0,0,0,6,0,6,4,0,4,7,0,7,17,0,17
UTTAR PRADESH,2009,EVE-TEASING,0,0,0,0,0,0,0,0,0,0,0,0,0,0,0
UTTAR PRADESH,2009,CRUELTY BY HUSBAND OR RELATIVE OF HUSBAND,0,0,0,78,1,79,201,11,212,205,6,211,484,18,502
UTTAR PRADESH,2009,OTHER IPC CRIMES,0,0,0,51,0,51,84,2,86,43,1,44,178,3,181
UTTAR PRADESH,2009,TOTAL IPC,0,0,0,5304,98,5402,10400,337,10737,5516,217,5733,21220,652,21872
UTTAR PRADESH,2010,MURDER,0,0,0,2176,51,2227,5971,132,6103,3270,91,3361,11417,274,11691
UTTAR PRADESH,2010,ATTEMPT TO COMMIT MURDER,0,0,0,721,4,725,857,11,868,302,2,304,1880,17,1897
UTTAR PRADESH,2010,C.H. NOT AMOUNTING TO MURDER,0,0,0,229,7,236,412,25,437,287,7,294,928,39,967
UTTAR PRADESH,2010,RAPE,0,0,0,644,0,644,810,5,815,287,0,287,1741,5,1746
UTTAR PRADESH,2010,KIDNAPPING AND ABDUCTION,0,0,0,212,10,222,421,18,439,215,6,221,848,34,882
UTTAR PRADESH,2010,DACOITY,0,0,0,83,0,83,307,0,307,81,0,81,471,0,471
UTTAR PRADESH,2010,PREP. AND ASSEMBLY FOR DACOITY,0,0,0,25,0,25,52,0,52,62,0,62,139,0,139
UTTAR PRADESH,2010,ROBBERY,0,0,0,116,0,116,193,0,193,72,0,72,381,0,381
UTTAR PRADESH,2010,BURGLARY,0,0,0,43,0,43,76,2,78,56,0,56,175,2,177
UTTAR PRADESH,2010,THEFTS,0,0,0,214,2,216,302,3,305,125,2,127,641,7,648
UTTAR PRADESH,2010,EXTORTION,0,0,0,16,0,16,35,0,35,22,0,22,73,0,73
UTTAR PRADESH,2010,RIOTS,0,0,0,5,0,5,10,0,10,7,2,9,22,2,24
UTTAR PRADESH,2010,ARSON,0,0,0,13,0,13,11,0,11,6,0,6,30,0,30
UTTAR PRADESH,2010,CRIMINAL BREACH OF TRUST,0,0,0,13,0,13,18,0,18,17,0,17,48,0,48
UTTAR PRADESH,2010,CHEATING,0,0,0,10,0,10,23,2,25,11,0,11,44,2,46
UTTAR PRADESH,2010,COUNTER FEITING,0,0,0,19,0,19,58,0,58,32,3,35,109,3,112
UTTAR PRADESH,2010,DOWRY DEATHS,0,0,0,435,36,471,930,149,1079,734,108,842,2099,293,2392
UTTAR PRADESH,2010,MOLESTATION,0,0,0,6,0,6,6,0,6,9,0,9,21,0,21
UTTAR PRADESH,2010,EVE-TEASING,0,0,0,0,0,0,0,0,0,0,0,0,0,0,0
UTTAR PRADESH,2010,CRUELTY BY HUSBAND OR RELATIVE OF HUSBAND,0,0,0,95,1,96,212,15,227,236,10,246,543,26,569
UTTAR PRADESH,2010,OTHER IPC CRIMES,0,0,0,274,0,274,294,4,298,59,3,62,627,7,634
UTTAR PRADESH,2010,TOTAL IPC,0,0,0,5349,111,5460,10998,366,11364,5890,234,6124,22237,711,22948
UTTAR PRADESH,2011,MURDER,0,0,0,2188,53,2241,6102,137,6239,3291,96,3387,11581,286,11867
UTTAR PRADESH,2011,ATTEMPT TO COMMIT MURDER,0,0,0,743,5,748,903,17,920,312,3,315,1958,25,1983
UTTAR PRADESH,2011,C.H. NOT AMOUNTING TO MURDER,0,0,0,233,7,240,433,29,462,296,8,304,962,44,1006
UTTAR PRADESH,2011,RAPE,0,0,0,654,0,654,822,9,831,292,0,292,1768,9,1777
UTTAR PRADESH,2011,KIDNAPPING AND ABDUCTION,0,0,0,217,11,228,437,22,459,219,6,225,873,39,912
UTTAR PRADESH,2011,DACOITY,0,0,0,89,0,89,313,0,313,87,0,87,489,0,489
UTTAR PRADESH,2011,PREP. AND ASSEMBLY FOR DACOITY,0,0,0,27,0,27,57,0,57,67,0,67,151,0,151
UTTAR PRADESH,2011,ROBBERY,0,0,0,123,0,123,203,0,203,76,0,76,402,0,402
UTTAR PRADESH,2011,BURGLARY,0,0,0,47,0,47,91,4,95,57,0,57,195,4,199
UTTAR PRADESH,2011,THEFTS,0,0,0,225,3,228,362,5,367,131,2,133,718,10,728
UTTAR PRADESH,2011,EXTORTION,0,0,0,17,0,17,36,0,36,24,0,24,77,0,77
UTTAR PRADESH,2011,RIOTS,0,0,0,6,0,6,21,0,21,9,2,11,36,2,38
UTTAR PRADESH,2011,ARSON,0,0,0,15,0,15,13,0,13,8,0,8,36,0,36
UTTAR PRADESH,2011,CRIMINAL BREACH OF TRUST,0,0,0,16,0,16,21,0,21,22,0,22,59,0,59
UTTAR PRADESH,2011,CHEATING,0,0,0,11,0,11,37,3,40,13,0,13,61,3,64
UTTAR PRADESH,2011,COUNTER FEITING,0,0,0,21,0,21,62,0,62,33,3,36,116,3,119
UTTAR PRADESH,2011,DOWRY DEATHS,0,0,0,439,47,486,952,178,1130,797,118,915,2188,343,2531
UTTAR PRADESH,2011,MOLESTATION,0,0,0,7,0,7,9,0,9,12,0,12,28,0,28
UTTAR PRADESH,2011,EVE-TEASING,0,0,0,0,0,0,0,0,0,0,0,0,0,0,0
UTTAR PRADESH,2011,CRUELTY BY HUSBAND OR RELATIVE OF HUSBAND,0,0,0,99,2,101,231,15,246,274,13,287,604,30,634
UTTAR PRADESH,2011,OTHER IPC CRIMES,0,0,0,361,0,361,312,4,316,130,3,133,803,7,810
UTTAR PRADESH,2011,TOTAL IPC,0,0,0,5538,128,5666,11417,423,11840,6150,254,6404,23105,805,23910
UTTAR PRADESH,2012,MURDER,0,0,0,2090,46,2136,6006,135,6141,3047,93,3140,11143,274,11417
UTTAR PRADESH,2012,ATTEMPT TO COMMIT MURDER,0,0,0,705,4,709,800,15,815,300,2,302,1805,21,1826
UTTAR PRADESH,2012,C.H. NOT AMOUNTING TO MURDER,0,0,0,225,5,230,323,27,350,285,7,292,833,39,872
UTTAR PRADESH,2012,RAPE,0,0,0,590,0,590,750,8,758,276,0,276,1616,8,1624
UTTAR PRADESH,2012,KIDNAPPING AND ABDUCTION,0,0,0,210,9,219,400,20,420,202,6,208,812,35,847
UTTAR PRADESH,2012,DACOITY,0,0,0,85,0,85,285,0,285,85,0,85,455,0,455
UTTAR PRADESH,2012,PREP. AND ASSEMBLY FOR DACOITY,0,0,0,26,0,26,58,0,58,66,0,66,150,0,150
UTTAR PRADESH,2012,ROBBERY,0,0,0,122,0,122,200,0,200,74,0,74,396,0,396
UTTAR PRADESH,2012,BURGLARY,0,0,0,45,0,45,85,3,88,53,0,53,183,3,186
UTTAR PRADESH,2012,THEFTS,0,0,0,225,2,227,355,4,359,130,2,132,710,8,718
UTTAR PRADESH,2012,EXTORTION,0,0,0,17,0,17,36,0,36,23,0,23,76,0,76
UTTAR PRADESH,2012,RIOTS,0,0,0,5,0,5,20,0,20,8,2,10,33,2,35
UTTAR PRADESH,2012,ARSON,0,0,0,4,0,4,12,0,12,7,0,7,23,0,23
UTTAR PRADESH,2012,CRIMINAL BREACH OF TRUST,0,0,0,12,0,12,20,0,20,20,0,20,52,0,52
UTTAR PRADESH,2012,CHEATING,0,0,0,9,0,9,36,2,38,12,0,12,57,2,59
UTTAR PRADESH,2012,COUNTER FEITING,0,0,0,15,0,15,60,0,60,32,2,34,107,2,109
UTTAR PRADESH,2012,DOWRY DEATHS,0,0,0,358,43,401,952,173,1125,751,118,869,2061,334,2395
UTTAR PRADESH,2012,MOLESTATION,0,0,0,6,0,6,10,0,10,11,0,11,27,0,27
UTTAR PRADESH,2012,EVE-TEASING,0,0,0,0,0,0,0,0,0,0,0,0,0,0,0
UTTAR PRADESH,2012,CRUELTY BY HUSBAND OR RELATIVE OF HUSBAND,0,0,0,82,1,83,231,13,244,225,13,238,538,27,565
UTTAR PRADESH,2012,OTHER IPC CRIMES,0,0,0,325,0,325,312,3,315,125,2,127,762,5,767
UTTAR PRADESH,2012,TOTAL IPC,0,0,0,5156,110,5266,10951,403,11354,5732,247,5979,21839,760,22599
UTTARANCHAL,2001,MURDER,0,0,0,42,0,42,232,0,232,38,0,38,312,0,312
UTTARANCHAL,2001,ATTEMPT TO COMMIT MURDER,0,0,0,8,1,9,9,0,9,1,0,1,18,1,19
UTTARANCHAL,2001,C.H. NOT AMOUNTING TO MURDER,0,0,0,2,0,2,2,0,2,1,0,1,5,0,5
UTTARANCHAL,2001,RAPE,0,0,0,4,0,4,3,0,3,1,0,1,8,0,8
UTTARANCHAL,2001,KIDNAPPING AND ABDUCTION,0,0,0,0,0,0,3,0,3,0,0,0,3,0,3
UTTARANCHAL,2001,DACOITY,0,0,0,2,0,2,5,0,5,0,0,0,7,0,7
UTTARANCHAL,2001,PREP. AND ASSEMBLY FOR DACOITY,0,0,0,0,0,0,0,0,0,0,0,0,0,0,0
UTTARANCHAL,2001,ROBBERY,5,0,5,0,0,0,1,0,1,0,0,0,6,0,6
UTTARANCHAL,2001,BURGLARY,1,0,1,0,0,0,2,0,2,4,0,4,7,0,7
UTTARANCHAL,2001,THEFTS,7,0,7,6,0,6,8,0,8,1,0,1,22,0,22
UTTARANCHAL,2001,EXTORTION,0,0,0,0,0,0,0,0,0,0,0,0,0,0,0
UTTARANCHAL,2001,RIOTS,0,0,0,0,0,0,0,0,0,0,0,0,0,0,0
UTTARANCHAL,2001,ARSON,0,0,0,0,0,0,0,0,0,0,0,0,0,0,0
UTTARANCHAL,2001,CRIMINAL BREACH OF TRUST,0,0,0,0,0,0,0,0,0,3,0,3,3,0,3
UTTARANCHAL,2001,CHEATING,0,0,0,0,0,0,0,0,0,0,0,0,0,0,0
UTTARANCHAL,2001,COUNTER FEITING,0,0,0,0,0,0,0,0,0,3,0,3,3,0,3
UTTARANCHAL,2001,DOWRY DEATHS,2,0,2,9,1,10,11,0,11,3,0,3,25,1,26
UTTARANCHAL,2001,MOLESTATION,1,0,1,0,0,0,0,0,0,0,0,0,1,0,1
UTTARANCHAL,2001,EVE-TEASING,0,0,0,0,0,0,0,0,0,0,0,0,0,0,0
UTTARANCHAL,2001,CRUELTY BY HUSBAND OR RELATIVE OF HUSBAND,0,0,0,6,0,6,0,0,0,0,0,0,6,0,6
UTTARANCHAL,2001,OTHER IPC CRIMES,0,0,0,0,0,0,0,0,0,0,0,0,0,0,0
UTTARANCHAL,2001,TOTAL IPC,16,0,16,79,2,81,276,0,276,55,0,55,426,2,428
UTTARANCHAL,2002,MURDER,0,0,0,65,0,65,242,6,248,54,0,54,361,6,367
UTTARANCHAL,2002,ATTEMPT TO COMMIT MURDER,0,0,0,9,0,9,20,0,20,3,0,3,32,0,32
UTTARANCHAL,2002,C.H. NOT AMOUNTING TO MURDER,0,0,0,2,0,2,6,0,6,4,0,4,12,0,12
UTTARANCHAL,2002,RAPE,1,0,1,13,0,13,3,2,5,0,0,0,17,2,19
UTTARANCHAL,2002,KIDNAPPING AND ABDUCTION,0,0,0,2,0,2,2,0,2,1,0,1,5,0,5
UTTARANCHAL,2002,DACOITY,0,0,0,3,0,3,6,0,6,1,0,1,10,0,10
UTTARANCHAL,2002,PREP. AND ASSEMBLY FOR DACOITY,0,0,0,0,0,0,1,0,1,4,0,4,5,0,5
UTTARANCHAL,2002,ROBBERY,0,0,0,3,0,3,2,0,2,0,0,0,5,0,5
UTTARANCHAL,2002,BURGLARY,0,0,0,4,0,4,4,0,4,0,0,0,8,0,8
UTTARANCHAL,2002,THEFTS,2,0,2,13,0,13,23,0,23,12,0,12,50,0,50
UTTARANCHAL,2002,EXTORTION,0,0,0,4,0,4,0,0,0,0,0,0,4,0,4
UTTARANCHAL,2002,RIOTS,0,0,0,0,0,0,0,0,0,0,0,0,0,0,0
UTTARANCHAL,2002,ARSON,0,0,0,0,0,0,0,0,0,0,0,0,0,0,0
UTTARANCHAL,2002,CRIMINAL BREACH OF TRUST,0,0,0,0,0,0,0,0,0,0,0,0,0,0,0
UTTARANCHAL,2002,CHEATING,0,0,0,0,1,1,0,0,0,0,0,0,0,1,1
UTTARANCHAL,2002,COUNTER FEITING,0,0,0,0,0,0,0,0,0,0,0,0,0,0,0
UTTARANCHAL,2002,DOWRY DEATHS,0,0,0,8,0,8,3,2,5,3,0,3,14,2,16
UTTARANCHAL,2002,MOLESTATION,0,0,0,0,0,0,0,0,0,0,0,0,0,0,0
UTTARANCHAL,2002,EVE-TEASING,0,0,0,0,0,0,0,0,0,0,0,0,0,0,0
UTTARANCHAL,2002,CRUELTY BY HUSBAND OR RELATIVE OF HUSBAND,0,0,0,0,1,1,0,0,0,0,0,0,0,1,1
UTTARANCHAL,2002,OTHER IPC CRIMES,0,0,0,1,0,1,0,0,0,0,0,0,1,0,1
UTTARANCHAL,2002,TOTAL IPC,3,0,3,127,2,129,312,10,322,82,0,82,524,12,536
UTTARANCHAL,2003,MURDER,0,0,0,51,0,51,234,2,236,102,3,105,387,5,392
UTTARANCHAL,2003,ATTEMPT TO COMMIT MURDER,0,0,0,12,0,12,21,0,21,9,0,9,42,0,42
UTTARANCHAL,2003,C.H. NOT AMOUNTING TO MURDER,0,0,0,3,0,3,0,0,0,0,0,0,3,0,3
UTTARANCHAL,2003,RAPE,1,0,1,21,0,21,20,0,20,0,0,0,42,0,42
UTTARANCHAL,2003,KIDNAPPING AND ABDUCTION,0,0,0,5,0,5,1,0,1,0,0,0,6,0,6
UTTARANCHAL,2003,DACOITY,0,0,0,7,0,7,5,0,5,2,0,2,14,0,14
UTTARANCHAL,2003,PREP. AND ASSEMBLY FOR DACOITY,0,0,0,2,0,2,0,0,0,6,0,6,8,0,8
UTTARANCHAL,2003,ROBBERY,0,0,0,7,0,7,1,0,1,0,0,0,8,0,8
UTTARANCHAL,2003,BURGLARY,0,0,0,1,0,1,3,0,3,0,0,0,4,0,4
UTTARANCHAL,2003,THEFTS,2,0,2,8,0,8,14,0,14,5,0,5,29,0,29
UTTARANCHAL,2003,EXTORTION,0,0,0,1,0,1,1,0,1,0,0,0,2,0,2
UTTARANCHAL,2003,RIOTS,0,0,0,0,0,0,0,0,0,0,0,0,0,0,0
UTTARANCHAL,2003,ARSON,0,0,0,1,0,1,0,0,0,0,0,0,1,0,1
UTTARANCHAL,2003,CRIMINAL BREACH OF TRUST,0,0,0,0,0,0,0,0,0,0,0,0,0,0,0
UTTARANCHAL,2003,CHEATING,0,0,0,0,0,0,1,0,1,0,0,0,1,0,1
UTTARANCHAL,2003,COUNTER FEITING,0,0,0,0,0,0,1,0,1,0,0,0,1,0,1
UTTARANCHAL,2003,DOWRY DEATHS,0,0,0,14,2,16,7,1,8,2,1,3,23,4,27
UTTARANCHAL,2003,MOLESTATION,0,0,0,0,0,0,1,0,1,0,0,0,1,0,1
UTTARANCHAL,2003,EVE-TEASING,0,0,0,0,0,0,0,0,0,0,0,0,0,0,0
UTTARANCHAL,2003,CRUELTY BY HUSBAND OR RELATIVE OF HUSBAND,0,0,0,0,0,0,0,2,2,0,1,1,0,3,3
UTTARANCHAL,2003,OTHER IPC CRIMES,0,0,0,1,0,1,1,0,1,1,0,1,3,0,3
UTTARANCHAL,2003,TOTAL IPC,3,0,3,134,2,136,311,5,316,127,5,132,575,12,587
UTTARANCHAL,2004,MURDER,0,0,0,22,1,23,175,1,176,71,0,71,268,2,270
UTTARANCHAL,2004,ATTEMPT TO COMMIT MURDER,0,0,0,15,0,15,27,0,27,10,0,10,52,0,52
UTTARANCHAL,2004,C.H. NOT AMOUNTING TO MURDER,0,0,0,1,0,1,3,0,3,2,0,2,6,0,6
UTTARANCHAL,2004,RAPE,0,0,0,2,0,2,2,3,5,0,0,0,4,3,7
UTTARANCHAL,2004,KIDNAPPING AND ABDUCTION,0,0,0,3,0,3,13,0,13,0,0,0,16,0,16
UTTARANCHAL,2004,DACOITY,0,0,0,0,0,0,0,0,0,0,0,0,0,0,0
UTTARANCHAL,2004,PREP. AND ASSEMBLY FOR DACOITY,0,0,0,4,0,4,12,0,12,5,0,5,21,0,21
UTTARANCHAL,2004,ROBBERY,0,0,0,0,0,0,0,0,0,0,0,0,0,0,0
UTTARANCHAL,2004,BURGLARY,0,0,0,1,0,1,1,0,1,0,0,0,2,0,2
UTTARANCHAL,2004,THEFTS,0,0,0,3,0,3,5,0,5,4,0,4,12,0,12
UTTARANCHAL,2004,EXTORTION,0,0,0,0,0,0,0,0,0,0,0,0,0,0,0
UTTARANCHAL,2004,RIOTS,0,0,0,2,0,2,3,0,3,2,2,4,7,2,9
UTTARANCHAL,2004,ARSON,0,0,0,0,0,0,0,0,0,0,0,0,0,0,0
UTTARANCHAL,2004,CRIMINAL BREACH OF TRUST,0,0,0,3,0,3,4,0,4,5,0,5,12,0,12
UTTARANCHAL,2004,CHEATING,0,0,0,2,0,2,3,0,3,0,0,0,5,0,5
UTTARANCHAL,2004,COUNTER FEITING,0,0,0,9,3,12,5,0,5,16,0,16,30,3,33
UTTARANCHAL,2004,DOWRY DEATHS,0,0,0,0,0,0,0,0,0,0,0,0,0,0,0
UTTARANCHAL,2004,MOLESTATION,0,0,0,3,0,3,5,0,5,0,0,0,8,0,8
UTTARANCHAL,2004,EVE-TEASING,0,0,0,1,0,1,0,0,0,1,0,1,2,0,2
UTTARANCHAL,2004,CRUELTY BY HUSBAND OR RELATIVE OF HUSBAND,0,0,0,7,0,7,8,3,11,7,0,7,22,3,25
UTTARANCHAL,2004,OTHER IPC CRIMES,0,0,0,0,0,0,0,0,0,0,0,0,0,0,0
UTTARANCHAL,2004,TOTAL IPC,0,0,0,78,4,82,266,7,273,123,2,125,467,13,480
UTTARANCHAL,2005,MURDER,0,0,0,86,1,87,256,4,260,138,1,139,480,6,486
UTTARANCHAL,2005,ATTEMPT TO COMMIT MURDER,0,0,0,14,0,14,4,0,4,1,0,1,19,0,19
UTTARANCHAL,2005,C.H. NOT AMOUNTING TO MURDER,0,0,0,12,0,12,9,1,10,3,1,4,24,2,26
UTTARANCHAL,2005,RAPE,0,0,0,27,0,27,9,0,9,2,0,2,38,0,38
UTTARANCHAL,2005,KIDNAPPING AND ABDUCTION,0,0,0,3,1,4,3,0,3,1,1,2,7,2,9
UTTARANCHAL,2005,DACOITY,0,0,0,3,0,3,6,0,6,1,0,1,10,0,10
UTTARANCHAL,2005,PREP. AND ASSEMBLY FOR DACOITY,0,0,0,0,0,0,0,0,0,0,0,0,0,0,0
UTTARANCHAL,2005,ROBBERY,0,0,0,3,0,3,1,0,1,0,0,0,4,0,4
UTTARANCHAL,2005,BURGLARY,0,0,0,10,0,10,1,0,1,0,0,0,11,0,11
UTTARANCHAL,2005,THEFTS,0,0,0,11,0,11,7,0,7,0,0,0,18,0,18
UTTARANCHAL,2005,EXTORTION,0,0,0,0,0,0,0,0,0,0,0,0,0,0,0
UTTARANCHAL,2005,RIOTS,0,0,0,0,0,0,0,0,0,0,0,0,0,0,0
UTTARANCHAL,2005,ARSON,0,0,0,0,0,0,0,0,0,0,0,0,0,0,0
UTTARANCHAL,2005,CRIMINAL BREACH OF TRUST,0,0,0,0,0,0,2,0,2,0,0,0,2,0,2
UTTARANCHAL,2005,CHEATING,0,0,0,0,0,0,0,0,0,0,0,0,0,0,0
UTTARANCHAL,2005,COUNTER FEITING,0,0,0,0,0,0,0,0,0,0,0,0,0,0,0
UTTARANCHAL,2005,DOWRY DEATHS,0,0,0,3,0,3,4,0,4,1,0,1,8,0,8
UTTARANCHAL,2005,MOLESTATION,0,0,0,0,0,0,0,0,0,0,0,0,0,0,0
UTTARANCHAL,2005,EVE-TEASING,0,0,0,0,0,0,0,0,0,0,0,0,0,0,0
UTTARANCHAL,2005,CRUELTY BY HUSBAND OR RELATIVE OF HUSBAND,0,0,0,0,0,0,1,1,2,0,0,0,1,1,2
UTTARANCHAL,2005,OTHER IPC CRIMES,0,0,0,0,0,0,0,0,0,0,0,0,0,0,0
UTTARANCHAL,2005,TOTAL IPC,0,0,0,172,2,174,303,6,309,147,3,150,622,11,633
UTTARANCHAL,2006,MURDER,1,0,1,131,0,131,240,7,247,151,3,154,523,10,533
UTTARANCHAL,2006,ATTEMPT TO COMMIT MURDER,0,0,0,17,0,17,13,1,14,7,0,7,37,1,38
UTTARANCHAL,2006,C.H. NOT AMOUNTING TO MURDER,0,0,0,16,0,16,10,0,10,8,2,10,34,2,36
UTTARANCHAL,2006,RAPE,0,0,0,35,0,35,18,0,18,9,0,9,62,0,62
UTTARANCHAL,2006,KIDNAPPING AND ABDUCTION,0,0,0,2,1,3,2,0,2,1,0,1,5,1,6
UTTARANCHAL,2006,DACOITY,0,0,0,4,0,4,4,0,4,2,0,2,10,0,10
UTTARANCHAL,2006,PREP. AND ASSEMBLY FOR DACOITY,0,0,0,4,0,4,0,0,0,0,0,0,4,0,4
UTTARANCHAL,2006,ROBBERY,0,0,0,3,0,3,1,0,1,1,0,1,5,0,5
UTTARANCHAL,2006,BURGLARY,0,0,0,4,0,4,7,0,7,3,0,3,14,0,14
UTTARANCHAL,2006,THEFTS,4,0,4,21,0,21,10,0,10,1,0,1,36,0,36
UTTARANCHAL,2006,EXTORTION,0,0,0,0,0,0,0,0,0,0,0,0,0,0,0
UTTARANCHAL,2006,RIOTS,0,0,0,3,0,3,2,0,2,3,0,3,8,0,8
UTTARANCHAL,2006,ARSON,0,0,0,0,0,0,0,0,0,0,0,0,0,0,0
UTTARANCHAL,2006,CRIMINAL BREACH OF TRUST,0,0,0,0,0,0,0,0,0,1,0,1,1,0,1
UTTARANCHAL,2006,CHEATING,0,0,0,0,0,0,1,0,1,0,0,0,1,0,1
UTTARANCHAL,2006,COUNTER FEITING,0,0,0,2,0,2,3,1,4,0,0,0,5,1,6
UTTARANCHAL,2006,DOWRY DEATHS,0,0,0,11,0,11,6,0,6,6,1,7,23,1,24
UTTARANCHAL,2006,MOLESTATION,0,0,0,1,0,1,3,0,3,1,0,1,5,0,5
UTTARANCHAL,2006,EVE-TEASING,0,0,0,0,0,0,0,0,0,0,0,0,0,0,0
UTTARANCHAL,2006,CRUELTY BY HUSBAND OR RELATIVE OF HUSBAND,0,0,0,0,0,0,0,0,0,0,0,0,0,0,0
UTTARANCHAL,2006,OTHER IPC CRIMES,0,0,0,0,0,0,0,0,0,1,0,1,1,0,1
UTTARANCHAL,2006,TOTAL IPC,5,0,5,254,1,255,320,9,329,195,6,201,774,16,790
UTTARANCHAL,2007,MURDER,0,0,0,157,0,157,128,12,140,244,3,247,529,15,544
UTTARANCHAL,2007,ATTEMPT TO COMMIT MURDER,0,0,0,21,0,21,12,1,13,10,0,10,43,1,44
UTTARANCHAL,2007,C.H. NOT AMOUNTING TO MURDER,0,0,0,16,0,16,13,2,15,9,1,10,38,3,41
UTTARANCHAL,2007,RAPE,0,0,0,42,0,42,19,0,19,13,1,14,74,1,75
UTTARANCHAL,2007,KIDNAPPING AND ABDUCTION,0,0,0,17,1,18,11,0,11,2,0,2,30,1,31
UTTARANCHAL,2007,DACOITY,0,0,0,8,0,8,6,0,6,6,0,6,20,0,20
UTTARANCHAL,2007,PREP. AND ASSEMBLY FOR DACOITY,0,0,0,0,0,0,0,0,0,0,0,0,0,0,0
UTTARANCHAL,2007,ROBBERY,0,0,0,5,0,5,3,0,3,0,0,0,8,0,8
UTTARANCHAL,2007,BURGLARY,0,0,0,3,0,3,4,0,4,4,0,4,11,0,11
UTTARANCHAL,2007,THEFTS,0,0,0,10,0,10,4,0,4,0,0,0,14,0,14
UTTARANCHAL,2007,EXTORTION,0,0,0,0,0,0,0,0,0,0,0,0,0,0,0
UTTARANCHAL,2007,RIOTS,0,0,0,5,0,5,2,0,2,1,0,1,8,0,8
UTTARANCHAL,2007,ARSON,0,0,0,0,0,0,0,0,0,0,0,0,0,0,0
UTTARANCHAL,2007,CRIMINAL BREACH OF TRUST,0,0,0,0,0,0,0,0,0,0,0,0,0,0,0
UTTARANCHAL,2007,CHEATING,0,0,0,0,0,0,3,0,3,0,0,0,3,0,3
UTTARANCHAL,2007,COUNTER FEITING,0,0,0,7,0,7,2,1,3,1,1,2,10,2,12
UTTARANCHAL,2007,DOWRY DEATHS,0,0,0,15,0,15,9,0,9,2,0,2,26,0,26
UTTARANCHAL,2007,MOLESTATION,0,0,0,1,0,1,0,0,0,0,0,0,1,0,1
UTTARANCHAL,2007,EVE-TEASING,0,0,0,0,0,0,0,0,0,0,0,0,0,0,0
UTTARANCHAL,2007,CRUELTY BY HUSBAND OR RELATIVE OF HUSBAND,0,0,0,0,3,3,0,0,0,0,0,0,0,3,3
UTTARANCHAL,2007,OTHER IPC CRIMES,0,0,0,3,0,3,0,0,0,0,0,0,3,0,3
UTTARANCHAL,2007,TOTAL IPC,0,0,0,310,4,314,216,16,232,292,6,298,818,26,844
UTTARANCHAL,2008,MURDER,0,0,0,181,1,182,276,11,287,239,1,240,696,13,709
UTTARANCHAL,2008,ATTEMPT TO COMMIT MURDER,0,0,0,27,1,28,56,0,56,14,0,14,97,1,98
UTTARANCHAL,2008,C.H. NOT AMOUNTING TO MURDER,0,0,0,14,0,14,20,4,24,4,0,4,38,4,42
UTTARANCHAL,2008,RAPE,0,0,0,29,0,29,17,0,17,1,0,1,47,0,47
UTTARANCHAL,2008,KIDNAPPING AND ABDUCTION,0,0,0,13,0,13,18,0,18,1,0,1,32,0,32
UTTARANCHAL,2008,DACOITY,0,0,0,4,0,4,5,0,5,3,0,3,12,0,12
UTTARANCHAL,2008,PREP. AND ASSEMBLY FOR DACOITY,0,0,0,0,0,0,0,0,0,0,0,0,0,0,0
UTTARANCHAL,2008,ROBBERY,0,0,0,5,0,5,1,0,1,0,0,0,6,0,6
UTTARANCHAL,2008,BURGLARY,0,0,0,0,0,0,0,0,0,0,0,0,0,0,0
UTTARANCHAL,2008,THEFTS,0,0,0,0,0,0,0,0,0,0,0,0,0,0,0
UTTARANCHAL,2008,EXTORTION,0,0,0,0,0,0,0,0,0,0,0,0,0,0,0
UTTARANCHAL,2008,RIOTS,0,0,0,0,0,0,0,0,0,0,0,0,0,0,0
UTTARANCHAL,2008,ARSON,0,0,0,0,0,0,0,0,0,0,0,0,0,0,0
UTTARANCHAL,2008,CRIMINAL BREACH OF TRUST,0,0,0,0,0,0,0,0,0,0,0,0,0,0,0
UTTARANCHAL,2008,CHEATING,0,0,0,0,0,0,0,0,0,0,0,0,0,0,0
UTTARANCHAL,2008,COUNTER FEITING,0,0,0,2,0,2,1,2,3,0,0,0,3,2,5
UTTARANCHAL,2008,DOWRY DEATHS,0,0,0,25,5,30,18,4,22,4,1,5,47,10,57
UTTARANCHAL,2008,MOLESTATION,0,0,0,0,0,0,0,0,0,0,0,0,0,0,0
UTTARANCHAL,2008,EVE-TEASING,0,0,0,0,0,0,0,0,0,0,0,0,0,0,0
UTTARANCHAL,2008,CRUELTY BY HUSBAND OR RELATIVE OF HUSBAND,0,0,0,0,0,0,0,0,0,0,0,0,0,0,0
UTTARANCHAL,2008,OTHER IPC CRIMES,0,0,0,6,0,6,13,0,13,4,0,4,23,0,23
UTTARANCHAL,2008,TOTAL IPC,0,0,0,306,7,313,425,21,446,270,2,272,1001,30,1031
UTTARANCHAL,2009,MURDER,0,0,0,130,0,130,233,4,237,207,6,213,570,10,580
UTTARANCHAL,2009,ATTEMPT TO COMMIT MURDER,0,0,0,31,1,32,19,0,19,31,0,31,81,1,82
UTTARANCHAL,2009,C.H. NOT AMOUNTING TO MURDER,0,0,0,36,3,39,21,0,21,20,1,21,77,4,81
UTTARANCHAL,2009,RAPE,0,0,0,21,0,21,30,0,30,11,0,11,62,0,62
UTTARANCHAL,2009,KIDNAPPING AND ABDUCTION,0,0,0,10,0,10,16,2,18,13,0,13,39,2,41
UTTARANCHAL,2009,DACOITY,0,0,0,11,1,12,12,0,12,8,0,8,31,1,32
UTTARANCHAL,2009,PREP. AND ASSEMBLY FOR DACOITY,0,0,0,0,0,0,0,0,0,0,0,0,0,0,0
UTTARANCHAL,2009,ROBBERY,0,0,0,4,0,4,11,0,11,0,0,0,15,0,15
UTTARANCHAL,2009,BURGLARY,0,0,0,7,0,7,14,3,17,5,0,5,26,3,29
UTTARANCHAL,2009,THEFTS,0,0,0,17,2,19,25,1,26,0,0,0,42,3,45
UTTARANCHAL,2009,EXTORTION,0,0,0,0,0,0,0,0,0,0,0,0,0,0,0
UTTARANCHAL,2009,RIOTS,0,0,0,6,0,6,12,2,14,0,0,0,18,2,20
UTTARANCHAL,2009,ARSON,0,0,0,0,0,0,0,0,0,2,0,2,2,0,2
UTTARANCHAL,2009,CRIMINAL BREACH OF TRUST,0,0,0,0,0,0,16,0,16,4,0,4,20,0,20
UTTARANCHAL,2009,CHEATING,0,0,0,0,0,0,2,0,2,0,0,0,2,0,2
UTTARANCHAL,2009,COUNTER FEITING,0,0,0,2,0,2,3,0,3,0,0,0,5,0,5
UTTARANCHAL,2009,DOWRY DEATHS,0,0,0,21,1,22,18,5,23,7,0,7,46,6,52
UTTARANCHAL,2009,MOLESTATION,0,0,0,0,0,0,6,0,6,0,0,0,6,0,6
UTTARANCHAL,2009,EVE-TEASING,0,0,0,0,0,0,0,0,0,0,0,0,0,0,0
UTTARANCHAL,2009,CRUELTY BY HUSBAND OR RELATIVE OF HUSBAND,0,0,0,0,0,0,4,0,4,4,0,4,8,0,8
UTTARANCHAL,2009,OTHER IPC CRIMES,0,0,0,6,0,6,5,0,5,5,0,5,16,0,16
UTTARANCHAL,2009,TOTAL IPC,0,0,0,302,8,310,447,17,464,317,7,324,1066,32,1098
UTTARANCHAL,2010,MURDER,0,0,0,132,1,133,276,8,284,205,4,209,613,13,626
UTTARANCHAL,2010,ATTEMPT TO COMMIT MURDER,0,0,0,39,0,39,33,1,34,28,0,28,100,1,101
UTTARANCHAL,2010,C.H. NOT AMOUNTING TO MURDER,0,0,0,18,0,18,22,2,24,15,2,17,55,4,59
UTTARANCHAL,2010,RAPE,0,0,0,41,0,41,17,0,17,15,0,15,73,0,73
UTTARANCHAL,2010,KIDNAPPING AND ABDUCTION,0,0,0,10,0,10,16,0,16,10,0,10,36,0,36
UTTARANCHAL,2010,DACOITY,0,0,0,3,0,3,15,0,15,5,0,5,23,0,23
UTTARANCHAL,2010,PREP. AND ASSEMBLY FOR DACOITY,0,0,0,0,0,0,0,0,0,0,0,0,0,0,0
UTTARANCHAL,2010,ROBBERY,0,0,0,4,0,4,17,0,17,7,0,7,28,0,28
UTTARANCHAL,2010,BURGLARY,0,0,0,11,0,11,1,5,6,0,0,0,12,5,17
UTTARANCHAL,2010,THEFTS,0,0,0,37,0,37,22,1,23,4,0,4,63,1,64
UTTARANCHAL,2010,EXTORTION,0,0,0,0,0,0,0,0,0,0,0,0,0,0,0
UTTARANCHAL,2010,RIOTS,0,0,0,0,0,0,4,3,7,0,0,0,4,3,7
UTTARANCHAL,2010,ARSON,0,0,0,0,0,0,2,0,2,0,0,0,2,0,2
UTTARANCHAL,2010,CRIMINAL BREACH OF TRUST,0,0,0,8,0,8,6,0,6,3,2,5,17,2,19
UTTARANCHAL,2010,CHEATING,0,0,0,0,0,0,0,0,0,1,0,1,1,0,1
UTTARANCHAL,2010,COUNTER FEITING,0,0,0,3,0,3,2,0,2,0,0,0,5,0,5
UTTARANCHAL,2010,DOWRY DEATHS,0,0,0,29,4,33,20,6,26,6,3,9,55,13,68
UTTARANCHAL,2010,MOLESTATION,0,0,0,12,0,12,4,0,4,0,0,0,16,0,16
UTTARANCHAL,2010,EVE-TEASING,0,0,0,0,0,0,0,0,0,0,0,0,0,0,0
UTTARANCHAL,2010,CRUELTY BY HUSBAND OR RELATIVE OF HUSBAND,0,0,0,21,3,24,3,0,3,0,0,0,24,3,27
UTTARANCHAL,2010,OTHER IPC CRIMES,0,0,0,8,0,8,3,0,3,0,0,0,11,0,11
UTTARANCHAL,2010,TOTAL IPC,0,0,0,376,8,384,463,26,489,299,11,310,1138,45,1183
UTTARANCHAL,2011,MURDER,0,0,0,8,2,10,510,12,522,170,12,182,688,26,714
UTTARANCHAL,2011,ATTEMPT TO COMMIT MURDER,0,0,0,12,0,12,117,2,119,70,1,71,199,3,202
UTTARANCHAL,2011,C.H. NOT AMOUNTING TO MURDER,0,0,0,12,0,12,59,2,61,62,1,63,133,3,136
UTTARANCHAL,2011,RAPE,0,0,0,11,0,11,31,0,31,33,1,34,75,1,76
UTTARANCHAL,2011,KIDNAPPING AND ABDUCTION,0,0,0,13,0,13,32,1,33,24,1,25,69,2,71
UTTARANCHAL,2011,DACOITY,0,0,0,11,0,11,4,0,4,12,1,13,27,1,28
UTTARANCHAL,2011,PREP. AND ASSEMBLY FOR DACOITY,0,0,0,0,0,0,5,0,5,4,1,5,9,1,10
UTTARANCHAL,2011,ROBBERY,0,0,0,0,0,0,2,0,2,0,0,0,2,0,2
UTTARANCHAL,2011,BURGLARY,0,0,0,0,0,0,3,2,5,3,1,4,6,3,9
UTTARANCHAL,2011,THEFTS,0,0,0,4,0,4,3,1,4,4,1,5,11,2,13
UTTARANCHAL,2011,EXTORTION,0,0,0,0,0,0,0,0,0,0,0,0,0,0,0
UTTARANCHAL,2011,RIOTS,0,0,0,2,0,2,0,0,0,0,0,0,2,0,2
UTTARANCHAL,2011,ARSON,0,0,0,0,0,0,0,0,0,0,0,0,0,0,0
UTTARANCHAL,2011,CRIMINAL BREACH OF TRUST,0,0,0,0,0,0,0,0,0,0,0,0,0,0,0
UTTARANCHAL,2011,CHEATING,0,0,0,0,0,0,0,0,0,0,0,0,0,0,0
UTTARANCHAL,2011,COUNTER FEITING,0,0,0,0,0,0,0,0,0,0,0,0,0,0,0
UTTARANCHAL,2011,DOWRY DEATHS,0,0,0,6,0,6,65,7,72,50,8,58,121,15,136
UTTARANCHAL,2011,MOLESTATION,0,0,0,1,0,1,0,0,0,0,0,0,1,0,1
UTTARANCHAL,2011,EVE-TEASING,0,0,0,0,0,0,0,0,0,0,0,0,0,0,0
UTTARANCHAL,2011,CRUELTY BY HUSBAND OR RELATIVE OF HUSBAND,0,0,0,2,0,2,0,0,0,3,0,3,5,0,5
UTTARANCHAL,2011,OTHER IPC CRIMES,0,0,0,0,0,0,0,0,0,0,0,0,0,0,0
UTTARANCHAL,2011,TOTAL IPC,0,0,0,82,2,84,831,27,858,435,28,463,1348,57,1405
UTTARANCHAL,2012,MURDER,0,0,0,164,3,167,322,11,333,241,4,245,727,18,745
UTTARANCHAL,2012,ATTEMPT TO COMMIT MURDER,0,0,0,52,0,52,39,0,39,25,0,25,116,0,116
UTTARANCHAL,2012,C.H. NOT AMOUNTING TO MURDER,0,0,0,22,0,22,23,3,26,12,0,12,57,3,60
UTTARANCHAL,2012,RAPE,0,0,0,48,0,48,21,0,21,16,0,16,85,0,85
UTTARANCHAL,2012,KIDNAPPING AND ABDUCTION,0,0,0,12,0,12,18,0,18,11,0,11,41,0,41
UTTARANCHAL,2012,DACOITY,0,0,0,4,0,4,12,0,12,8,0,8,24,0,24
UTTARANCHAL,2012,PREP. AND ASSEMBLY FOR DACOITY,0,0,0,2,0,2,0,0,0,0,0,0,2,0,2
UTTARANCHAL,2012,ROBBERY,0,0,0,8,0,8,22,0,22,9,0,9,39,0,39
UTTARANCHAL,2012,BURGLARY,0,0,0,12,0,12,11,0,11,3,0,3,26,0,26
UTTARANCHAL,2012,THEFTS,0,0,0,42,0,42,22,4,26,8,0,8,72,4,76
UTTARANCHAL,2012,EXTORTION,0,0,0,0,0,0,0,0,0,0,0,0,0,0,0
UTTARANCHAL,2012,RIOTS,0,0,0,0,0,0,0,0,0,0,0,0,0,0,0
UTTARANCHAL,2012,ARSON,0,0,0,2,0,2,0,0,0,0,0,0,2,0,2
UTTARANCHAL,2012,CRIMINAL BREACH OF TRUST,0,0,0,10,0,10,8,0,8,5,3,8,23,3,26
UTTARANCHAL,2012,CHEATING,0,0,0,0,0,0,3,0,3,0,0,0,3,0,3
UTTARANCHAL,2012,COUNTER FEITING,0,0,0,3,0,3,2,0,2,0,0,0,5,0,5
UTTARANCHAL,2012,DOWRY DEATHS,0,0,0,42,8,50,22,9,31,6,2,8,70,19,89
UTTARANCHAL,2012,MOLESTATION,0,0,0,11,0,11,2,0,2,0,0,0,13,0,13
UTTARANCHAL,2012,EVE-TEASING,0,0,0,0,0,0,0,0,0,0,0,0,0,0,0
UTTARANCHAL,2012,CRUELTY BY HUSBAND OR RELATIVE OF HUSBAND,0,0,0,24,5,29,3,0,3,0,0,0,27,5,32
UTTARANCHAL,2012,OTHER IPC CRIMES,0,0,0,3,0,3,0,0,0,0,0,0,3,0,3
UTTARANCHAL,2012,TOTAL IPC,0,0,0,461,16,477,530,27,557,344,9,353,1335,52,1387
WEST BENGAL,2001,MURDER,1,0,1,371,5,376,614,12,626,166,6,172,1152,23,1175
WEST BENGAL,2001,ATTEMPT TO COMMIT MURDER,2,0,2,37,2,39,51,6,57,4,0,4,94,8,102
WEST BENGAL,2001,C.H. NOT AMOUNTING TO MURDER,0,0,0,35,2,37,43,7,50,12,0,12,90,9,99
WEST BENGAL,2001,RAPE,7,0,7,46,0,46,40,0,40,6,0,6,99,0,99
WEST BENGAL,2001,KIDNAPPING AND ABDUCTION,0,0,0,8,0,8,8,0,8,1,0,1,17,0,17
WEST BENGAL,2001,DACOITY,4,0,4,75,2,77,87,5,92,9,0,9,175,7,182
WEST BENGAL,2001,PREP. AND ASSEMBLY FOR DACOITY,0,0,0,4,0,4,3,0,3,1,0,1,8,0,8
WEST BENGAL,2001,ROBBERY,0,0,0,11,0,11,12,0,12,1,0,1,24,0,24
WEST BENGAL,2001,BURGLARY,0,0,0,1,0,1,3,0,3,0,0,0,4,0,4
WEST BENGAL,2001,THEFTS,5,0,5,51,5,56,41,5,46,15,0,15,112,10,122
WEST BENGAL,2001,EXTORTION,0,0,0,5,0,5,2,0,2,0,0,0,7,0,7
WEST BENGAL,2001,RIOTS,0,0,0,0,0,0,0,0,0,0,0,0,0,0,0
WEST BENGAL,2001,ARSON,0,0,0,2,0,2,3,0,3,0,0,0,5,0,5
WEST BENGAL,2001,CRIMINAL BREACH OF TRUST,0,0,0,0,0,0,0,0,0,0,0,0,0,0,0
WEST BENGAL,2001,CHEATING,0,0,0,2,0,2,3,0,3,0,0,0,5,0,5
WEST BENGAL,2001,COUNTER FEITING,0,0,0,0,0,0,0,0,0,0,0,0,0,0,0
WEST BENGAL,2001,DOWRY DEATHS,0,0,0,2,0,2,5,0,5,2,0,2,9,0,9
WEST BENGAL,2001,MOLESTATION,0,0,0,0,0,0,0,0,0,0,0,0,0,0,0
WEST BENGAL,2001,EVE-TEASING,0,0,0,0,0,0,0,0,0,0,0,0,0,0,0
WEST BENGAL,2001,CRUELTY BY HUSBAND OR RELATIVE OF HUSBAND,0,0,0,10,0,10,13,3,16,2,0,2,25,3,28
WEST BENGAL,2001,OTHER IPC CRIMES,0,0,0,20,0,20,13,7,20,1,0,1,34,7,41
WEST BENGAL,2001,TOTAL IPC,19,0,19,680,16,696,941,45,986,220,6,226,1860,67,1927
WEST BENGAL,2002,MURDER,0,0,0,458,2,460,532,25,557,152,15,167,1142,42,1184
WEST BENGAL,2002,ATTEMPT TO COMMIT MURDER,0,0,0,47,0,47,85,2,87,4,1,5,136,3,139
WEST BENGAL,2002,C.H. NOT AMOUNTING TO MURDER,0,0,0,32,0,32,39,6,45,4,0,4,75,6,81
WEST BENGAL,2002,RAPE,1,0,1,44,0,44,19,0,19,4,0,4,68,0,68
WEST BENGAL,2002,KIDNAPPING AND ABDUCTION,0,0,0,9,0,9,10,2,12,1,0,1,20,2,22
WEST BENGAL,2002,DACOITY,1,0,1,55,0,55,43,2,45,8,0,8,107,2,109
WEST BENGAL,2002,PREP. AND ASSEMBLY FOR DACOITY,0,0,0,7,0,7,3,0,3,1,0,1,11,0,11
WEST BENGAL,2002,ROBBERY,0,0,0,15,0,15,20,0,20,0,0,0,35,0,35
WEST BENGAL,2002,BURGLARY,0,0,0,2,0,2,1,0,1,0,0,0,3,0,3
WEST BENGAL,2002,THEFTS,0,0,0,23,0,23,30,2,32,1,0,1,54,2,56
WEST BENGAL,2002,EXTORTION,0,0,0,3,0,3,2,0,2,0,0,0,5,0,5
WEST BENGAL,2002,RIOTS,0,0,0,0,0,0,0,0,0,0,0,0,0,0,0
WEST BENGAL,2002,ARSON,0,0,0,0,0,0,0,0,0,0,0,0,0,0,0
WEST BENGAL,2002,CRIMINAL BREACH OF TRUST,0,0,0,0,0,0,0,0,0,0,0,0,0,0,0
WEST BENGAL,2002,CHEATING,0,0,0,2,0,2,1,0,1,0,0,0,3,0,3
WEST BENGAL,2002,COUNTER FEITING,0,0,0,0,0,0,0,0,0,0,0,0,0,0,0
WEST BENGAL,2002,DOWRY DEATHS,0,0,0,34,2,36,34,6,40,2,7,9,70,15,85
WEST BENGAL,2002,MOLESTATION,0,0,0,0,0,0,0,0,0,0,0,0,0,0,0
WEST BENGAL,2002,EVE-TEASING,0,0,0,0,0,0,0,0,0,0,0,0,0,0,0
WEST BENGAL,2002,CRUELTY BY HUSBAND OR RELATIVE OF HUSBAND,0,0,0,18,0,18,18,1,19,11,2,13,47,3,50
WEST BENGAL,2002,OTHER IPC CRIMES,0,0,0,29,7,36,24,0,24,3,0,3,56,7,63
WEST BENGAL,2002,TOTAL IPC,2,0,2,778,11,789,861,46,907,191,25,216,1832,82,1914
WEST BENGAL,2003,MURDER,0,0,0,380,10,390,830,23,853,141,13,154,1351,46,1397
WEST BENGAL,2003,ATTEMPT TO COMMIT MURDER,0,0,0,108,2,110,96,3,99,26,0,26,230,5,235
WEST BENGAL,2003,C.H. NOT AMOUNTING TO MURDER,0,0,0,33,0,33,49,6,55,12,2,14,94,8,102
WEST BENGAL,2003,RAPE,0,0,0,93,0,93,58,0,58,6,0,6,157,0,157
WEST BENGAL,2003,KIDNAPPING AND ABDUCTION,0,0,0,30,1,31,25,4,29,5,0,5,60,5,65
WEST BENGAL,2003,DACOITY,0,0,0,87,0,87,96,1,97,8,0,8,191,1,192
WEST BENGAL,2003,PREP. AND ASSEMBLY FOR DACOITY,0,0,0,4,0,4,6,0,6,0,0,0,10,0,10
WEST BENGAL,2003,ROBBERY,0,0,0,19,0,19,33,1,34,4,0,4,56,1,57
WEST BENGAL,2003,BURGLARY,0,0,0,1,0,1,1,0,1,0,0,0,2,0,2
WEST BENGAL,2003,THEFTS,0,0,0,56,3,59,32,2,34,1,0,1,89,5,94
WEST BENGAL,2003,EXTORTION,0,0,0,0,0,0,2,0,2,0,0,0,2,0,2
WEST BENGAL,2003,RIOTS,0,0,0,0,0,0,0,0,0,0,0,0,0,0,0
WEST BENGAL,2003,ARSON,0,0,0,0,0,0,0,0,0,0,0,0,0,0,0
WEST BENGAL,2003,CRIMINAL BREACH OF TRUST,0,0,0,0,0,0,2,0,2,0,0,0,2,0,2
WEST BENGAL,2003,CHEATING,0,0,0,2,0,2,8,0,8,0,0,0,10,0,10
WEST BENGAL,2003,COUNTER FEITING,0,0,0,0,0,0,2,0,2,1,0,1,3,0,3
WEST BENGAL,2003,DOWRY DEATHS,0,0,0,10,3,13,35,15,50,11,3,14,56,21,77
WEST BENGAL,2003,MOLESTATION,0,0,0,0,0,0,0,0,0,0,0,0,0,0,0
WEST BENGAL,2003,EVE-TEASING,0,0,0,0,0,0,0,0,0,0,0,0,0,0,0
WEST BENGAL,2003,CRUELTY BY HUSBAND OR RELATIVE OF HUSBAND,0,0,0,56,3,59,76,6,82,18,4,22,150,13,163
WEST BENGAL,2003,OTHER IPC CRIMES,0,0,0,31,0,31,14,0,14,3,0,3,48,0,48
WEST BENGAL,2003,TOTAL IPC,0,0,0,910,22,932,1365,61,1426,236,22,258,2511,105,2616
WEST BENGAL,2004,MURDER,0,0,0,404,8,412,885,39,924,152,17,169,1441,64,1505
WEST BENGAL,2004,ATTEMPT TO COMMIT MURDER,0,0,0,87,0,87,97,0,97,22,0,22,206,0,206
WEST BENGAL,2004,C.H. NOT AMOUNTING TO MURDER,0,0,0,54,2,56,65,2,67,11,0,11,130,4,134
WEST BENGAL,2004,RAPE,0,0,0,158,0,158,58,0,58,5,0,5,221,0,221
WEST BENGAL,2004,KIDNAPPING AND ABDUCTION,0,0,0,30,2,32,26,3,29,3,0,3,59,5,64
WEST BENGAL,2004,DACOITY,0,0,0,101,2,103,93,2,95,11,0,11,205,4,209
WEST BENGAL,2004,PREP. AND ASSEMBLY FOR DACOITY,0,0,0,3,0,3,5,0,5,0,0,0,8,0,8
WEST BENGAL,2004,ROBBERY,0,0,0,32,0,32,16,1,17,2,0,2,50,1,51
WEST BENGAL,2004,BURGLARY,0,0,0,11,0,11,3,0,3,0,0,0,14,0,14
WEST BENGAL,2004,THEFTS,0,0,0,44,2,46,23,1,24,3,0,3,70,3,73
WEST BENGAL,2004,EXTORTION,0,0,0,1,0,1,2,0,2,0,0,0,3,0,3
WEST BENGAL,2004,RIOTS,0,0,0,9,0,9,0,0,0,0,0,0,9,0,9
WEST BENGAL,2004,ARSON,0,0,0,0,0,0,0,0,0,0,0,0,0,0,0
WEST BENGAL,2004,CRIMINAL BREACH OF TRUST,0,0,0,0,0,0,0,0,0,2,0,2,2,0,2
WEST BENGAL,2004,CHEATING,0,0,0,3,0,3,13,0,13,2,0,2,18,0,18
WEST BENGAL,2004,COUNTER FEITING,0,0,0,0,0,0,0,0,0,0,0,0,0,0,0
WEST BENGAL,2004,DOWRY DEATHS,0,0,0,50,2,52,37,10,47,10,10,20,97,22,119
WEST BENGAL,2004,MOLESTATION,0,0,0,0,0,0,0,0,0,0,0,0,0,0,0
WEST BENGAL,2004,EVE-TEASING,0,0,0,0,0,0,0,0,0,0,0,0,0,0,0
WEST BENGAL,2004,CRUELTY BY HUSBAND OR RELATIVE OF HUSBAND,0,0,0,77,4,81,55,6,61,20,6,26,152,16,168
WEST BENGAL,2004,OTHER IPC CRIMES,0,0,0,25,0,25,32,1,33,0,0,0,57,1,58
WEST BENGAL,2004,TOTAL IPC,0,0,0,1089,22,1111,1410,65,1475,243,33,276,2742,120,2862
WEST BENGAL,2005,MURDER,0,0,0,503,18,521,913,4,917,211,16,227,1627,38,1665
WEST BENGAL,2005,ATTEMPT TO COMMIT MURDER,0,0,0,90,0,90,98,0,98,34,0,34,222,0,222
WEST BENGAL,2005,C.H. NOT AMOUNTING TO MURDER,0,0,0,54,2,56,68,0,68,31,0,31,153,2,155
WEST BENGAL,2005,RAPE,0,0,0,80,0,80,30,0,30,2,0,2,112,0,112
WEST BENGAL,2005,KIDNAPPING AND ABDUCTION,0,0,0,44,6,50,45,4,49,4,0,4,93,10,103
WEST BENGAL,2005,DACOITY,0,0,0,40,0,40,47,0,47,19,0,19,106,0,106
WEST BENGAL,2005,PREP. AND ASSEMBLY FOR DACOITY,0,0,0,10,0,10,12,0,12,0,0,0,22,0,22
WEST BENGAL,2005,ROBBERY,0,0,0,28,0,28,23,0,23,0,0,0,51,0,51
WEST BENGAL,2005,BURGLARY,0,0,0,4,0,4,0,0,0,2,0,2,6,0,6
WEST BENGAL,2005,THEFTS,3,0,3,66,4,70,30,10,40,10,0,10,109,14,123
WEST BENGAL,2005,EXTORTION,0,0,0,4,0,4,9,0,9,0,0,0,13,0,13
WEST BENGAL,2005,RIOTS,0,0,0,12,0,12,0,0,0,0,0,0,12,0,12
WEST BENGAL,2005,ARSON,0,0,0,0,0,0,0,0,0,0,0,0,0,0,0
WEST BENGAL,2005,CRIMINAL BREACH OF TRUST,0,0,0,0,0,0,0,0,0,0,0,0,0,0,0
WEST BENGAL,2005,CHEATING,4,0,4,36,0,36,45,0,45,0,0,0,85,0,85
WEST BENGAL,2005,COUNTER FEITING,0,0,0,0,0,0,0,0,0,0,0,0,0,0,0
WEST BENGAL,2005,DOWRY DEATHS,0,0,0,42,14,56,25,1,26,12,0,12,79,15,94
WEST BENGAL,2005,MOLESTATION,0,0,0,0,0,0,0,0,0,0,0,0,0,0,0
WEST BENGAL,2005,EVE-TEASING,0,0,0,0,0,0,0,0,0,0,0,0,0,0,0
WEST BENGAL,2005,CRUELTY BY HUSBAND OR RELATIVE OF HUSBAND,0,0,0,62,23,85,75,14,89,31,4,35,168,41,209
WEST BENGAL,2005,OTHER IPC CRIMES,0,0,0,0,0,0,0,0,0,0,0,0,0,0,0
WEST BENGAL,2005,TOTAL IPC,7,0,7,1075,67,1142,1420,33,1453,356,20,376,2858,120,2978
WEST BENGAL,2006,MURDER,0,0,0,374,19,393,1034,28,1062,235,19,254,1643,66,1709
WEST BENGAL,2006,ATTEMPT TO COMMIT MURDER,0,0,0,68,2,70,131,7,138,41,4,45,240,13,253
WEST BENGAL,2006,C.H. NOT AMOUNTING TO MURDER,0,0,0,67,4,71,45,6,51,26,6,32,138,16,154
WEST BENGAL,2006,RAPE,0,0,0,103,0,103,91,0,91,19,0,19,213,0,213
WEST BENGAL,2006,KIDNAPPING AND ABDUCTION,0,0,0,34,5,39,31,6,37,6,4,10,71,15,86
WEST BENGAL,2006,DACOITY,0,0,0,55,1,56,81,2,83,11,0,11,147,3,150
WEST BENGAL,2006,PREP. AND ASSEMBLY FOR DACOITY,0,0,0,13,0,13,39,0,39,3,0,3,55,0,55
WEST BENGAL,2006,ROBBERY,0,0,0,17,0,17,16,0,16,0,0,0,33,0,33
WEST BENGAL,2006,BURGLARY,0,0,0,0,0,0,1,0,1,0,0,0,1,0,1
WEST BENGAL,2006,THEFTS,0,0,0,45,1,46,19,1,20,6,0,6,70,2,72
WEST BENGAL,2006,EXTORTION,0,0,0,13,0,13,8,0,8,2,0,2,23,0,23
WEST BENGAL,2006,RIOTS,0,0,0,0,0,0,0,0,0,0,0,0,0,0,0
WEST BENGAL,2006,ARSON,0,0,0,0,0,0,0,0,0,0,0,0,0,0,0
WEST BENGAL,2006,CRIMINAL BREACH OF TRUST,0,0,0,0,0,0,0,0,0,2,0,2,2,0,2
WEST BENGAL,2006,CHEATING,0,0,0,4,0,4,16,0,16,3,1,4,23,1,24
WEST BENGAL,2006,COUNTER FEITING,0,0,0,1,0,1,3,0,3,0,0,0,4,0,4
WEST BENGAL,2006,DOWRY DEATHS,0,0,0,35,4,39,90,10,100,22,4,26,147,18,165
WEST BENGAL,2006,MOLESTATION,0,0,0,0,0,0,1,0,1,0,0,0,1,0,1
WEST BENGAL,2006,EVE-TEASING,0,0,0,0,0,0,0,0,0,0,0,0,0,0,0
WEST BENGAL,2006,CRUELTY BY HUSBAND OR RELATIVE OF HUSBAND,0,0,0,28,4,32,145,13,158,25,5,30,198,22,220
WEST BENGAL,2006,OTHER IPC CRIMES,0,0,0,7,0,7,20,0,20,0,0,0,27,0,27
WEST BENGAL,2006,TOTAL IPC,0,0,0,864,40,904,1771,73,1844,401,43,444,3036,156,3192
WEST BENGAL,2007,MURDER,0,0,0,310,18,328,1185,53,1238,358,19,377,1853,90,1943
WEST BENGAL,2007,ATTEMPT TO COMMIT MURDER,0,0,0,116,3,119,104,7,111,68,7,75,288,17,305
WEST BENGAL,2007,C.H. NOT AMOUNTING TO MURDER,0,0,0,57,2,59,71,5,76,31,0,31,159,7,166
WEST BENGAL,2007,RAPE,0,0,0,120,0,120,102,0,102,22,0,22,244,0,244
WEST BENGAL,2007,KIDNAPPING AND ABDUCTION,0,0,0,27,2,29,32,2,34,8,0,8,67,4,71
WEST BENGAL,2007,DACOITY,0,0,0,69,0,69,81,0,81,11,0,11,161,0,161
WEST BENGAL,2007,PREP. AND ASSEMBLY FOR DACOITY,0,0,0,13,0,13,25,0,25,3,0,3,41,0,41
WEST BENGAL,2007,ROBBERY,0,0,0,31,0,31,26,0,26,2,0,2,59,0,59
WEST BENGAL,2007,BURGLARY,0,0,0,0,0,0,0,0,0,0,0,0,0,0,0
WEST BENGAL,2007,THEFTS,0,0,0,62,0,62,17,0,17,10,0,10,89,0,89
WEST BENGAL,2007,EXTORTION,0,0,0,13,0,13,11,0,11,3,0,3,27,0,27
WEST BENGAL,2007,RIOTS,0,0,0,0,0,0,0,0,0,0,0,0,0,0,0
WEST BENGAL,2007,ARSON,0,0,0,1,0,1,10,0,10,0,0,0,11,0,11
WEST BENGAL,2007,CRIMINAL BREACH OF TRUST,0,0,0,13,0,13,5,0,5,0,0,0,18,0,18
WEST BENGAL,2007,CHEATING,0,0,0,5,0,5,15,0,15,2,0,2,22,0,22
WEST BENGAL,2007,COUNTER FEITING,0,0,0,2,0,2,2,0,2,0,0,0,4,0,4
WEST BENGAL,2007,DOWRY DEATHS,1,1,2,25,12,37,47,4,51,35,4,39,108,21,129
WEST BENGAL,2007,MOLESTATION,0,0,0,0,0,0,0,0,0,0,0,0,0,0,0
WEST BENGAL,2007,EVE-TEASING,0,0,0,0,0,0,0,0,0,0,0,0,0,0,0
WEST BENGAL,2007,CRUELTY BY HUSBAND OR RELATIVE OF HUSBAND,1,1,2,36,6,42,55,12,67,24,5,29,116,24,140
WEST BENGAL,2007,OTHER IPC CRIMES,0,0,0,18,0,18,19,0,19,2,1,3,39,1,40
WEST BENGAL,2007,TOTAL IPC,2,2,4,918,43,961,1807,83,1890,579,36,615,3306,164,3470
WEST BENGAL,2008,MURDER,0,0,0,345,6,351,1514,42,1556,440,29,469,2299,77,2376
WEST BENGAL,2008,ATTEMPT TO COMMIT MURDER,0,0,0,84,1,85,154,8,162,51,1,52,289,10,299
WEST BENGAL,2008,C.H. NOT AMOUNTING TO MURDER,0,0,0,48,1,49,88,1,89,27,1,28,163,3,166
WEST BENGAL,2008,RAPE,0,0,0,137,0,137,134,2,136,36,0,36,307,2,309
WEST BENGAL,2008,KIDNAPPING AND ABDUCTION,0,0,0,46,9,55,38,16,54,9,1,10,93,26,119
WEST BENGAL,2008,DACOITY,0,0,0,76,2,78,134,0,134,12,0,12,222,2,224
WEST BENGAL,2008,PREP. AND ASSEMBLY FOR DACOITY,0,0,0,15,0,15,24,0,24,0,0,0,39,0,39
WEST BENGAL,2008,ROBBERY,0,0,0,35,3,38,63,0,63,9,0,9,107,3,110
WEST BENGAL,2008,BURGLARY,0,0,0,0,0,0,0,0,0,0,0,0,0,0,0
WEST BENGAL,2008,THEFTS,0,0,0,65,7,72,43,0,43,18,0,18,126,7,133
WEST BENGAL,2008,EXTORTION,0,0,0,8,0,8,6,0,6,0,0,0,14,0,14
WEST BENGAL,2008,RIOTS,0,0,0,0,0,0,0,0,0,0,0,0,0,0,0
WEST BENGAL,2008,ARSON,0,0,0,0,0,0,0,0,0,0,0,0,0,0,0
WEST BENGAL,2008,CRIMINAL BREACH OF TRUST,0,0,0,2,0,2,4,0,4,0,0,0,6,0,6
WEST BENGAL,2008,CHEATING,0,0,0,11,0,11,18,0,18,1,0,1,30,0,30
WEST BENGAL,2008,COUNTER FEITING,0,0,0,2,0,2,5,1,6,1,1,2,8,2,10
WEST BENGAL,2008,DOWRY DEATHS,0,0,0,32,6,38,54,14,68,15,12,27,101,32,133
WEST BENGAL,2008,MOLESTATION,0,0,0,0,0,0,0,0,0,0,0,0,0,0,0
WEST BENGAL,2008,EVE-TEASING,0,0,0,0,0,0,0,0,0,0,0,0,0,0,0
WEST BENGAL,2008,CRUELTY BY HUSBAND OR RELATIVE OF HUSBAND,0,0,0,120,12,132,166,16,182,71,11,82,357,39,396
WEST BENGAL,2008,OTHER IPC CRIMES,0,0,0,79,0,79,74,0,74,23,0,23,176,0,176
WEST BENGAL,2008,TOTAL IPC,0,0,0,1105,47,1152,2519,100,2619,713,56,769,4337,203,4540
WEST BENGAL,2009,MURDER,0,0,0,428,21,449,1449,51,1500,482,35,517,2359,107,2466
WEST BENGAL,2009,ATTEMPT TO COMMIT MURDER,0,0,0,54,6,60,129,10,139,63,4,67,246,20,266
WEST BENGAL,2009,C.H. NOT AMOUNTING TO MURDER,0,0,0,72,3,75,75,5,80,27,1,28,174,9,183
WEST BENGAL,2009,RAPE,0,0,0,131,0,131,163,0,163,63,0,63,357,0,357
WEST BENGAL,2009,KIDNAPPING AND ABDUCTION,0,0,0,64,12,76,42,14,56,7,1,8,113,27,140
WEST BENGAL,2009,DACOITY,0,0,0,53,2,55,85,1,86,13,0,13,151,3,154
WEST BENGAL,2009,PREP. AND ASSEMBLY FOR DACOITY,0,0,0,13,0,13,24,0,24,7,0,7,44,0,44
WEST BENGAL,2009,ROBBERY,0,0,0,39,0,39,30,0,30,10,0,10,79,0,79
WEST BENGAL,2009,BURGLARY,0,0,0,0,0,0,0,0,0,0,0,0,0,0,0
WEST BENGAL,2009,THEFTS,0,0,0,33,0,33,21,0,21,7,0,7,61,0,61
WEST BENGAL,2009,EXTORTION,0,0,0,8,5,13,3,2,5,0,0,0,11,7,18
WEST BENGAL,2009,RIOTS,0,0,0,2,0,2,8,0,8,0,0,0,10,0,10
WEST BENGAL,2009,ARSON,0,0,0,0,0,0,0,0,0,0,0,0,0,0,0
WEST BENGAL,2009,CRIMINAL BREACH OF TRUST,0,0,0,0,0,0,2,0,2,1,0,1,3,0,3
WEST BENGAL,2009,CHEATING,0,0,0,3,0,3,11,0,11,2,0,2,16,0,16
WEST BENGAL,2009,COUNTER FEITING,0,0,0,0,0,0,4,1,5,1,1,2,5,2,7
WEST BENGAL,2009,DOWRY DEATHS,0,0,0,45,6,51,36,9,45,16,4,20,97,19,116
WEST BENGAL,2009,MOLESTATION,0,0,0,0,0,0,0,0,0,0,0,0,0,0,0
WEST BENGAL,2009,EVE-TEASING,0,0,0,0,0,0,0,0,0,0,0,0,0,0,0
WEST BENGAL,2009,CRUELTY BY HUSBAND OR RELATIVE OF HUSBAND,0,0,0,110,9,119,129,11,140,61,16,77,300,36,336
WEST BENGAL,2009,OTHER IPC CRIMES,0,0,0,23,0,23,16,1,17,10,0,10,49,1,50
WEST BENGAL,2009,TOTAL IPC,0,0,0,1078,64,1142,2227,105,2332,770,62,832,4075,231,4306
WEST BENGAL,2010,MURDER,0,0,0,404,12,416,1676,61,1737,582,36,618,2662,109,2771
WEST BENGAL,2010,ATTEMPT TO COMMIT MURDER,0,0,0,39,2,41,78,6,84,38,2,40,155,10,165
WEST BENGAL,2010,C.H. NOT AMOUNTING TO MURDER,0,0,0,50,1,51,66,15,81,20,1,21,136,17,153
WEST BENGAL,2010,RAPE,0,0,0,162,0,162,81,0,81,18,0,18,261,0,261
WEST BENGAL,2010,KIDNAPPING AND ABDUCTION,0,0,0,74,4,78,48,8,56,13,2,15,135,14,149
WEST BENGAL,2010,DACOITY,0,0,0,53,2,55,99,10,109,14,3,17,166,15,181
WEST BENGAL,2010,PREP. AND ASSEMBLY FOR DACOITY,0,0,0,15,0,15,12,0,12,4,0,4,31,0,31
WEST BENGAL,2010,ROBBERY,0,0,0,32,0,32,52,0,52,5,0,5,89,0,89
WEST BENGAL,2010,BURGLARY,0,0,0,2,0,2,3,0,3,0,0,0,5,0,5
WEST BENGAL,2010,THEFTS,0,0,0,41,2,43,36,1,37,5,2,7,82,5,87
WEST BENGAL,2010,EXTORTION,0,0,0,7,0,7,3,0,3,0,0,0,10,0,10
WEST BENGAL,2010,RIOTS,0,0,0,3,0,3,5,0,5,0,0,0,8,0,8
WEST BENGAL,2010,ARSON,0,0,0,2,0,2,4,0,4,1,0,1,7,0,7
WEST BENGAL,2010,CRIMINAL BREACH OF TRUST,0,0,0,0,0,0,7,0,7,3,0,3,10,0,10
WEST BENGAL,2010,CHEATING,0,0,0,3,1,4,13,2,15,1,0,1,17,3,20
WEST BENGAL,2010,COUNTER FEITING,0,0,0,0,0,0,0,0,0,1,0,1,1,0,1
WEST BENGAL,2010,DOWRY DEATHS,0,0,0,34,5,39,43,14,57,18,23,41,95,42,137
WEST BENGAL,2010,MOLESTATION,0,0,0,0,0,0,0,0,0,0,0,0,0,0,0
WEST BENGAL,2010,EVE-TEASING,0,0,0,4,0,4,0,0,0,0,0,0,4,0,4
WEST BENGAL,2010,CRUELTY BY HUSBAND OR RELATIVE OF HUSBAND,0,0,0,81,8,89,122,12,134,74,8,82,277,28,305
WEST BENGAL,2010,OTHER IPC CRIMES,0,0,0,12,0,12,9,0,9,0,0,0,21,0,21
WEST BENGAL,2010,TOTAL IPC,0,0,0,1018,37,1055,2357,129,2486,797,77,874,4172,243,4415
WEST BENGAL,2011,MURDER,0,0,0,678,21,699,1217,61,1278,543,43,586,2438,125,2563
WEST BENGAL,2011,ATTEMPT TO COMMIT MURDER,0,0,0,52,4,56,67,5,72,50,2,52,169,11,180
WEST BENGAL,2011,C.H. NOT AMOUNTING TO MURDER,0,0,0,68,1,69,101,19,120,62,1,63,231,21,252
WEST BENGAL,2011,RAPE,0,0,0,117,0,117,132,0,132,33,0,33,282,0,282
WEST BENGAL,2011,KIDNAPPING AND ABDUCTION,0,0,0,63,4,67,35,7,42,23,1,24,121,12,133
WEST BENGAL,2011,DACOITY,0,0,0,73,0,73,78,7,85,38,3,41,189,10,199
WEST BENGAL,2011,PREP. AND ASSEMBLY FOR DACOITY,0,0,0,6,0,6,17,0,17,12,0,12,35,0,35
WEST BENGAL,2011,ROBBERY,0,0,0,36,0,36,34,0,34,15,0,15,85,0,85
WEST BENGAL,2011,BURGLARY,0,0,0,3,0,3,9,0,9,7,0,7,19,0,19
WEST BENGAL,2011,THEFTS,0,0,0,38,2,40,27,1,28,13,1,14,78,4,82
WEST BENGAL,2011,EXTORTION,0,0,0,0,0,0,1,0,1,0,0,0,1,0,1
WEST BENGAL,2011,RIOTS,0,0,0,13,0,13,66,0,66,0,0,0,79,0,79
WEST BENGAL,2011,ARSON,0,0,0,0,0,0,2,0,2,1,0,1,3,0,3
WEST BENGAL,2011,CRIMINAL BREACH OF TRUST,0,0,0,5,0,5,6,0,6,2,0,2,13,0,13
WEST BENGAL,2011,CHEATING,0,0,0,12,0,12,21,3,24,16,0,16,49,3,52
WEST BENGAL,2011,COUNTER FEITING,0,0,0,2,0,2,3,0,3,1,0,1,6,0,6
WEST BENGAL,2011,DOWRY DEATHS,0,0,0,48,5,53,57,26,83,41,31,72,146,62,208
WEST BENGAL,2011,MOLESTATION,0,0,0,1,0,1,5,0,5,2,0,2,8,0,8
WEST BENGAL,2011,EVE-TEASING,0,0,0,0,0,0,0,0,0,0,0,0,0,0,0
WEST BENGAL,2011,CRUELTY BY HUSBAND OR RELATIVE OF HUSBAND,0,0,0,29,3,32,73,9,82,15,3,18,117,15,132
WEST BENGAL,2011,OTHER IPC CRIMES,0,0,0,14,6,20,20,2,22,5,0,5,39,8,47
WEST BENGAL,2011,TOTAL IPC,0,0,0,1258,46,1304,1971,140,2111,879,85,964,4108,271,4379
WEST BENGAL,2012,MURDER,0,0,0,693,38,731,1372,47,1419,465,44,509,2530,129,2659
WEST BENGAL,2012,ATTEMPT TO COMMIT MURDER,0,0,0,84,5,89,131,5,136,58,1,59,273,11,284
WEST BENGAL,2012,C.H. NOT AMOUNTING TO MURDER,0,0,0,71,6,77,99,7,106,45,7,52,215,20,235
WEST BENGAL,2012,RAPE,0,0,0,181,1,182,127,0,127,26,1,27,334,2,336
WEST BENGAL,2012,KIDNAPPING AND ABDUCTION,0,0,0,53,11,64,69,13,82,22,5,27,144,29,173
WEST BENGAL,2012,DACOITY,0,0,0,71,1,72,101,0,101,14,0,14,186,1,187
WEST BENGAL,2012,PREP. AND ASSEMBLY FOR DACOITY,0,0,0,11,0,11,14,0,14,1,0,1,26,0,26
WEST BENGAL,2012,ROBBERY,0,0,0,33,0,33,27,0,27,7,1,8,67,1,68
WEST BENGAL,2012,BURGLARY,0,0,0,10,0,10,8,0,8,3,1,4,21,1,22
WEST BENGAL,2012,THEFTS,0,0,0,38,1,39,33,0,33,4,1,5,75,2,77
WEST BENGAL,2012,EXTORTION,0,0,0,1,0,1,1,0,1,2,0,2,4,0,4
WEST BENGAL,2012,RIOTS,0,0,0,21,0,21,3,0,3,1,0,1,25,0,25
WEST BENGAL,2012,ARSON,0,0,0,5,0,5,8,0,8,3,0,3,16,0,16
WEST BENGAL,2012,CRIMINAL BREACH OF TRUST,0,0,0,2,0,2,6,0,6,2,0,2,10,0,10
WEST BENGAL,2012,CHEATING,0,0,0,8,2,10,8,2,10,5,0,5,21,4,25
WEST BENGAL,2012,COUNTER FEITING,0,0,0,57,1,58,47,0,47,1,0,1,105,1,106
WEST BENGAL,2012,DOWRY DEATHS,0,0,0,27,7,34,34,21,55,30,29,59,91,57,148
WEST BENGAL,2012,MOLESTATION,0,0,0,0,0,0,0,0,0,0,0,0,0,0,0
WEST BENGAL,2012,EVE-TEASING,0,0,0,0,0,0,0,0,0,0,0,0,0,0,0
WEST BENGAL,2012,CRUELTY BY HUSBAND OR RELATIVE OF HUSBAND,0,0,0,27,13,40,25,12,37,7,17,24,59,42,101
WEST BENGAL,2012,OTHER IPC CRIMES,0,0,0,66,2,68,64,1,65,4,0,4,134,3,137
WEST BENGAL,2012,TOTAL IPC,0,0,0,1459,88,1547,2177,108,2285,700,107,807,4336,303,4639
A & N ISLANDS,2001,MURDER,0,0,0,12,0,12,19,2,21,3,0,3,34,2,36
A & N ISLANDS,2001,ATTEMPT TO COMMIT MURDER,0,0,0,1,0,1,3,1,4,0,0,0,4,1,5
A & N ISLANDS,2001,C.H. NOT AMOUNTING TO MURDER,0,0,0,1,0,1,1,0,1,0,0,0,2,0,2
A & N ISLANDS,2001,RAPE,0,0,0,0,0,0,0,0,0,0,0,0,0,0,0
A & N ISLANDS,2001,KIDNAPPING AND ABDUCTION,0,0,0,1,0,1,2,0,2,0,0,0,3,0,3
A & N ISLANDS,2001,DACOITY,0,0,0,0,0,0,0,0,0,0,0,0,0,0,0
A & N ISLANDS,2001,PREP. AND ASSEMBLY FOR DACOITY,0,0,0,0,0,0,0,0,0,0,0,0,0,0,0
A & N ISLANDS,2001,ROBBERY,0,0,0,0,0,0,0,0,0,0,0,0,0,0,0
A & N ISLANDS,2001,BURGLARY,0,0,0,0,0,0,0,0,0,0,0,0,0,0,0
A & N ISLANDS,2001,THEFTS,0,0,0,0,0,0,0,0,0,0,0,0,0,0,0
A & N ISLANDS,2001,EXTORTION,0,0,0,0,0,0,0,0,0,0,0,0,0,0,0
A & N ISLANDS,2001,RIOTS,0,0,0,1,0,1,6,0,6,0,0,0,7,0,7
A & N ISLANDS,2001,ARSON,0,0,0,0,0,0,0,0,0,0,0,0,0,0,0
A & N ISLANDS,2001,CRIMINAL BREACH OF TRUST,0,0,0,0,0,0,0,0,0,0,0,0,0,0,0
A & N ISLANDS,2001,CHEATING,0,0,0,0,0,0,0,0,0,0,0,0,0,0,0
A & N ISLANDS,2001,COUNTER FEITING,0,0,0,0,0,0,0,0,0,0,0,0,0,0,0
A & N ISLANDS,2001,DOWRY DEATHS,0,0,0,0,0,0,0,0,0,0,0,0,0,0,0
A & N ISLANDS,2001,MOLESTATION,0,0,0,0,0,0,0,0,0,0,0,0,0,0,0
A & N ISLANDS,2001,EVE-TEASING,0,0,0,0,0,0,0,0,0,0,0,0,0,0,0
A & N ISLANDS,2001,CRUELTY BY HUSBAND OR RELATIVE OF HUSBAND,0,0,0,0,0,0,0,0,0,0,0,0,0,0,0
A & N ISLANDS,2001,OTHER IPC CRIMES,0,0,0,2,0,2,7,0,7,2,0,2,11,0,11
A & N ISLANDS,2001,TOTAL IPC,0,0,0,18,0,18,38,3,41,5,0,5,61,3,64
A & N ISLANDS,2002,MURDER,0,0,0,12,0,12,17,2,19,3,0,3,32,2,34
A & N ISLANDS,2002,ATTEMPT TO COMMIT MURDER,0,0,0,1,0,1,3,1,4,0,0,0,4,1,5
A & N ISLANDS,2002,C.H. NOT AMOUNTING TO MURDER,0,0,0,1,0,1,1,0,1,0,0,0,2,0,2
A & N ISLANDS,2002,RAPE,0,0,0,1,0,1,2,0,2,0,0,0,3,0,3
A & N ISLANDS,2002,KIDNAPPING AND ABDUCTION,0,0,0,0,0,0,0,0,0,0,0,0,0,0,0
A & N ISLANDS,2002,DACOITY,0,0,0,0,0,0,0,0,0,0,0,0,0,0,0
A & N ISLANDS,2002,PREP. AND ASSEMBLY FOR DACOITY,0,0,0,0,0,0,0,0,0,0,0,0,0,0,0
A & N ISLANDS,2002,ROBBERY,0,0,0,0,0,0,0,0,0,0,0,0,0,0,0
A & N ISLANDS,2002,BURGLARY,0,0,0,0,0,0,0,0,0,0,0,0,0,0,0
A & N ISLANDS,2002,THEFTS,0,0,0,0,0,0,0,0,0,0,0,0,0,0,0
A & N ISLANDS,2002,EXTORTION,0,0,0,0,0,0,0,0,0,0,0,0,0,0,0
A & N ISLANDS,2002,RIOTS,0,0,0,4,0,4,4,0,4,0,0,0,8,0,8
A & N ISLANDS,2002,ARSON,0,0,0,0,0,0,0,0,0,0,0,0,0,0,0
A & N ISLANDS,2002,CRIMINAL BREACH OF TRUST,0,0,0,0,0,0,0,0,0,0,0,0,0,0,0
A & N ISLANDS,2002,CHEATING,0,0,0,0,0,0,0,0,0,0,0,0,0,0,0
A & N ISLANDS,2002,COUNTER FEITING,0,0,0,0,0,0,0,0,0,0,0,0,0,0,0
A & N ISLANDS,2002,DOWRY DEATHS,0,0,0,0,0,0,0,0,0,0,0,0,0,0,0
A & N ISLANDS,2002,MOLESTATION,0,0,0,0,0,0,0,0,0,0,0,0,0,0,0
A & N ISLANDS,2002,EVE-TEASING,0,0,0,0,0,0,0,0,0,0,0,0,0,0,0
A & N ISLANDS,2002,CRUELTY BY HUSBAND OR RELATIVE OF HUSBAND,0,0,0,0,0,0,0,0,0,0,0,0,0,0,0
A & N ISLANDS,2002,OTHER IPC CRIMES,0,0,0,5,0,5,9,0,9,2,1,3,16,1,17
A & N ISLANDS,2002,TOTAL IPC,0,0,0,24,0,24,36,3,39,5,1,6,65,4,69
A & N ISLANDS,2003,MURDER,0,0,0,13,2,15,16,0,16,1,0,1,30,2,32
A & N ISLANDS,2003,ATTEMPT TO COMMIT MURDER,0,0,0,1,0,1,2,0,2,0,0,0,3,0,3
A & N ISLANDS,2003,C.H. NOT AMOUNTING TO MURDER,0,0,0,5,0,5,2,0,2,0,0,0,7,0,7
A & N ISLANDS,2003,RAPE,0,0,0,0,0,0,3,0,3,0,0,0,3,0,3
A & N ISLANDS,2003,KIDNAPPING AND ABDUCTION,0,0,0,0,0,0,0,0,0,0,0,0,0,0,0
A & N ISLANDS,2003,DACOITY,0,0,0,0,0,0,0,0,0,0,0,0,0,0,0
A & N ISLANDS,2003,PREP. AND ASSEMBLY FOR DACOITY,0,0,0,0,0,0,0,0,0,0,0,0,0,0,0
A & N ISLANDS,2003,ROBBERY,0,0,0,0,0,0,0,0,0,0,0,0,0,0,0
A & N ISLANDS,2003,BURGLARY,0,0,0,0,0,0,0,0,0,0,0,0,0,0,0
A & N ISLANDS,2003,THEFTS,0,0,0,6,0,6,0,0,0,0,0,0,6,0,6
A & N ISLANDS,2003,EXTORTION,0,0,0,0,0,0,0,0,0,0,0,0,0,0,0
A & N ISLANDS,2003,RIOTS,0,0,0,0,0,0,0,0,0,0,0,0,0,0,0
A & N ISLANDS,2003,ARSON,0,0,0,0,0,0,0,0,0,0,0,0,0,0,0
A & N ISLANDS,2003,CRIMINAL BREACH OF TRUST,0,0,0,0,0,0,0,0,0,0,0,0,0,0,0
A & N ISLANDS,2003,CHEATING,0,0,0,0,0,0,0,0,0,0,0,0,0,0,0
A & N ISLANDS,2003,COUNTER FEITING,0,0,0,0,0,0,0,0,0,0,0,0,0,0,0
A & N ISLANDS,2003,DOWRY DEATHS,0,0,0,0,0,0,0,0,0,0,0,0,0,0,0
A & N ISLANDS,2003,MOLESTATION,0,0,0,0,0,0,0,0,0,0,0,0,0,0,0
A & N ISLANDS,2003,EVE-TEASING,0,0,0,0,0,0,0,0,0,0,0,0,0,0,0
A & N ISLANDS,2003,CRUELTY BY HUSBAND OR RELATIVE OF HUSBAND,0,0,0,0,0,0,0,0,0,0,0,0,0,0,0
A & N ISLANDS,2003,OTHER IPC CRIMES,0,0,0,12,0,12,6,0,6,1,0,1,19,0,19
A & N ISLANDS,2003,TOTAL IPC,0,0,0,37,2,39,29,0,29,2,0,2,68,2,70
A & N ISLANDS,2004,MURDER,0,0,0,13,2,15,17,0,17,0,0,0,30,2,32
A & N ISLANDS,2004,ATTEMPT TO COMMIT MURDER,0,0,0,3,0,3,1,0,1,0,0,0,4,0,4
A & N ISLANDS,2004,C.H. NOT AMOUNTING TO MURDER,0,0,0,0,0,0,1,0,1,0,0,0,1,0,1
A & N ISLANDS,2004,RAPE,0,0,0,2,0,2,2,0,2,0,0,0,4,0,4
A & N ISLANDS,2004,KIDNAPPING AND ABDUCTION,0,0,0,0,0,0,0,0,0,0,0,0,0,0,0
A & N ISLANDS,2004,DACOITY,0,0,0,0,0,0,0,0,0,0,0,0,0,0,0
A & N ISLANDS,2004,PREP. AND ASSEMBLY FOR DACOITY,0,0,0,0,0,0,0,0,0,0,0,0,0,0,0
A & N ISLANDS,2004,ROBBERY,0,0,0,0,0,0,0,0,0,0,0,0,0,0,0
A & N ISLANDS,2004,BURGLARY,0,0,0,0,0,0,0,0,0,0,0,0,0,0,0
A & N ISLANDS,2004,THEFTS,0,0,0,5,0,5,0,0,0,0,0,0,5,0,5
A & N ISLANDS,2004,EXTORTION,0,0,0,0,0,0,0,0,0,0,0,0,0,0,0
A & N ISLANDS,2004,RIOTS,0,0,0,0,0,0,0,0,0,0,0,0,0,0,0
A & N ISLANDS,2004,ARSON,0,0,0,0,0,0,0,0,0,0,0,0,0,0,0
A & N ISLANDS,2004,CRIMINAL BREACH OF TRUST,0,0,0,0,0,0,0,0,0,0,0,0,0,0,0
A & N ISLANDS,2004,CHEATING,0,0,0,0,0,0,1,0,1,0,0,0,1,0,1
A & N ISLANDS,2004,COUNTER FEITING,0,0,0,0,0,0,0,0,0,0,0,0,0,0,0
A & N ISLANDS,2004,DOWRY DEATHS,0,0,0,0,0,0,0,0,0,0,0,0,0,0,0
A & N ISLANDS,2004,MOLESTATION,0,0,0,0,0,0,0,0,0,0,0,0,0,0,0
A & N ISLANDS,2004,EVE-TEASING,0,0,0,0,0,0,0,0,0,0,0,0,0,0,0
A & N ISLANDS,2004,CRUELTY BY HUSBAND OR RELATIVE OF HUSBAND,0,0,0,0,0,0,0,0,0,0,0,0,0,0,0
A & N ISLANDS,2004,OTHER IPC CRIMES,0,0,0,5,0,5,4,0,4,0,0,0,9,0,9
A & N ISLANDS,2004,TOTAL IPC,0,0,0,28,2,30,26,0,26,0,0,0,54,2,56
A & N ISLANDS,2005,MURDER,0,0,0,3,0,3,17,1,18,5,0,5,25,1,26
A & N ISLANDS,2005,ATTEMPT TO COMMIT MURDER,0,0,0,1,0,1,3,0,3,1,0,1,5,0,5
A & N ISLANDS,2005,C.H. NOT AMOUNTING TO MURDER,0,0,0,0,0,0,1,0,1,0,0,0,1,0,1
A & N ISLANDS,2005,RAPE,0,0,0,0,0,0,2,0,2,1,0,1,3,0,3
A & N ISLANDS,2005,KIDNAPPING AND ABDUCTION,0,0,0,0,0,0,0,0,0,0,0,0,0,0,0
A & N ISLANDS,2005,DACOITY,0,0,0,0,0,0,0,0,0,0,0,0,0,0,0
A & N ISLANDS,2005,PREP. AND ASSEMBLY FOR DACOITY,0,0,0,0,0,0,0,0,0,0,0,0,0,0,0
A & N ISLANDS,2005,ROBBERY,0,0,0,0,0,0,1,0,1,0,0,0,1,0,1
A & N ISLANDS,2005,BURGLARY,0,0,0,2,0,2,3,0,3,0,0,0,5,0,5
A & N ISLANDS,2005,THEFTS,0,0,0,0,0,0,0,0,0,0,0,0,0,0,0
A & N ISLANDS,2005,EXTORTION,0,0,0,0,0,0,0,0,0,0,0,0,0,0,0
A & N ISLANDS,2005,RIOTS,0,0,0,0,0,0,0,0,0,0,0,0,0,0,0
A & N ISLANDS,2005,ARSON,0,0,0,0,0,0,0,0,0,0,0,0,0,0,0
A & N ISLANDS,2005,CRIMINAL BREACH OF TRUST,0,0,0,0,0,0,0,0,0,0,0,0,0,0,0
A & N ISLANDS,2005,CHEATING,0,0,0,0,0,0,0,0,0,0,0,0,0,0,0
A & N ISLANDS,2005,COUNTER FEITING,0,0,0,0,0,0,0,0,0,0,0,0,0,0,0
A & N ISLANDS,2005,DOWRY DEATHS,0,0,0,0,0,0,0,0,0,0,0,0,0,0,0
A & N ISLANDS,2005,MOLESTATION,0,0,0,0,0,0,0,0,0,0,0,0,0,0,0
A & N ISLANDS,2005,EVE-TEASING,0,0,0,0,0,0,0,0,0,0,0,0,0,0,0
A & N ISLANDS,2005,CRUELTY BY HUSBAND OR RELATIVE OF HUSBAND,0,0,0,0,0,0,0,0,0,0,0,0,0,0,0
A & N ISLANDS,2005,OTHER IPC CRIMES,0,0,0,0,0,0,0,0,0,0,0,0,0,0,0
A & N ISLANDS,2005,TOTAL IPC,0,0,0,6,0,6,27,1,28,7,0,7,40,1,41
A & N ISLANDS,2006,MURDER,0,0,0,3,0,3,19,1,20,3,0,3,25,1,26
A & N ISLANDS,2006,ATTEMPT TO COMMIT MURDER,0,0,0,1,0,1,3,0,3,1,0,1,5,0,5
A & N ISLANDS,2006,C.H. NOT AMOUNTING TO MURDER,0,0,0,0,0,0,0,0,0,0,0,0,0,0,0
A & N ISLANDS,2006,RAPE,0,0,0,0,0,0,3,0,3,1,0,1,4,0,4
A & N ISLANDS,2006,KIDNAPPING AND ABDUCTION,0,0,0,0,0,0,0,0,0,0,0,0,0,0,0
A & N ISLANDS,2006,DACOITY,0,0,0,0,0,0,0,0,0,0,0,0,0,0,0
A & N ISLANDS,2006,PREP. AND ASSEMBLY FOR DACOITY,0,0,0,0,0,0,0,0,0,0,0,0,0,0,0
A & N ISLANDS,2006,ROBBERY,0,0,0,0,0,0,1,0,1,0,0,0,1,0,1
A & N ISLANDS,2006,BURGLARY,0,0,0,2,0,2,2,0,2,0,0,0,4,0,4
A & N ISLANDS,2006,THEFTS,0,0,0,0,0,0,2,0,2,0,0,0,2,0,2
A & N ISLANDS,2006,EXTORTION,0,0,0,0,0,0,0,0,0,0,0,0,0,0,0
A & N ISLANDS,2006,RIOTS,0,0,0,0,0,0,0,0,0,0,0,0,0,0,0
A & N ISLANDS,2006,ARSON,0,0,0,0,0,0,0,0,0,0,0,0,0,0,0
A & N ISLANDS,2006,CRIMINAL BREACH OF TRUST,0,0,0,0,0,0,0,0,0,0,0,0,0,0,0
A & N ISLANDS,2006,CHEATING,0,0,0,0,0,0,0,0,0,0,0,0,0,0,0
A & N ISLANDS,2006,COUNTER FEITING,0,0,0,0,0,0,0,0,0,0,0,0,0,0,0
A & N ISLANDS,2006,DOWRY DEATHS,0,0,0,0,0,0,0,0,0,0,0,0,0,0,0
A & N ISLANDS,2006,MOLESTATION,0,0,0,0,0,0,0,0,0,0,0,0,0,0,0
A & N ISLANDS,2006,EVE-TEASING,0,0,0,0,0,0,0,0,0,0,0,0,0,0,0
A & N ISLANDS,2006,CRUELTY BY HUSBAND OR RELATIVE OF HUSBAND,0,0,0,0,0,0,0,0,0,0,0,0,0,0,0
A & N ISLANDS,2006,OTHER IPC CRIMES,0,0,0,0,0,0,0,0,0,0,0,0,0,0,0
A & N ISLANDS,2006,TOTAL IPC,0,0,0,6,0,6,30,1,31,5,0,5,41,1,42
A & N ISLANDS,2007,MURDER,0,0,0,6,0,6,20,1,21,2,0,2,28,1,29
A & N ISLANDS,2007,ATTEMPT TO COMMIT MURDER,0,0,0,1,0,1,2,0,2,0,0,0,3,0,3
A & N ISLANDS,2007,C.H. NOT AMOUNTING TO MURDER,0,0,0,0,0,0,0,0,0,0,0,0,0,0,0
A & N ISLANDS,2007,RAPE,0,0,0,0,0,0,2,0,2,1,0,1,3,0,3
A & N ISLANDS,2007,KIDNAPPING AND ABDUCTION,0,0,0,0,0,0,0,0,0,0,0,0,0,0,0
A & N ISLANDS,2007,DACOITY,0,0,0,0,0,0,2,0,2,0,0,0,2,0,2
A & N ISLANDS,2007,PREP. AND ASSEMBLY FOR DACOITY,0,0,0,0,0,0,0,0,0,0,0,0,0,0,0
A & N ISLANDS,2007,ROBBERY,0,0,0,0,0,0,0,0,0,0,0,0,0,0,0
A & N ISLANDS,2007,BURGLARY,0,0,0,2,0,2,1,0,1,0,0,0,3,0,3
A & N ISLANDS,2007,THEFTS,0,0,0,1,0,1,4,0,4,0,0,0,5,0,5
A & N ISLANDS,2007,EXTORTION,0,0,0,0,0,0,0,0,0,0,0,0,0,0,0
A & N ISLANDS,2007,RIOTS,0,0,0,0,0,0,0,0,0,0,0,0,0,0,0
A & N ISLANDS,2007,ARSON,0,0,0,0,0,0,0,0,0,0,0,0,0,0,0
A & N ISLANDS,2007,CRIMINAL BREACH OF TRUST,0,0,0,0,0,0,0,0,0,0,0,0,0,0,0
A & N ISLANDS,2007,CHEATING,0,0,0,0,0,0,0,0,0,0,0,0,0,0,0
A & N ISLANDS,2007,COUNTER FEITING,0,0,0,0,0,0,0,0,0,0,0,0,0,0,0
A & N ISLANDS,2007,DOWRY DEATHS,0,0,0,0,0,0,0,0,0,0,0,0,0,0,0
A & N ISLANDS,2007,MOLESTATION,0,0,0,0,0,0,0,0,0,0,0,0,0,0,0
A & N ISLANDS,2007,EVE-TEASING,0,0,0,0,0,0,0,0,0,0,0,0,0,0,0
A & N ISLANDS,2007,CRUELTY BY HUSBAND OR RELATIVE OF HUSBAND,0,0,0,0,0,0,0,0,0,0,0,0,0,0,0
A & N ISLANDS,2007,OTHER IPC CRIMES,0,0,0,6,0,6,9,0,9,0,0,0,15,0,15
A & N ISLANDS,2007,TOTAL IPC,0,0,0,16,0,16,40,1,41,3,0,3,59,1,60
A & N ISLANDS,2008,MURDER,0,0,0,1,0,1,25,0,25,5,0,5,31,0,31
A & N ISLANDS,2008,ATTEMPT TO COMMIT MURDER,0,0,0,0,0,0,1,0,1,0,0,0,1,0,1
A & N ISLANDS,2008,C.H. NOT AMOUNTING TO MURDER,0,0,0,0,0,0,1,0,1,0,0,0,1,0,1
A & N ISLANDS,2008,RAPE,0,0,0,0,0,0,3,0,3,2,0,2,5,0,5
A & N ISLANDS,2008,KIDNAPPING AND ABDUCTION,0,0,0,0,0,0,0,0,0,0,0,0,0,0,0
A & N ISLANDS,2008,DACOITY,0,0,0,2,0,2,0,0,0,0,0,0,2,0,2
A & N ISLANDS,2008,PREP. AND ASSEMBLY FOR DACOITY,0,0,0,0,0,0,0,0,0,0,0,0,0,0,0
A & N ISLANDS,2008,ROBBERY,0,0,0,1,0,1,0,0,0,0,0,0,1,0,1
A & N ISLANDS,2008,BURGLARY,0,0,0,0,0,0,0,0,0,0,0,0,0,0,0
A & N ISLANDS,2008,THEFTS,0,0,0,1,0,1,2,0,2,0,0,0,3,0,3
A & N ISLANDS,2008,EXTORTION,0,0,0,0,0,0,0,0,0,0,0,0,0,0,0
A & N ISLANDS,2008,RIOTS,0,0,0,0,0,0,0,0,0,0,0,0,0,0,0
A & N ISLANDS,2008,ARSON,0,0,0,0,0,0,0,0,0,0,0,0,0,0,0
A & N ISLANDS,2008,CRIMINAL BREACH OF TRUST,0,0,0,0,0,0,0,0,0,0,0,0,0,0,0
A & N ISLANDS,2008,CHEATING,0,0,0,0,0,0,0,0,0,0,0,0,0,0,0
A & N ISLANDS,2008,COUNTER FEITING,0,0,0,0,0,0,0,0,0,0,0,0,0,0,0
A & N ISLANDS,2008,DOWRY DEATHS,0,0,0,0,0,0,0,0,0,0,0,0,0,0,0
A & N ISLANDS,2008,MOLESTATION,0,0,0,0,0,0,0,0,0,0,0,0,0,0,0
A & N ISLANDS,2008,EVE-TEASING,0,0,0,0,0,0,0,0,0,0,0,0,0,0,0
A & N ISLANDS,2008,CRUELTY BY HUSBAND OR RELATIVE OF HUSBAND,0,0,0,0,0,0,0,0,0,0,0,0,0,0,0
A & N ISLANDS,2008,OTHER IPC CRIMES,0,0,0,1,0,1,2,0,2,0,0,0,3,0,3
A & N ISLANDS,2008,TOTAL IPC,0,0,0,6,0,6,34,0,34,7,0,7,47,0,47
A & N ISLANDS,2009,MURDER,0,0,0,2,0,2,22,0,22,5,0,5,29,0,29
A & N ISLANDS,2009,ATTEMPT TO COMMIT MURDER,0,0,0,0,0,0,2,0,2,1,0,1,3,0,3
A & N ISLANDS,2009,C.H. NOT AMOUNTING TO MURDER,0,0,0,0,0,0,2,0,2,0,0,0,2,0,2
A & N ISLANDS,2009,RAPE,0,0,0,0,0,0,3,0,3,1,0,1,4,0,4
A & N ISLANDS,2009,KIDNAPPING AND ABDUCTION,0,0,0,0,0,0,0,0,0,0,0,0,0,0,0
A & N ISLANDS,2009,DACOITY,0,0,0,0,0,0,0,0,0,0,0,0,0,0,0
A & N ISLANDS,2009,PREP. AND ASSEMBLY FOR DACOITY,0,0,0,0,0,0,0,0,0,0,0,0,0,0,0
A & N ISLANDS,2009,ROBBERY,0,0,0,1,0,1,0,0,0,0,0,0,1,0,1
A & N ISLANDS,2009,BURGLARY,0,0,0,0,0,0,0,0,0,0,0,0,0,0,0
A & N ISLANDS,2009,THEFTS,0,0,0,1,0,1,1,0,1,0,0,0,2,0,2
A & N ISLANDS,2009,EXTORTION,0,0,0,0,0,0,0,0,0,0,0,0,0,0,0
A & N ISLANDS,2009,RIOTS,0,0,0,0,0,0,0,0,0,0,0,0,0,0,0
A & N ISLANDS,2009,ARSON,0,0,0,0,0,0,0,0,0,0,0,0,0,0,0
A & N ISLANDS,2009,CRIMINAL BREACH OF TRUST,0,0,0,0,0,0,0,0,0,0,0,0,0,0,0
A & N ISLANDS,2009,CHEATING,0,0,0,0,0,0,0,0,0,0,0,0,0,0,0
A & N ISLANDS,2009,COUNTER FEITING,0,0,0,0,0,0,0,0,0,0,0,0,0,0,0
A & N ISLANDS,2009,DOWRY DEATHS,0,0,0,0,0,0,0,0,0,0,0,0,0,0,0
A & N ISLANDS,2009,MOLESTATION,0,0,0,0,0,0,0,0,0,0,0,0,0,0,0
A & N ISLANDS,2009,EVE-TEASING,0,0,0,0,0,0,0,0,0,0,0,0,0,0,0
A & N ISLANDS,2009,CRUELTY BY HUSBAND OR RELATIVE OF HUSBAND,0,0,0,0,0,0,0,0,0,0,0,0,0,0,0
A & N ISLANDS,2009,OTHER IPC CRIMES,0,0,0,1,0,1,0,0,0,0,0,0,1,0,1
A & N ISLANDS,2009,TOTAL IPC,0,0,0,5,0,5,30,0,30,7,0,7,42,0,42
A & N ISLANDS,2010,MURDER,0,0,0,0,0,0,22,0,22,7,0,7,29,0,29
A & N ISLANDS,2010,ATTEMPT TO COMMIT MURDER,0,0,0,2,0,2,0,0,0,0,0,0,2,0,2
A & N ISLANDS,2010,C.H. NOT AMOUNTING TO MURDER,0,0,0,0,0,0,0,0,0,0,0,0,0,0,0
A & N ISLANDS,2010,RAPE,0,0,0,3,0,3,0,0,0,2,0,2,5,0,5
A & N ISLANDS,2010,KIDNAPPING AND ABDUCTION,0,0,0,0,0,0,0,0,0,0,0,0,0,0,0
A & N ISLANDS,2010,DACOITY,0,0,0,0,0,0,2,0,2,0,0,0,2,0,2
A & N ISLANDS,2010,PREP. AND ASSEMBLY FOR DACOITY,0,0,0,0,0,0,0,0,0,0,0,0,0,0,0
A & N ISLANDS,2010,ROBBERY,0,0,0,0,0,0,0,0,0,0,0,0,0,0,0
A & N ISLANDS,2010,BURGLARY,0,0,0,0,0,0,0,0,0,0,0,0,0,0,0
A & N ISLANDS,2010,THEFTS,0,0,0,1,0,1,2,0,2,2,0,2,5,0,5
A & N ISLANDS,2010,EXTORTION,0,0,0,0,0,0,0,0,0,0,0,0,0,0,0
A & N ISLANDS,2010,RIOTS,0,0,0,0,0,0,0,0,0,0,0,0,0,0,0
A & N ISLANDS,2010,ARSON,0,0,0,0,0,0,0,0,0,0,0,0,0,0,0
A & N ISLANDS,2010,CRIMINAL BREACH OF TRUST,0,0,0,0,0,0,0,0,0,0,0,0,0,0,0
A & N ISLANDS,2010,CHEATING,0,0,0,0,0,0,0,0,0,0,0,0,0,0,0
A & N ISLANDS,2010,COUNTER FEITING,0,0,0,0,0,0,0,0,0,0,0,0,0,0,0
A & N ISLANDS,2010,DOWRY DEATHS,0,0,0,0,0,0,0,0,0,0,0,0,0,0,0
A & N ISLANDS,2010,MOLESTATION,0,0,0,0,0,0,0,0,0,0,0,0,0,0,0
A & N ISLANDS,2010,EVE-TEASING,0,0,0,0,0,0,0,0,0,0,0,0,0,0,0
A & N ISLANDS,2010,CRUELTY BY HUSBAND OR RELATIVE OF HUSBAND,0,0,0,0,0,0,0,0,0,0,0,0,0,0,0
A & N ISLANDS,2010,OTHER IPC CRIMES,0,0,0,1,0,1,13,0,13,0,0,0,14,0,14
A & N ISLANDS,2010,TOTAL IPC,0,0,0,7,0,7,39,0,39,11,0,11,57,0,57
A & N ISLANDS,2011,MURDER,0,0,0,2,0,2,19,0,19,6,0,6,27,0,27
A & N ISLANDS,2011,ATTEMPT TO COMMIT MURDER,0,0,0,1,0,1,1,0,1,0,0,0,2,0,2
A & N ISLANDS,2011,C.H. NOT AMOUNTING TO MURDER,0,0,0,0,0,0,4,0,4,0,0,0,4,0,4
A & N ISLANDS,2011,RAPE,0,0,0,1,0,1,4,0,4,2,0,2,7,0,7
A & N ISLANDS,2011,KIDNAPPING AND ABDUCTION,0,0,0,0,0,0,0,0,0,0,0,0,0,0,0
A & N ISLANDS,2011,DACOITY,0,0,0,0,0,0,0,0,0,0,0,0,0,0,0
A & N ISLANDS,2011,PREP. AND ASSEMBLY FOR DACOITY,0,0,0,0,0,0,0,0,0,0,0,0,0,0,0
A & N ISLANDS,2011,ROBBERY,0,0,0,0,0,0,0,0,0,0,0,0,0,0,0
A & N ISLANDS,2011,BURGLARY,0,0,0,0,0,0,0,0,0,0,0,0,0,0,0
A & N ISLANDS,2011,THEFTS,0,0,0,1,0,1,0,0,0,1,0,1,2,0,2
A & N ISLANDS,2011,EXTORTION,0,0,0,0,0,0,0,0,0,0,0,0,0,0,0
A & N ISLANDS,2011,RIOTS,0,0,0,0,0,0,0,0,0,0,0,0,0,0,0
A & N ISLANDS,2011,ARSON,0,0,0,0,0,0,0,0,0,0,0,0,0,0,0
A & N ISLANDS,2011,CRIMINAL BREACH OF TRUST,0,0,0,0,0,0,0,0,0,0,0,0,0,0,0
A & N ISLANDS,2011,CHEATING,0,0,0,0,0,0,0,0,0,0,0,0,0,0,0
A & N ISLANDS,2011,COUNTER FEITING,0,0,0,0,0,0,0,0,0,0,0,0,0,0,0
A & N ISLANDS,2011,DOWRY DEATHS,0,0,0,0,0,0,0,0,0,0,0,0,0,0,0
A & N ISLANDS,2011,MOLESTATION,0,0,0,0,0,0,0,0,0,0,0,0,0,0,0
A & N ISLANDS,2011,EVE-TEASING,0,0,0,0,0,0,0,0,0,0,0,0,0,0,0
A & N ISLANDS,2011,CRUELTY BY HUSBAND OR RELATIVE OF HUSBAND,0,0,0,0,0,0,0,0,0,0,0,0,0,0,0
A & N ISLANDS,2011,OTHER IPC CRIMES,0,0,0,1,0,1,6,0,6,9,0,9,16,0,16
A & N ISLANDS,2011,TOTAL IPC,0,0,0,6,0,6,34,0,34,18,0,18,58,0,58
A & N ISLANDS,2012,MURDER,0,0,0,6,0,6,15,0,15,8,0,8,29,0,29
A & N ISLANDS,2012,ATTEMPT TO COMMIT MURDER,0,0,0,0,0,0,1,0,1,0,0,0,1,0,1
A & N ISLANDS,2012,C.H. NOT AMOUNTING TO MURDER,0,0,0,0,0,0,5,0,5,0,0,0,5,0,5
A & N ISLANDS,2012,RAPE,0,0,0,1,0,1,2,0,2,1,0,1,4,0,4
A & N ISLANDS,2012,KIDNAPPING AND ABDUCTION,0,0,0,0,0,0,0,0,0,0,0,0,0,0,0
A & N ISLANDS,2012,DACOITY,0,0,0,0,0,0,0,0,0,0,0,0,0,0,0
A & N ISLANDS,2012,PREP. AND ASSEMBLY FOR DACOITY,0,0,0,0,0,0,0,0,0,0,0,0,0,0,0
A & N ISLANDS,2012,ROBBERY,0,0,0,0,0,0,0,0,0,0,0,0,0,0,0
A & N ISLANDS,2012,BURGLARY,0,0,0,0,0,0,0,0,0,0,0,0,0,0,0
A & N ISLANDS,2012,THEFTS,0,0,0,0,0,0,1,0,1,1,0,1,2,0,2
A & N ISLANDS,2012,EXTORTION,0,0,0,0,0,0,0,0,0,0,0,0,0,0,0
A & N ISLANDS,2012,RIOTS,0,0,0,0,0,0,0,0,0,0,0,0,0,0,0
A & N ISLANDS,2012,ARSON,0,0,0,0,0,0,0,0,0,0,0,0,0,0,0
A & N ISLANDS,2012,CRIMINAL BREACH OF TRUST,0,0,0,0,0,0,0,0,0,0,0,0,0,0,0
A & N ISLANDS,2012,CHEATING,0,0,0,0,0,0,0,0,0,0,0,0,0,0,0
A & N ISLANDS,2012,COUNTER FEITING,0,0,0,0,0,0,0,0,0,0,0,0,0,0,0
A & N ISLANDS,2012,DOWRY DEATHS,0,0,0,0,0,0,0,0,0,0,0,0,0,0,0
A & N ISLANDS,2012,MOLESTATION,0,0,0,0,0,0,0,0,0,0,0,0,0,0,0
A & N ISLANDS,2012,EVE-TEASING,0,0,0,0,0,0,0,0,0,0,0,0,0,0,0
A & N ISLANDS,2012,CRUELTY BY HUSBAND OR RELATIVE OF HUSBAND,0,0,0,0,0,0,0,0,0,0,0,0,0,0,0
A & N ISLANDS,2012,OTHER IPC CRIMES,0,0,0,1,0,1,1,0,1,12,0,12,14,0,14
A & N ISLANDS,2012,TOTAL IPC,0,0,0,8,0,8,25,0,25,22,0,22,55,0,55
CHANDIGARH,2001,MURDER,0,0,0,12,1,13,20,2,22,2,0,2,34,3,37
CHANDIGARH,2001,ATTEMPT TO COMMIT MURDER,2,0,2,3,0,3,14,0,14,1,0,1,20,0,20
CHANDIGARH,2001,C.H. NOT AMOUNTING TO MURDER,0,0,0,0,0,0,0,0,0,0,0,0,0,0,0
CHANDIGARH,2001,RAPE,0,0,0,2,0,2,4,0,4,0,0,0,6,0,6
CHANDIGARH,2001,KIDNAPPING AND ABDUCTION,0,0,0,1,0,1,0,0,0,0,0,0,1,0,1
CHANDIGARH,2001,DACOITY,0,0,0,0,0,0,0,0,0,0,0,0,0,0,0
CHANDIGARH,2001,PREP. AND ASSEMBLY FOR DACOITY,0,0,0,0,0,0,3,0,3,0,0,0,3,0,3
CHANDIGARH,2001,ROBBERY,0,0,0,0,0,0,0,0,0,0,0,0,0,0,0
CHANDIGARH,2001,BURGLARY,0,0,0,0,0,0,0,0,0,0,0,0,0,0,0
CHANDIGARH,2001,THEFTS,0,0,0,4,1,5,5,0,5,2,0,2,11,1,12
CHANDIGARH,2001,EXTORTION,0,0,0,0,0,0,0,0,0,0,0,0,0,0,0
CHANDIGARH,2001,RIOTS,0,0,0,0,0,0,0,0,0,0,0,0,0,0,0
CHANDIGARH,2001,ARSON,0,0,0,0,0,0,0,0,0,0,0,0,0,0,0
CHANDIGARH,2001,CRIMINAL BREACH OF TRUST,0,0,0,0,0,0,2,0,2,0,0,0,2,0,2
CHANDIGARH,2001,CHEATING,0,0,0,0,0,0,1,0,1,0,0,0,1,0,1
CHANDIGARH,2001,COUNTER FEITING,0,0,0,0,0,0,0,0,0,0,0,0,0,0,0
CHANDIGARH,2001,DOWRY DEATHS,0,0,0,2,0,2,1,2,3,1,0,1,4,2,6
CHANDIGARH,2001,MOLESTATION,0,0,0,0,0,0,0,0,0,0,0,0,0,0,0
CHANDIGARH,2001,EVE-TEASING,0,0,0,0,0,0,0,0,0,0,0,0,0,0,0
CHANDIGARH,2001,CRUELTY BY HUSBAND OR RELATIVE OF HUSBAND,0,0,0,0,0,0,0,0,0,0,0,0,0,0,0
CHANDIGARH,2001,OTHER IPC CRIMES,0,0,0,0,0,0,0,0,0,0,0,0,0,0,0
CHANDIGARH,2001,TOTAL IPC,2,0,2,24,2,26,50,4,54,6,0,6,82,6,88
CHANDIGARH,2002,MURDER,0,0,0,18,1,19,26,3,29,6,1,7,50,5,55
CHANDIGARH,2002,ATTEMPT TO COMMIT MURDER,0,0,0,3,1,4,2,0,2,3,0,3,8,1,9
CHANDIGARH,2002,C.H. NOT AMOUNTING TO MURDER,0,0,0,0,0,0,1,0,1,0,0,0,1,0,1
CHANDIGARH,2002,RAPE,0,0,0,2,0,2,5,0,5,0,0,0,7,0,7
CHANDIGARH,2002,KIDNAPPING AND ABDUCTION,0,0,0,0,0,0,1,0,1,0,0,0,1,0,1
CHANDIGARH,2002,DACOITY,0,0,0,0,0,0,2,0,2,0,0,0,2,0,2
CHANDIGARH,2002,PREP. AND ASSEMBLY FOR DACOITY,0,0,0,0,0,0,0,0,0,0,0,0,0,0,0
CHANDIGARH,2002,ROBBERY,0,0,0,1,0,1,0,0,0,0,0,0,1,0,1
CHANDIGARH,2002,BURGLARY,0,0,0,0,0,0,0,0,0,1,0,1,1,0,1
CHANDIGARH,2002,THEFTS,0,0,0,2,0,2,4,0,4,0,0,0,6,0,6
CHANDIGARH,2002,EXTORTION,0,0,0,0,0,0,0,0,0,0,0,0,0,0,0
CHANDIGARH,2002,RIOTS,0,0,0,0,0,0,0,0,0,0,0,0,0,0,0
CHANDIGARH,2002,ARSON,0,0,0,0,0,0,0,0,0,0,0,0,0,0,0
CHANDIGARH,2002,CRIMINAL BREACH OF TRUST,0,0,0,0,0,0,0,0,0,0,0,0,0,0,0
CHANDIGARH,2002,CHEATING,0,0,0,2,0,2,0,0,0,0,0,0,2,0,2
CHANDIGARH,2002,COUNTER FEITING,0,0,0,0,0,0,0,0,0,0,0,0,0,0,0
CHANDIGARH,2002,DOWRY DEATHS,0,0,0,1,0,1,2,1,3,0,0,0,3,1,4
CHANDIGARH,2002,MOLESTATION,0,0,0,0,0,0,0,0,0,0,0,0,0,0,0
CHANDIGARH,2002,EVE-TEASING,0,0,0,0,0,0,0,0,0,0,0,0,0,0,0
CHANDIGARH,2002,CRUELTY BY HUSBAND OR RELATIVE OF HUSBAND,0,0,0,0,0,0,1,0,1,0,0,0,1,0,1
CHANDIGARH,2002,OTHER IPC CRIMES,0,0,0,1,0,1,0,0,0,1,0,1,2,0,2
CHANDIGARH,2002,TOTAL IPC,0,0,0,30,2,32,44,4,48,11,1,12,85,7,92
CHANDIGARH,2003,MURDER,0,0,0,12,1,13,16,2,18,8,1,9,36,4,40
CHANDIGARH,2003,ATTEMPT TO COMMIT MURDER,0,0,0,4,0,4,8,1,9,2,0,2,14,1,15
CHANDIGARH,2003,C.H. NOT AMOUNTING TO MURDER,0,0,0,2,0,2,3,0,3,0,0,0,5,0,5
CHANDIGARH,2003,RAPE,0,0,0,3,0,3,6,0,6,0,0,0,9,0,9
CHANDIGARH,2003,KIDNAPPING AND ABDUCTION,0,0,0,2,0,2,3,0,3,3,0,3,8,0,8
CHANDIGARH,2003,DACOITY,0,0,0,2,0,2,4,0,4,0,0,0,6,0,6
CHANDIGARH,2003,PREP. AND ASSEMBLY FOR DACOITY,0,0,0,0,0,0,2,0,2,0,0,0,2,0,2
CHANDIGARH,2003,ROBBERY,0,0,0,1,0,1,3,0,3,0,0,0,4,0,4
CHANDIGARH,2003,BURGLARY,0,0,0,0,0,0,6,1,7,0,0,0,6,1,7
CHANDIGARH,2003,THEFTS,0,0,0,3,0,3,4,0,4,5,0,5,12,0,12
CHANDIGARH,2003,EXTORTION,0,0,0,0,0,0,0,0,0,0,0,0,0,0,0
CHANDIGARH,2003,RIOTS,0,0,0,0,0,0,0,0,0,0,0,0,0,0,0
CHANDIGARH,2003,ARSON,0,0,0,0,0,0,0,0,0,0,0,0,0,0,0
CHANDIGARH,2003,CRIMINAL BREACH OF TRUST,0,0,0,0,0,0,3,0,3,0,0,0,3,0,3
CHANDIGARH,2003,CHEATING,0,0,0,0,0,0,2,0,2,0,0,0,2,0,2
CHANDIGARH,2003,COUNTER FEITING,0,0,0,0,0,0,0,0,0,0,0,0,0,0,0
CHANDIGARH,2003,DOWRY DEATHS,0,0,0,2,0,2,3,2,5,3,1,4,8,3,11
CHANDIGARH,2003,MOLESTATION,0,0,0,0,0,0,0,0,0,0,0,0,0,0,0
CHANDIGARH,2003,EVE-TEASING,0,0,0,0,0,0,0,0,0,0,0,0,0,0,0
CHANDIGARH,2003,CRUELTY BY HUSBAND OR RELATIVE OF HUSBAND,0,0,0,0,0,0,0,0,0,0,0,0,0,0,0
CHANDIGARH,2003,OTHER IPC CRIMES,0,0,0,0,0,0,0,0,0,0,0,0,0,0,0
CHANDIGARH,2003,TOTAL IPC,0,0,0,31,1,32,63,6,69,21,2,23,115,9,124
CHANDIGARH,2004,MURDER,0,0,0,11,1,12,21,4,25,10,0,10,42,5,47
CHANDIGARH,2004,ATTEMPT TO COMMIT MURDER,0,0,0,2,0,2,3,0,3,2,1,3,7,1,8
CHANDIGARH,2004,C.H. NOT AMOUNTING TO MURDER,0,0,0,2,0,2,3,0,3,0,0,0,5,0,5
CHANDIGARH,2004,RAPE,0,0,0,1,0,1,2,0,2,1,0,1,4,0,4
CHANDIGARH,2004,KIDNAPPING AND ABDUCTION,0,0,0,0,0,0,1,0,1,0,0,0,1,0,1
CHANDIGARH,2004,DACOITY,0,0,0,1,0,1,2,0,2,0,0,0,3,0,3
CHANDIGARH,2004,PREP. AND ASSEMBLY FOR DACOITY,0,0,0,1,0,1,1,0,1,0,0,0,2,0,2
CHANDIGARH,2004,ROBBERY,0,0,0,0,0,0,2,0,2,0,0,0,2,0,2
CHANDIGARH,2004,BURGLARY,0,0,0,3,0,3,2,0,2,0,0,0,5,0,5
CHANDIGARH,2004,THEFTS,0,0,0,1,0,1,4,1,5,0,0,0,5,1,6
CHANDIGARH,2004,EXTORTION,0,0,0,0,0,0,0,0,0,0,0,0,0,0,0
CHANDIGARH,2004,RIOTS,0,0,0,0,0,0,0,0,0,0,0,0,0,0,0
CHANDIGARH,2004,ARSON,0,0,0,0,0,0,0,0,0,0,0,0,0,0,0
CHANDIGARH,2004,CRIMINAL BREACH OF TRUST,0,0,0,0,0,0,4,0,4,3,0,3,7,0,7
CHANDIGARH,2004,CHEATING,0,0,0,0,0,0,2,0,2,1,0,1,3,0,3
CHANDIGARH,2004,COUNTER FEITING,0,0,0,0,0,0,0,0,0,0,0,0,0,0,0
CHANDIGARH,2004,DOWRY DEATHS,0,0,0,0,0,0,0,0,0,0,0,0,0,0,0
CHANDIGARH,2004,MOLESTATION,0,0,0,0,0,0,2,0,2,0,0,0,2,0,2
CHANDIGARH,2004,EVE-TEASING,0,0,0,0,0,0,0,0,0,0,0,0,0,0,0
CHANDIGARH,2004,CRUELTY BY HUSBAND OR RELATIVE OF HUSBAND,0,0,0,0,0,0,0,0,0,0,0,0,0,0,0
CHANDIGARH,2004,OTHER IPC CRIMES,0,0,0,0,0,0,0,0,0,0,0,0,0,0,0
CHANDIGARH,2004,TOTAL IPC,0,0,0,22,1,23,49,5,54,17,1,18,88,7,95
CHANDIGARH,2005,MURDER,0,0,0,8,2,10,17,1,18,7,2,9,32,5,37
CHANDIGARH,2005,ATTEMPT TO COMMIT MURDER,0,0,0,2,0,2,4,1,5,2,0,2,8,1,9
CHANDIGARH,2005,C.H. NOT AMOUNTING TO MURDER,0,0,0,1,0,1,2,0,2,0,0,0,3,0,3
CHANDIGARH,2005,RAPE,0,0,0,1,0,1,4,0,4,0,0,0,5,0,5
CHANDIGARH,2005,KIDNAPPING AND ABDUCTION,0,0,0,0,0,0,2,0,2,0,0,0,2,0,2
CHANDIGARH,2005,DACOITY,0,0,0,0,0,0,2,0,2,0,0,0,2,0,2
CHANDIGARH,2005,PREP. AND ASSEMBLY FOR DACOITY,0,0,0,1,0,1,0,0,0,0,0,0,1,0,1
CHANDIGARH,2005,ROBBERY,0,0,0,0,0,0,0,0,0,0,0,0,0,0,0
CHANDIGARH,2005,BURGLARY,0,0,0,1,0,1,0,0,0,1,0,1,2,0,2
CHANDIGARH,2005,THEFTS,0,0,0,1,0,1,2,0,2,0,0,0,3,0,3
CHANDIGARH,2005,EXTORTION,0,0,0,0,0,0,0,0,0,1,0,1,1,0,1
CHANDIGARH,2005,RIOTS,0,0,0,0,0,0,0,0,0,0,0,0,0,0,0
CHANDIGARH,2005,ARSON,0,0,0,0,0,0,1,0,1,1,0,1,2,0,2
CHANDIGARH,2005,CRIMINAL BREACH OF TRUST,0,0,0,0,0,0,2,0,2,1,0,1,3,0,3
CHANDIGARH,2005,CHEATING,0,0,0,0,0,0,0,0,0,1,0,1,1,0,1
CHANDIGARH,2005,COUNTER FEITING,0,0,0,0,0,0,0,0,0,0,0,0,0,0,0
CHANDIGARH,2005,DOWRY DEATHS,0,0,0,0,0,0,0,0,0,1,0,1,1,0,1
CHANDIGARH,2005,MOLESTATION,0,0,0,0,0,0,0,0,0,0,0,0,0,0,0
CHANDIGARH,2005,EVE-TEASING,0,0,0,0,0,0,0,0,0,0,0,0,0,0,0
CHANDIGARH,2005,CRUELTY BY HUSBAND OR RELATIVE OF HUSBAND,0,0,0,0,0,0,0,0,0,0,0,0,0,0,0
CHANDIGARH,2005,OTHER IPC CRIMES,0,0,0,0,0,0,0,0,0,0,0,0,0,0,0
CHANDIGARH,2005,TOTAL IPC,0,0,0,15,2,17,36,2,38,15,2,17,66,6,72
CHANDIGARH,2006,MURDER,0,0,0,11,1,12,17,2,19,10,1,11,38,4,42
CHANDIGARH,2006,ATTEMPT TO COMMIT MURDER,0,0,0,4,0,4,2,0,2,2,0,2,8,0,8
CHANDIGARH,2006,C.H. NOT AMOUNTING TO MURDER,0,0,0,1,0,1,0,0,0,1,0,1,2,0,2
CHANDIGARH,2006,RAPE,0,0,0,6,0,6,7,1,8,0,0,0,13,1,14
CHANDIGARH,2006,KIDNAPPING AND ABDUCTION,0,0,0,0,0,0,2,0,2,1,0,1,3,0,3
CHANDIGARH,2006,DACOITY,0,0,0,2,0,2,3,0,3,0,0,0,5,0,5
CHANDIGARH,2006,PREP. AND ASSEMBLY FOR DACOITY,0,0,0,1,0,1,0,0,0,0,0,0,1,0,1
CHANDIGARH,2006,ROBBERY,0,0,0,1,0,1,2,0,2,2,0,2,5,0,5
CHANDIGARH,2006,BURGLARY,0,0,0,0,0,0,0,0,0,0,0,0,0,0,0
CHANDIGARH,2006,THEFTS,0,0,0,1,0,1,2,0,2,1,0,1,4,0,4
CHANDIGARH,2006,EXTORTION,0,0,0,0,0,0,1,0,1,1,0,1,2,0,2
CHANDIGARH,2006,RIOTS,0,0,0,0,0,0,0,0,0,0,0,0,0,0,0
CHANDIGARH,2006,ARSON,0,0,0,0,0,0,0,0,0,0,0,0,0,0,0
CHANDIGARH,2006,CRIMINAL BREACH OF TRUST,0,0,0,0,0,0,3,0,3,1,0,1,4,0,4
CHANDIGARH,2006,CHEATING,0,0,0,0,0,0,0,0,0,0,0,0,0,0,0
CHANDIGARH,2006,COUNTER FEITING,0,0,0,0,0,0,0,0,0,0,0,0,0,0,0
CHANDIGARH,2006,DOWRY DEATHS,0,0,0,0,0,0,2,0,2,0,0,0,2,0,2
CHANDIGARH,2006,MOLESTATION,0,0,0,0,0,0,0,0,0,0,0,0,0,0,0
CHANDIGARH,2006,EVE-TEASING,0,0,0,0,0,0,0,0,0,0,0,0,0,0,0
CHANDIGARH,2006,CRUELTY BY HUSBAND OR RELATIVE OF HUSBAND,0,0,0,0,0,0,0,0,0,0,0,0,0,0,0
CHANDIGARH,2006,OTHER IPC CRIMES,0,0,0,0,0,0,0,0,0,0,0,0,0,0,0
CHANDIGARH,2006,TOTAL IPC,0,0,0,27,1,28,41,3,44,19,1,20,87,5,92
CHANDIGARH,2007,MURDER,0,0,0,12,1,13,18,2,20,9,1,10,39,4,43
CHANDIGARH,2007,ATTEMPT TO COMMIT MURDER,0,0,0,3,0,3,6,0,6,2,0,2,11,0,11
CHANDIGARH,2007,C.H. NOT AMOUNTING TO MURDER,0,0,0,1,0,1,3,0,3,2,0,2,6,0,6
CHANDIGARH,2007,RAPE,0,0,0,4,0,4,11,0,11,1,0,1,16,0,16
CHANDIGARH,2007,KIDNAPPING AND ABDUCTION,0,0,0,1,0,1,2,0,2,2,0,2,5,0,5
CHANDIGARH,2007,DACOITY,0,0,0,1,0,1,1,0,1,1,0,1,3,0,3
CHANDIGARH,2007,PREP. AND ASSEMBLY FOR DACOITY,0,0,0,0,0,0,4,0,4,1,0,1,5,0,5
CHANDIGARH,2007,ROBBERY,0,0,0,1,0,1,2,0,2,1,0,1,4,0,4
CHANDIGARH,2007,BURGLARY,0,0,0,0,0,0,0,0,0,0,0,0,0,0,0
CHANDIGARH,2007,THEFTS,0,0,0,2,0,2,4,0,4,2,0,2,8,0,8
CHANDIGARH,2007,EXTORTION,0,0,0,0,0,0,0,0,0,0,0,0,0,0,0
CHANDIGARH,2007,RIOTS,0,0,0,0,0,0,0,0,0,0,0,0,0,0,0
CHANDIGARH,2007,ARSON,0,0,0,0,0,0,0,0,0,0,0,0,0,0,0
CHANDIGARH,2007,CRIMINAL BREACH OF TRUST,0,0,0,0,0,0,0,0,0,0,0,0,0,0,0
CHANDIGARH,2007,CHEATING,0,0,0,0,0,0,0,0,0,0,0,0,0,0,0
CHANDIGARH,2007,COUNTER FEITING,0,0,0,0,0,0,0,0,0,0,0,0,0,0,0
CHANDIGARH,2007,DOWRY DEATHS,0,0,0,1,0,1,3,0,3,1,0,1,5,0,5
CHANDIGARH,2007,MOLESTATION,0,0,0,0,0,0,0,0,0,0,0,0,0,0,0
CHANDIGARH,2007,EVE-TEASING,0,0,0,0,0,0,0,0,0,0,0,0,0,0,0
CHANDIGARH,2007,CRUELTY BY HUSBAND OR RELATIVE OF HUSBAND,0,0,0,0,0,0,0,0,0,0,0,0,0,0,0
CHANDIGARH,2007,OTHER IPC CRIMES,0,0,0,0,0,0,0,0,0,0,0,0,0,0,0
CHANDIGARH,2007,TOTAL IPC,0,0,0,26,1,27,54,2,56,22,1,23,102,4,106
CHANDIGARH,2008,MURDER,0,0,0,16,1,17,30,2,32,15,0,15,61,3,64
CHANDIGARH,2008,ATTEMPT TO COMMIT MURDER,0,0,0,4,0,4,6,0,6,2,0,2,12,0,12
CHANDIGARH,2008,C.H. NOT AMOUNTING TO MURDER,0,0,0,2,0,2,4,0,4,2,0,2,8,0,8
CHANDIGARH,2008,RAPE,0,0,0,5,0,5,12,1,13,6,0,6,23,1,24
CHANDIGARH,2008,KIDNAPPING AND ABDUCTION,0,0,0,4,0,4,3,0,3,0,0,0,7,0,7
CHANDIGARH,2008,DACOITY,0,0,0,2,0,2,4,0,4,0,0,0,6,0,6
CHANDIGARH,2008,PREP. AND ASSEMBLY FOR DACOITY,0,0,0,3,0,3,2,0,2,0,0,0,5,0,5
CHANDIGARH,2008,ROBBERY,0,0,0,1,0,1,1,0,1,0,0,0,2,0,2
CHANDIGARH,2008,BURGLARY,0,0,0,0,0,0,0,0,0,0,0,0,0,0,0
CHANDIGARH,2008,THEFTS,0,0,0,3,1,4,1,0,1,1,0,1,5,1,6
CHANDIGARH,2008,EXTORTION,0,0,0,0,0,0,0,0,0,0,0,0,0,0,0
CHANDIGARH,2008,RIOTS,0,0,0,0,0,0,0,0,0,0,0,0,0,0,0
CHANDIGARH,2008,ARSON,0,0,0,0,0,0,0,0,0,0,0,0,0,0,0
CHANDIGARH,2008,CRIMINAL BREACH OF TRUST,0,0,0,0,0,0,0,0,0,0,0,0,0,0,0
CHANDIGARH,2008,CHEATING,0,0,0,0,0,0,0,0,0,0,0,0,0,0,0
CHANDIGARH,2008,COUNTER FEITING,0,0,0,0,0,0,0,0,0,0,0,0,0,0,0
CHANDIGARH,2008,DOWRY DEATHS,0,0,0,1,0,1,0,0,0,1,0,1,2,0,2
CHANDIGARH,2008,MOLESTATION,0,0,0,0,0,0,0,0,0,0,0,0,0,0,0
CHANDIGARH,2008,EVE-TEASING,0,0,0,0,0,0,0,0,0,0,0,0,0,0,0
CHANDIGARH,2008,CRUELTY BY HUSBAND OR RELATIVE OF HUSBAND,0,0,0,0,0,0,0,0,0,0,0,0,0,0,0
CHANDIGARH,2008,OTHER IPC CRIMES,0,0,0,0,0,0,0,0,0,0,0,0,0,0,0
CHANDIGARH,2008,TOTAL IPC,0,0,0,41,2,43,63,3,66,27,0,27,131,5,136
CHANDIGARH,2009,MURDER,0,0,0,24,1,25,20,3,23,6,1,7,50,5,55
CHANDIGARH,2009,ATTEMPT TO COMMIT MURDER,0,0,0,7,0,7,14,0,14,2,0,2,23,0,23
CHANDIGARH,2009,C.H. NOT AMOUNTING TO MURDER,0,0,0,6,0,6,9,1,10,1,0,1,16,1,17
CHANDIGARH,2009,RAPE,0,0,0,5,0,5,11,0,11,1,0,1,17,0,17
CHANDIGARH,2009,KIDNAPPING AND ABDUCTION,0,0,0,4,0,4,7,1,8,2,0,2,13,1,14
CHANDIGARH,2009,DACOITY,0,0,0,4,0,4,9,0,9,1,0,1,14,0,14
CHANDIGARH,2009,PREP. AND ASSEMBLY FOR DACOITY,0,0,0,2,0,2,6,0,6,0,0,0,8,0,8
CHANDIGARH,2009,ROBBERY,0,0,0,7,0,7,10,0,10,0,0,0,17,0,17
CHANDIGARH,2009,BURGLARY,0,0,0,0,0,0,0,0,0,0,0,0,0,0,0
CHANDIGARH,2009,THEFTS,0,0,0,4,0,4,9,1,10,1,0,1,14,1,15
CHANDIGARH,2009,EXTORTION,0,0,0,0,0,0,0,0,0,0,0,0,0,0,0
CHANDIGARH,2009,RIOTS,0,0,0,0,0,0,0,0,0,0,0,0,0,0,0
CHANDIGARH,2009,ARSON,0,0,0,0,0,0,0,0,0,0,0,0,0,0,0
CHANDIGARH,2009,CRIMINAL BREACH OF TRUST,0,0,0,0,0,0,2,0,2,2,0,2,4,0,4
CHANDIGARH,2009,CHEATING,0,0,0,0,0,0,1,0,1,1,0,1,2,0,2
CHANDIGARH,2009,COUNTER FEITING,0,0,0,0,0,0,0,0,0,0,0,0,0,0,0
CHANDIGARH,2009,DOWRY DEATHS,0,0,0,2,1,3,0,0,0,0,0,0,2,1,3
CHANDIGARH,2009,MOLESTATION,0,0,0,0,0,0,0,0,0,0,0,0,0,0,0
CHANDIGARH,2009,EVE-TEASING,0,0,0,0,0,0,0,0,0,0,0,0,0,0,0
CHANDIGARH,2009,CRUELTY BY HUSBAND OR RELATIVE OF HUSBAND,0,0,0,0,0,0,0,0,0,0,0,0,0,0,0
CHANDIGARH,2009,OTHER IPC CRIMES,0,0,0,0,0,0,0,0,0,0,0,0,0,0,0
CHANDIGARH,2009,TOTAL IPC,0,0,0,65,2,67,98,6,104,17,1,18,180,9,189
CHANDIGARH,2010,MURDER,0,0,0,28,1,29,24,4,28,5,2,7,57,7,64
CHANDIGARH,2010,ATTEMPT TO COMMIT MURDER,0,0,0,6,0,6,10,0,10,1,0,1,17,0,17
CHANDIGARH,2010,C.H. NOT AMOUNTING TO MURDER,0,0,0,4,0,4,11,1,12,2,0,2,17,1,18
CHANDIGARH,2010,RAPE,0,0,0,3,0,3,8,0,8,1,0,1,12,0,12
CHANDIGARH,2010,KIDNAPPING AND ABDUCTION,0,0,0,5,0,5,9,0,9,2,1,3,16,1,17
CHANDIGARH,2010,DACOITY,0,0,0,3,0,3,7,0,7,2,0,2,12,0,12
CHANDIGARH,2010,PREP. AND ASSEMBLY FOR DACOITY,0,0,0,4,0,4,4,0,4,0,0,0,8,0,8
CHANDIGARH,2010,ROBBERY,0,0,0,5,0,5,10,0,10,0,0,0,15,0,15
CHANDIGARH,2010,BURGLARY,0,0,0,0,0,0,0,0,0,0,0,0,0,0,0
CHANDIGARH,2010,THEFTS,0,0,0,6,0,6,8,1,9,4,0,4,18,1,19
CHANDIGARH,2010,EXTORTION,0,0,0,0,0,0,0,0,0,0,0,0,0,0,0
CHANDIGARH,2010,RIOTS,0,0,0,0,0,0,0,0,0,0,0,0,0,0,0
CHANDIGARH,2010,ARSON,0,0,0,0,0,0,0,0,0,0,0,0,0,0,0
CHANDIGARH,2010,CRIMINAL BREACH OF TRUST,0,0,0,0,0,0,4,0,4,3,0,3,7,0,7
CHANDIGARH,2010,CHEATING,0,0,0,0,0,0,2,0,2,2,0,2,4,0,4
CHANDIGARH,2010,COUNTER FEITING,0,0,0,0,0,0,0,0,0,0,0,0,0,0,0
CHANDIGARH,2010,DOWRY DEATHS,0,0,0,3,0,3,1,0,1,1,0,1,5,0,5
CHANDIGARH,2010,MOLESTATION,0,0,0,0,0,0,0,0,0,0,0,0,0,0,0
CHANDIGARH,2010,EVE-TEASING,0,0,0,0,0,0,0,0,0,0,0,0,0,0,0
CHANDIGARH,2010,CRUELTY BY HUSBAND OR RELATIVE OF HUSBAND,0,0,0,0,0,0,0,0,0,0,0,0,0,0,0
CHANDIGARH,2010,OTHER IPC CRIMES,0,0,0,0,0,0,0,0,0,0,0,0,0,0,0
CHANDIGARH,2010,TOTAL IPC,0,0,0,67,1,68,98,6,104,23,3,26,188,10,198
CHANDIGARH,2011,MURDER,0,0,0,34,1,35,36,1,37,6,1,7,76,3,79
CHANDIGARH,2011,ATTEMPT TO COMMIT MURDER,0,0,0,8,0,8,11,0,11,2,0,2,21,0,21
CHANDIGARH,2011,C.H. NOT AMOUNTING TO MURDER,0,0,0,6,0,6,6,1,7,1,0,1,13,1,14
CHANDIGARH,2011,RAPE,0,0,0,9,0,9,7,0,7,3,0,3,19,0,19
CHANDIGARH,2011,KIDNAPPING AND ABDUCTION,0,0,0,4,0,4,4,0,4,0,0,0,8,0,8
CHANDIGARH,2011,DACOITY,0,0,0,3,0,3,4,0,4,0,0,0,7,0,7
CHANDIGARH,2011,PREP. AND ASSEMBLY FOR DACOITY,0,0,0,2,0,2,3,0,3,0,0,0,5,0,5
CHANDIGARH,2011,ROBBERY,0,0,0,4,0,4,9,0,9,1,0,1,14,0,14
CHANDIGARH,2011,BURGLARY,0,0,0,0,0,0,7,1,8,1,0,1,8,1,9
CHANDIGARH,2011,THEFTS,0,0,0,6,1,7,9,0,9,1,0,1,16,1,17
CHANDIGARH,2011,EXTORTION,0,0,0,0,0,0,0,0,0,0,0,0,0,0,0
CHANDIGARH,2011,RIOTS,0,0,0,0,0,0,0,0,0,0,0,0,0,0,0
CHANDIGARH,2011,ARSON,0,0,0,0,0,0,0,0,0,0,0,0,0,0,0
CHANDIGARH,2011,CRIMINAL BREACH OF TRUST,0,0,0,0,0,0,3,0,3,2,0,2,5,0,5
CHANDIGARH,2011,CHEATING,0,0,0,0,0,0,0,0,0,0,0,0,0,0,0
CHANDIGARH,2011,COUNTER FEITING,0,0,0,0,0,0,0,0,0,0,0,0,0,0,0
CHANDIGARH,2011,DOWRY DEATHS,0,0,0,4,0,4,1,0,1,0,0,0,5,0,5
CHANDIGARH,2011,MOLESTATION,0,0,0,0,0,0,0,0,0,0,0,0,0,0,0
CHANDIGARH,2011,EVE-TEASING,0,0,0,0,0,0,0,0,0,0,0,0,0,0,0
CHANDIGARH,2011,CRUELTY BY HUSBAND OR RELATIVE OF HUSBAND,0,0,0,0,0,0,0,0,0,0,0,0,0,0,0
CHANDIGARH,2011,OTHER IPC CRIMES,0,0,0,0,0,0,0,0,0,0,0,0,0,0,0
CHANDIGARH,2011,TOTAL IPC,0,0,0,80,2,82,100,3,103,17,1,18,197,6,203
CHANDIGARH,2012,MURDER,0,0,0,26,2,28,19,3,22,4,0,4,49,5,54
CHANDIGARH,2012,ATTEMPT TO COMMIT MURDER,0,0,0,13,0,13,14,0,14,2,0,2,29,0,29
CHANDIGARH,2012,C.H. NOT AMOUNTING TO MURDER,0,0,0,5,0,5,6,1,7,1,0,1,12,1,13
CHANDIGARH,2012,RAPE,0,0,0,19,0,19,9,1,10,2,0,2,30,1,31
CHANDIGARH,2012,KIDNAPPING AND ABDUCTION,0,0,0,9,0,9,6,0,6,0,0,0,15,0,15
CHANDIGARH,2012,DACOITY,0,0,0,6,0,6,4,0,4,0,0,0,10,0,10
CHANDIGARH,2012,PREP. AND ASSEMBLY FOR DACOITY,0,0,0,6,0,6,3,0,3,0,0,0,9,0,9
CHANDIGARH,2012,ROBBERY,0,0,0,2,0,2,1,0,1,0,0,0,3,0,3
CHANDIGARH,2012,BURGLARY,0,0,0,0,0,0,0,0,0,2,0,2,2,0,2
CHANDIGARH,2012,THEFTS,0,0,0,12,1,13,8,1,9,4,1,5,24,3,27
CHANDIGARH,2012,EXTORTION,0,0,0,2,0,2,0,0,0,0,0,0,2,0,2
CHANDIGARH,2012,RIOTS,0,0,0,0,0,0,0,0,0,0,0,0,0,0,0
CHANDIGARH,2012,ARSON,0,0,0,0,0,0,0,0,0,0,0,0,0,0,0
CHANDIGARH,2012,CRIMINAL BREACH OF TRUST,0,0,0,3,0,3,1,1,2,0,0,0,4,1,5
CHANDIGARH,2012,CHEATING,0,0,0,2,0,2,1,1,2,0,0,0,3,1,4
CHANDIGARH,2012,COUNTER FEITING,0,0,0,0,0,0,0,0,0,0,0,0,0,0,0
CHANDIGARH,2012,DOWRY DEATHS,0,0,0,1,0,1,2,0,2,0,0,0,3,0,3
CHANDIGARH,2012,MOLESTATION,0,0,0,2,0,2,0,0,0,0,0,0,2,0,2
CHANDIGARH,2012,EVE-TEASING,0,0,0,0,0,0,0,0,0,0,0,0,0,0,0
CHANDIGARH,2012,CRUELTY BY HUSBAND OR RELATIVE OF HUSBAND,0,0,0,0,0,0,0,0,0,0,0,0,0,0,0
CHANDIGARH,2012,OTHER IPC CRIMES,0,0,0,0,0,0,0,0,0,0,0,0,0,0,0
CHANDIGARH,2012,TOTAL IPC,0,0,0,108,3,111,74,8,82,15,1,16,197,12,209
D & N HAVELI,2001,MURDER,0,0,0,0,0,0,0,0,0,0,0,0,0,0,0
D & N HAVELI,2001,MURDER,0,0,0,0,0,0,0,0,0,0,0,0,0,0,0
D & N HAVELI,2001,ATTEMPT TO COMMIT MURDER,0,0,0,0,0,0,0,0,0,0,0,0,0,0,0
D & N HAVELI,2001,C.H. NOT AMOUNTING TO MURDER,0,0,0,0,0,0,0,0,0,0,0,0,0,0,0
D & N HAVELI,2001,RAPE,0,0,0,1,0,1,0,0,0,0,0,0,1,0,1
D & N HAVELI,2001,KIDNAPPING AND ABDUCTION,0,0,0,0,0,0,0,0,0,0,0,0,0,0,0
D & N HAVELI,2001,DACOITY,0,0,0,0,0,0,0,0,0,0,0,0,0,0,0
D & N HAVELI,2001,PREP. AND ASSEMBLY FOR DACOITY,0,0,0,0,0,0,0,0,0,0,0,0,0,0,0
D & N HAVELI,2001,ROBBERY,0,0,0,0,0,0,0,0,0,0,0,0,0,0,0
D & N HAVELI,2001,BURGLARY,0,0,0,0,0,0,0,0,0,0,0,0,0,0,0
D & N HAVELI,2001,THEFTS,0,0,0,3,0,3,1,0,1,0,0,0,4,0,4
D & N HAVELI,2001,EXTORTION,0,0,0,0,0,0,0,0,0,0,0,0,0,0,0
D & N HAVELI,2001,RIOTS,0,0,0,0,0,0,0,0,0,0,0,0,0,0,0
D & N HAVELI,2001,ARSON,0,0,0,0,0,0,0,0,0,0,0,0,0,0,0
D & N HAVELI,2001,CRIMINAL BREACH OF TRUST,0,0,0,0,0,0,0,0,0,0,0,0,0,0,0
D & N HAVELI,2001,CHEATING,0,0,0,0,0,0,0,0,0,0,0,0,0,0,0
D & N HAVELI,2001,COUNTER FEITING,0,0,0,0,0,0,0,0,0,0,0,0,0,0,0
D & N HAVELI,2001,DOWRY DEATHS,0,0,0,0,0,0,0,0,0,0,0,0,0,0,0
D & N HAVELI,2001,MOLESTATION,0,0,0,0,0,0,0,0,0,0,0,0,0,0,0
D & N HAVELI,2001,EVE-TEASING,0,0,0,0,0,0,0,0,0,0,0,0,0,0,0
D & N HAVELI,2001,CRUELTY BY HUSBAND OR RELATIVE OF HUSBAND,0,0,0,0,0,0,0,0,0,0,0,0,0,0,0
D & N HAVELI,2001,OTHER IPC CRIMES,0,0,0,2,0,2,1,0,1,0,0,0,3,0,3
D & N HAVELI,2001,TOTAL IPC,0,0,0,6,0,6,2,0,2,0,0,0,8,0,8
D & N HAVELI,2002,MURDER,0,0,0,0,0,0,0,0,0,0,0,0,0,0,0
D & N HAVELI,2002,ATTEMPT TO COMMIT MURDER,0,0,0,0,0,0,0,0,0,0,0,0,0,0,0
D & N HAVELI,2002,C.H. NOT AMOUNTING TO MURDER,0,0,0,0,0,0,0,0,0,0,0,0,0,0,0
D & N HAVELI,2002,RAPE,0,0,0,0,0,0,0,0,0,0,0,0,0,0,0
D & N HAVELI,2002,KIDNAPPING AND ABDUCTION,0,0,0,0,0,0,0,0,0,0,0,0,0,0,0
D & N HAVELI,2002,DACOITY,0,0,0,0,0,0,2,1,3,0,0,0,2,1,3
D & N HAVELI,2002,PREP. AND ASSEMBLY FOR DACOITY,0,0,0,0,0,0,0,0,0,0,0,0,0,0,0
D & N HAVELI,2002,ROBBERY,0,0,0,0,0,0,0,0,0,0,0,0,0,0,0
D & N HAVELI,2002,BURGLARY,0,0,0,0,0,0,2,0,2,0,0,0,2,0,2
D & N HAVELI,2002,THEFTS,0,0,0,0,0,0,0,0,0,0,0,0,0,0,0
D & N HAVELI,2002,EXTORTION,0,0,0,0,0,0,0,0,0,0,0,0,0,0,0
D & N HAVELI,2002,RIOTS,0,0,0,0,0,0,0,0,0,0,0,0,0,0,0
D & N HAVELI,2002,ARSON,0,0,0,0,0,0,0,0,0,0,0,0,0,0,0
D & N HAVELI,2002,CRIMINAL BREACH OF TRUST,0,0,0,0,0,0,0,0,0,0,0,0,0,0,0
D & N HAVELI,2002,CHEATING,0,0,0,0,0,0,0,0,0,0,0,0,0,0,0
D & N HAVELI,2002,COUNTER FEITING,0,0,0,0,0,0,0,0,0,0,0,0,0,0,0
D & N HAVELI,2002,DOWRY DEATHS,0,0,0,0,0,0,0,0,0,0,0,0,0,0,0
D & N HAVELI,2002,MOLESTATION,0,0,0,0,0,0,0,0,0,0,0,0,0,0,0
D & N HAVELI,2002,EVE-TEASING,0,0,0,0,0,0,0,0,0,0,0,0,0,0,0
D & N HAVELI,2002,CRUELTY BY HUSBAND OR RELATIVE OF HUSBAND,0,0,0,0,0,0,0,0,0,0,0,0,0,0,0
D & N HAVELI,2002,OTHER IPC CRIMES,0,0,0,0,0,0,0,0,0,0,0,0,0,0,0
D & N HAVELI,2002,TOTAL IPC,0,0,0,0,0,0,4,1,5,0,0,0,4,1,5
D & N HAVELI,2003,MURDER,0,0,0,0,0,0,0,0,0,0,0,0,0,0,0
D & N HAVELI,2003,ATTEMPT TO COMMIT MURDER,0,0,0,0,0,0,0,0,0,0,0,0,0,0,0
D & N HAVELI,2003,C.H. NOT AMOUNTING TO MURDER,0,0,0,0,0,0,0,0,0,0,0,0,0,0,0
D & N HAVELI,2003,RAPE,0,0,0,0,0,0,0,0,0,0,0,0,0,0,0
D & N HAVELI,2003,KIDNAPPING AND ABDUCTION,0,0,0,0,0,0,0,0,0,0,0,0,0,0,0
D & N HAVELI,2003,DACOITY,0,0,0,0,0,0,0,0,0,0,0,0,0,0,0
D & N HAVELI,2003,PREP. AND ASSEMBLY FOR DACOITY,0,0,0,0,0,0,0,0,0,0,0,0,0,0,0
D & N HAVELI,2003,ROBBERY,0,0,0,0,0,0,0,0,0,0,0,0,0,0,0
D & N HAVELI,2003,BURGLARY,0,0,0,0,0,0,0,0,0,0,0,0,0,0,0
D & N HAVELI,2003,THEFTS,0,0,0,0,0,0,0,0,0,0,0,0,0,0,0
D & N HAVELI,2003,EXTORTION,0,0,0,0,0,0,0,0,0,0,0,0,0,0,0
D & N HAVELI,2003,RIOTS,0,0,0,0,0,0,0,0,0,0,0,0,0,0,0
D & N HAVELI,2003,ARSON,0,0,0,0,0,0,0,0,0,0,0,0,0,0,0
D & N HAVELI,2003,CRIMINAL BREACH OF TRUST,0,0,0,0,0,0,0,0,0,0,0,0,0,0,0
D & N HAVELI,2003,CHEATING,0,0,0,0,0,0,0,0,0,0,0,0,0,0,0
D & N HAVELI,2003,COUNTER FEITING,0,0,0,0,0,0,0,0,0,0,0,0,0,0,0
D & N HAVELI,2003,DOWRY DEATHS,0,0,0,0,0,0,0,0,0,0,0,0,0,0,0
D & N HAVELI,2003,MOLESTATION,0,0,0,0,0,0,0,0,0,0,0,0,0,0,0
D & N HAVELI,2003,EVE-TEASING,0,0,0,0,0,0,0,0,0,0,0,0,0,0,0
D & N HAVELI,2003,CRUELTY BY HUSBAND OR RELATIVE OF HUSBAND,0,0,0,0,0,0,0,0,0,0,0,0,0,0,0
D & N HAVELI,2003,OTHER IPC CRIMES,0,0,0,0,0,0,0,0,0,0,0,0,0,0,0
D & N HAVELI,2003,TOTAL IPC,0,0,0,0,0,0,0,0,0,0,0,0,0,0,0
D & N HAVELI,2004,MURDER,0,0,0,0,0,0,0,0,0,0,0,0,0,0,0
D & N HAVELI,2004,ATTEMPT TO COMMIT MURDER,0,0,0,0,0,0,0,0,0,0,0,0,0,0,0
D & N HAVELI,2004,C.H. NOT AMOUNTING TO MURDER,0,0,0,0,0,0,0,0,0,0,0,0,0,0,0
D & N HAVELI,2004,RAPE,0,0,0,0,0,0,0,0,0,0,0,0,0,0,0
D & N HAVELI,2004,KIDNAPPING AND ABDUCTION,0,0,0,0,0,0,0,0,0,0,0,0,0,0,0
D & N HAVELI,2004,DACOITY,0,0,0,0,0,0,0,0,0,0,0,0,0,0,0
D & N HAVELI,2004,PREP. AND ASSEMBLY FOR DACOITY,0,0,0,0,0,0,0,0,0,0,0,0,0,0,0
D & N HAVELI,2004,ROBBERY,0,0,0,0,0,0,0,0,0,0,0,0,0,0,0
D & N HAVELI,2004,BURGLARY,0,0,0,0,0,0,0,0,0,0,0,0,0,0,0
D & N HAVELI,2004,THEFTS,0,0,0,0,0,0,0,0,0,0,0,0,0,0,0
D & N HAVELI,2004,EXTORTION,0,0,0,0,0,0,0,0,0,0,0,0,0,0,0
D & N HAVELI,2004,RIOTS,0,0,0,0,0,0,0,0,0,0,0,0,0,0,0
D & N HAVELI,2004,ARSON,0,0,0,0,0,0,0,0,0,0,0,0,0,0,0
D & N HAVELI,2004,CRIMINAL BREACH OF TRUST,0,0,0,0,0,0,0,0,0,0,0,0,0,0,0
D & N HAVELI,2004,CHEATING,0,0,0,0,0,0,0,0,0,0,0,0,0,0,0
D & N HAVELI,2004,COUNTER FEITING,0,0,0,0,0,0,0,0,0,0,0,0,0,0,0
D & N HAVELI,2004,DOWRY DEATHS,0,0,0,0,0,0,0,0,0,0,0,0,0,0,0
D & N HAVELI,2004,MOLESTATION,0,0,0,0,0,0,0,0,0,0,0,0,0,0,0
D & N HAVELI,2004,EVE-TEASING,0,0,0,0,0,0,0,0,0,0,0,0,0,0,0
D & N HAVELI,2004,CRUELTY BY HUSBAND OR RELATIVE OF HUSBAND,0,0,0,0,0,0,0,0,0,0,0,0,0,0,0
D & N HAVELI,2004,OTHER IPC CRIMES,0,0,0,0,0,0,0,0,0,0,0,0,0,0,0
D & N HAVELI,2004,TOTAL IPC,0,0,0,0,0,0,0,0,0,0,0,0,0,0,0
D & N HAVELI,2005,MURDER,0,0,0,0,0,0,0,0,0,0,0,0,0,0,0
D & N HAVELI,2005,ATTEMPT TO COMMIT MURDER,0,0,0,0,0,0,0,0,0,0,0,0,0,0,0
D & N HAVELI,2005,C.H. NOT AMOUNTING TO MURDER,0,0,0,0,0,0,0,0,0,0,0,0,0,0,0
D & N HAVELI,2005,RAPE,0,0,0,0,0,0,0,0,0,0,0,0,0,0,0
D & N HAVELI,2005,KIDNAPPING AND ABDUCTION,0,0,0,0,0,0,0,0,0,0,0,0,0,0,0
D & N HAVELI,2005,DACOITY,0,0,0,0,0,0,0,0,0,0,0,0,0,0,0
D & N HAVELI,2005,PREP. AND ASSEMBLY FOR DACOITY,0,0,0,0,0,0,0,0,0,0,0,0,0,0,0
D & N HAVELI,2005,ROBBERY,0,0,0,0,0,0,0,0,0,0,0,0,0,0,0
D & N HAVELI,2005,BURGLARY,0,0,0,0,0,0,0,0,0,0,0,0,0,0,0
D & N HAVELI,2005,THEFTS,0,0,0,0,0,0,0,0,0,0,0,0,0,0,0
D & N HAVELI,2005,EXTORTION,0,0,0,0,0,0,0,0,0,0,0,0,0,0,0
D & N HAVELI,2005,RIOTS,0,0,0,0,0,0,0,0,0,0,0,0,0,0,0
D & N HAVELI,2005,ARSON,0,0,0,0,0,0,0,0,0,0,0,0,0,0,0
D & N HAVELI,2005,CRIMINAL BREACH OF TRUST,0,0,0,0,0,0,0,0,0,0,0,0,0,0,0
D & N HAVELI,2005,CHEATING,0,0,0,0,0,0,0,0,0,0,0,0,0,0,0
D & N HAVELI,2005,COUNTER FEITING,0,0,0,0,0,0,0,0,0,0,0,0,0,0,0
D & N HAVELI,2005,DOWRY DEATHS,0,0,0,0,0,0,0,0,0,0,0,0,0,0,0
D & N HAVELI,2005,MOLESTATION,0,0,0,0,0,0,0,0,0,0,0,0,0,0,0
D & N HAVELI,2005,EVE-TEASING,0,0,0,0,0,0,0,0,0,0,0,0,0,0,0
D & N HAVELI,2005,CRUELTY BY HUSBAND OR RELATIVE OF HUSBAND,0,0,0,0,0,0,0,0,0,0,0,0,0,0,0
D & N HAVELI,2005,OTHER IPC CRIMES,0,0,0,0,0,0,0,0,0,0,0,0,0,0,0
D & N HAVELI,2005,TOTAL IPC,0,0,0,0,0,0,0,0,0,0,0,0,0,0,0
D & N HAVELI,2006,MURDER,0,0,0,0,0,0,0,0,0,0,0,0,0,0,0
D & N HAVELI,2006,ATTEMPT TO COMMIT MURDER,0,0,0,0,0,0,0,0,0,0,0,0,0,0,0
D & N HAVELI,2006,C.H. NOT AMOUNTING TO MURDER,0,0,0,0,0,0,0,0,0,0,0,0,0,0,0
D & N HAVELI,2006,RAPE,0,0,0,0,0,0,0,0,0,0,0,0,0,0,0
D & N HAVELI,2006,KIDNAPPING AND ABDUCTION,0,0,0,0,0,0,0,0,0,0,0,0,0,0,0
D & N HAVELI,2006,DACOITY,0,0,0,0,0,0,0,0,0,0,0,0,0,0,0
D & N HAVELI,2006,PREP. AND ASSEMBLY FOR DACOITY,0,0,0,0,0,0,0,0,0,0,0,0,0,0,0
D & N HAVELI,2006,ROBBERY,0,0,0,0,0,0,0,0,0,0,0,0,0,0,0
D & N HAVELI,2006,BURGLARY,0,0,0,0,0,0,0,0,0,0,0,0,0,0,0
D & N HAVELI,2006,THEFTS,0,0,0,0,0,0,0,0,0,0,0,0,0,0,0
D & N HAVELI,2006,EXTORTION,0,0,0,0,0,0,0,0,0,0,0,0,0,0,0
D & N HAVELI,2006,RIOTS,0,0,0,0,0,0,0,0,0,0,0,0,0,0,0
D & N HAVELI,2006,ARSON,0,0,0,0,0,0,0,0,0,0,0,0,0,0,0
D & N HAVELI,2006,CRIMINAL BREACH OF TRUST,0,0,0,0,0,0,0,0,0,0,0,0,0,0,0
D & N HAVELI,2006,CHEATING,0,0,0,0,0,0,0,0,0,0,0,0,0,0,0
D & N HAVELI,2006,COUNTER FEITING,0,0,0,0,0,0,0,0,0,0,0,0,0,0,0
D & N HAVELI,2006,DOWRY DEATHS,0,0,0,0,0,0,0,0,0,0,0,0,0,0,0
D & N HAVELI,2006,MOLESTATION,0,0,0,0,0,0,0,0,0,0,0,0,0,0,0
D & N HAVELI,2006,EVE-TEASING,0,0,0,0,0,0,0,0,0,0,0,0,0,0,0
D & N HAVELI,2006,CRUELTY BY HUSBAND OR RELATIVE OF HUSBAND,0,0,0,0,0,0,0,0,0,0,0,0,0,0,0
D & N HAVELI,2006,OTHER IPC CRIMES,0,0,0,0,0,0,0,0,0,0,0,0,0,0,0
D & N HAVELI,2006,TOTAL IPC,0,0,0,0,0,0,0,0,0,0,0,0,0,0,0
D & N HAVELI,2007,MURDER,0,0,0,0,0,0,0,0,0,0,0,0,0,0,0
D & N HAVELI,2007,ATTEMPT TO COMMIT MURDER,0,0,0,0,0,0,0,0,0,0,0,0,0,0,0
D & N HAVELI,2007,C.H. NOT AMOUNTING TO MURDER,0,0,0,0,0,0,0,0,0,0,0,0,0,0,0
D & N HAVELI,2007,RAPE,0,0,0,0,0,0,0,0,0,0,0,0,0,0,0
D & N HAVELI,2007,KIDNAPPING AND ABDUCTION,0,0,0,0,0,0,0,0,0,0,0,0,0,0,0
D & N HAVELI,2007,DACOITY,0,0,0,0,0,0,0,0,0,0,0,0,0,0,0
D & N HAVELI,2007,PREP. AND ASSEMBLY FOR DACOITY,0,0,0,0,0,0,0,0,0,0,0,0,0,0,0
D & N HAVELI,2007,ROBBERY,0,0,0,0,0,0,0,0,0,0,0,0,0,0,0
D & N HAVELI,2007,BURGLARY,0,0,0,0,0,0,0,0,0,0,0,0,0,0,0
D & N HAVELI,2007,THEFTS,0,0,0,0,0,0,0,0,0,0,0,0,0,0,0
D & N HAVELI,2007,EXTORTION,0,0,0,0,0,0,0,0,0,0,0,0,0,0,0
D & N HAVELI,2007,RIOTS,0,0,0,0,0,0,0,0,0,0,0,0,0,0,0
D & N HAVELI,2007,ARSON,0,0,0,0,0,0,0,0,0,0,0,0,0,0,0
D & N HAVELI,2007,CRIMINAL BREACH OF TRUST,0,0,0,0,0,0,0,0,0,0,0,0,0,0,0
D & N HAVELI,2007,CHEATING,0,0,0,0,0,0,0,0,0,0,0,0,0,0,0
D & N HAVELI,2007,COUNTER FEITING,0,0,0,0,0,0,0,0,0,0,0,0,0,0,0
D & N HAVELI,2007,DOWRY DEATHS,0,0,0,0,0,0,0,0,0,0,0,0,0,0,0
D & N HAVELI,2007,MOLESTATION,0,0,0,0,0,0,0,0,0,0,0,0,0,0,0
D & N HAVELI,2007,EVE-TEASING,0,0,0,0,0,0,0,0,0,0,0,0,0,0,0
D & N HAVELI,2007,CRUELTY BY HUSBAND OR RELATIVE OF HUSBAND,0,0,0,0,0,0,0,0,0,0,0,0,0,0,0
D & N HAVELI,2007,OTHER IPC CRIMES,0,0,0,0,0,0,0,0,0,0,0,0,0,0,0
D & N HAVELI,2007,TOTAL IPC,0,0,0,0,0,0,0,0,0,0,0,0,0,0,0
D & N HAVELI,2008,MURDER,0,0,0,2,0,2,1,0,1,0,0,0,3,0,3
D & N HAVELI,2008,ATTEMPT TO COMMIT MURDER,0,0,0,1,0,1,0,0,0,0,0,0,1,0,1
D & N HAVELI,2008,C.H. NOT AMOUNTING TO MURDER,0,0,0,0,0,0,0,0,0,0,0,0,0,0,0
D & N HAVELI,2008,RAPE,0,0,0,1,0,1,0,0,0,0,0,0,1,0,1
D & N HAVELI,2008,KIDNAPPING AND ABDUCTION,0,0,0,1,0,1,0,0,0,0,0,0,1,0,1
D & N HAVELI,2008,DACOITY,0,0,0,2,0,2,0,0,0,0,0,0,2,0,2
D & N HAVELI,2008,PREP. AND ASSEMBLY FOR DACOITY,0,0,0,0,0,0,0,0,0,0,0,0,0,0,0
D & N HAVELI,2008,ROBBERY,0,0,0,0,0,0,0,0,0,0,0,0,0,0,0
D & N HAVELI,2008,BURGLARY,0,0,0,0,0,0,0,0,0,0,0,0,0,0,0
D & N HAVELI,2008,THEFTS,0,0,0,1,0,1,0,0,0,0,0,0,1,0,1
D & N HAVELI,2008,EXTORTION,0,0,0,0,0,0,0,0,0,0,0,0,0,0,0
D & N HAVELI,2008,RIOTS,0,0,0,0,0,0,0,0,0,0,0,0,0,0,0
D & N HAVELI,2008,ARSON,0,0,0,0,0,0,0,0,0,0,0,0,0,0,0
D & N HAVELI,2008,CRIMINAL BREACH OF TRUST,0,0,0,0,0,0,0,0,0,0,0,0,0,0,0
D & N HAVELI,2008,CHEATING,0,0,0,0,0,0,0,0,0,0,0,0,0,0,0
D & N HAVELI,2008,COUNTER FEITING,0,0,0,0,0,0,0,0,0,0,0,0,0,0,0
D & N HAVELI,2008,DOWRY DEATHS,0,0,0,0,0,0,0,0,0,0,0,0,0,0,0
D & N HAVELI,2008,MOLESTATION,0,0,0,0,0,0,0,0,0,0,0,0,0,0,0
D & N HAVELI,2008,EVE-TEASING,0,0,0,0,0,0,0,0,0,0,0,0,0,0,0
D & N HAVELI,2008,CRUELTY BY HUSBAND OR RELATIVE OF HUSBAND,0,0,0,0,0,0,0,0,0,0,0,0,0,0,0
D & N HAVELI,2008,OTHER IPC CRIMES,0,0,0,0,0,0,0,0,0,0,0,0,0,0,0
D & N HAVELI,2008,TOTAL IPC,0,0,0,8,0,8,1,0,1,0,0,0,9,0,9
D & N HAVELI,2009,MURDER,0,0,0,0,0,0,0,0,0,0,0,0,0,0,0
D & N HAVELI,2009,ATTEMPT TO COMMIT MURDER,0,0,0,0,0,0,0,0,0,0,0,0,0,0,0
D & N HAVELI,2009,C.H. NOT AMOUNTING TO MURDER,0,0,0,1,0,1,0,0,0,0,0,0,1,0,1
D & N HAVELI,2009,RAPE,0,0,0,0,0,0,0,0,0,0,0,0,0,0,0
D & N HAVELI,2009,KIDNAPPING AND ABDUCTION,0,0,0,0,0,0,0,0,0,0,0,0,0,0,0
D & N HAVELI,2009,DACOITY,0,0,0,0,0,0,0,0,0,0,0,0,0,0,0
D & N HAVELI,2009,PREP. AND ASSEMBLY FOR DACOITY,0,0,0,0,0,0,0,0,0,0,0,0,0,0,0
D & N HAVELI,2009,ROBBERY,0,0,0,0,0,0,0,0,0,0,0,0,0,0,0
D & N HAVELI,2009,BURGLARY,0,0,0,0,0,0,0,0,0,0,0,0,0,0,0
D & N HAVELI,2009,THEFTS,0,0,0,0,0,0,0,0,0,0,0,0,0,0,0
D & N HAVELI,2009,EXTORTION,0,0,0,0,0,0,0,0,0,0,0,0,0,0,0
D & N HAVELI,2009,RIOTS,0,0,0,0,0,0,0,0,0,0,0,0,0,0,0
D & N HAVELI,2009,ARSON,0,0,0,0,0,0,0,0,0,0,0,0,0,0,0
D & N HAVELI,2009,CRIMINAL BREACH OF TRUST,0,0,0,0,0,0,0,0,0,0,0,0,0,0,0
D & N HAVELI,2009,CHEATING,0,0,0,0,0,0,0,0,0,0,0,0,0,0,0
D & N HAVELI,2009,COUNTER FEITING,0,0,0,0,0,0,0,0,0,0,0,0,0,0,0
D & N HAVELI,2009,DOWRY DEATHS,0,0,0,0,0,0,0,0,0,0,0,0,0,0,0
D & N HAVELI,2009,MOLESTATION,0,0,0,0,0,0,0,0,0,0,0,0,0,0,0
D & N HAVELI,2009,EVE-TEASING,0,0,0,0,0,0,0,0,0,0,0,0,0,0,0
D & N HAVELI,2009,CRUELTY BY HUSBAND OR RELATIVE OF HUSBAND,0,0,0,0,0,0,0,0,0,0,0,0,0,0,0
D & N HAVELI,2009,OTHER IPC CRIMES,0,0,0,0,0,0,0,0,0,0,0,0,0,0,0
D & N HAVELI,2009,TOTAL IPC,0,0,0,1,0,1,0,0,0,0,0,0,1,0,1
D & N HAVELI,2010,MURDER,0,0,0,0,0,0,0,0,0,0,0,0,0,0,0
D & N HAVELI,2010,ATTEMPT TO COMMIT MURDER,0,0,0,0,0,0,0,0,0,0,0,0,0,0,0
D & N HAVELI,2010,C.H. NOT AMOUNTING TO MURDER,0,0,0,0,0,0,0,0,0,0,0,0,0,0,0
D & N HAVELI,2010,RAPE,0,0,0,0,0,0,0,0,0,0,0,0,0,0,0
D & N HAVELI,2010,KIDNAPPING AND ABDUCTION,0,0,0,0,0,0,0,0,0,0,0,0,0,0,0
D & N HAVELI,2010,DACOITY,0,0,0,0,0,0,0,0,0,0,0,0,0,0,0
D & N HAVELI,2010,PREP. AND ASSEMBLY FOR DACOITY,0,0,0,0,0,0,0,0,0,0,0,0,0,0,0
D & N HAVELI,2010,ROBBERY,0,0,0,0,0,0,0,0,0,0,0,0,0,0,0
D & N HAVELI,2010,BURGLARY,0,0,0,0,0,0,0,0,0,0,0,0,0,0,0
D & N HAVELI,2010,THEFTS,0,0,0,0,0,0,0,0,0,0,0,0,0,0,0
D & N HAVELI,2010,EXTORTION,0,0,0,0,0,0,0,0,0,0,0,0,0,0,0
D & N HAVELI,2010,RIOTS,0,0,0,0,0,0,0,0,0,0,0,0,0,0,0
D & N HAVELI,2010,ARSON,0,0,0,0,0,0,0,0,0,0,0,0,0,0,0
D & N HAVELI,2010,CRIMINAL BREACH OF TRUST,0,0,0,0,0,0,0,0,0,0,0,0,0,0,0
D & N HAVELI,2010,CHEATING,0,0,0,0,0,0,0,0,0,0,0,0,0,0,0
D & N HAVELI,2010,COUNTER FEITING,0,0,0,0,0,0,0,0,0,0,0,0,0,0,0
D & N HAVELI,2010,DOWRY DEATHS,0,0,0,0,0,0,0,0,0,0,0,0,0,0,0
D & N HAVELI,2010,MOLESTATION,0,0,0,0,0,0,0,0,0,0,0,0,0,0,0
D & N HAVELI,2010,EVE-TEASING,0,0,0,0,0,0,0,0,0,0,0,0,0,0,0
D & N HAVELI,2010,CRUELTY BY HUSBAND OR RELATIVE OF HUSBAND,0,0,0,0,0,0,0,0,0,0,0,0,0,0,0
D & N HAVELI,2010,OTHER IPC CRIMES,0,0,0,0,0,0,0,0,0,0,0,0,0,0,0
D & N HAVELI,2010,TOTAL IPC,0,0,0,0,0,0,0,0,0,0,0,0,0,0,0
D & N HAVELI,2011,MURDER,0,0,0,0,0,0,0,0,0,0,0,0,0,0,0
D & N HAVELI,2011,ATTEMPT TO COMMIT MURDER,0,0,0,0,0,0,0,0,0,0,0,0,0,0,0
D & N HAVELI,2011,C.H. NOT AMOUNTING TO MURDER,0,0,0,0,0,0,0,0,0,0,0,0,0,0,0
D & N HAVELI,2011,RAPE,0,0,0,0,0,0,0,0,0,0,0,0,0,0,0
D & N HAVELI,2011,KIDNAPPING AND ABDUCTION,0,0,0,0,0,0,0,0,0,0,0,0,0,0,0
D & N HAVELI,2011,DACOITY,0,0,0,0,0,0,0,0,0,0,0,0,0,0,0
D & N HAVELI,2011,PREP. AND ASSEMBLY FOR DACOITY,0,0,0,0,0,0,0,0,0,0,0,0,0,0,0
D & N HAVELI,2011,ROBBERY,0,0,0,0,0,0,0,0,0,0,0,0,0,0,0
D & N HAVELI,2011,BURGLARY,0,0,0,0,0,0,0,0,0,0,0,0,0,0,0
D & N HAVELI,2011,THEFTS,0,0,0,0,0,0,0,0,0,0,0,0,0,0,0
D & N HAVELI,2011,EXTORTION,0,0,0,0,0,0,0,0,0,0,0,0,0,0,0
D & N HAVELI,2011,RIOTS,0,0,0,0,0,0,0,0,0,0,0,0,0,0,0
D & N HAVELI,2011,ARSON,0,0,0,0,0,0,0,0,0,0,0,0,0,0,0
D & N HAVELI,2011,CRIMINAL BREACH OF TRUST,0,0,0,0,0,0,0,0,0,0,0,0,0,0,0
D & N HAVELI,2011,CHEATING,0,0,0,0,0,0,0,0,0,0,0,0,0,0,0
D & N HAVELI,2011,COUNTER FEITING,0,0,0,0,0,0,0,0,0,0,0,0,0,0,0
D & N HAVELI,2011,DOWRY DEATHS,0,0,0,0,0,0,0,0,0,0,0,0,0,0,0
D & N HAVELI,2011,MOLESTATION,0,0,0,0,0,0,0,0,0,0,0,0,0,0,0
D & N HAVELI,2011,EVE-TEASING,0,0,0,0,0,0,0,0,0,0,0,0,0,0,0
D & N HAVELI,2011,CRUELTY BY HUSBAND OR RELATIVE OF HUSBAND,0,0,0,0,0,0,0,0,0,0,0,0,0,0,0
D & N HAVELI,2011,OTHER IPC CRIMES,0,0,0,0,0,0,0,0,0,0,0,0,0,0,0
D & N HAVELI,2011,TOTAL IPC,0,0,0,0,0,0,0,0,0,0,0,0,0,0,0
D & N HAVELI,2012,MURDER,0,0,0,0,0,0,0,0,0,0,0,0,0,0,0
D & N HAVELI,2012,ATTEMPT TO COMMIT MURDER,0,0,0,0,0,0,0,0,0,0,0,0,0,0,0
D & N HAVELI,2012,C.H. NOT AMOUNTING TO MURDER,0,0,0,0,0,0,0,0,0,0,0,0,0,0,0
D & N HAVELI,2012,RAPE,0,0,0,0,0,0,0,0,0,0,0,0,0,0,0
D & N HAVELI,2012,KIDNAPPING AND ABDUCTION,0,0,0,0,0,0,0,0,0,0,0,0,0,0,0
D & N HAVELI,2012,DACOITY,0,0,0,0,0,0,0,0,0,0,0,0,0,0,0
D & N HAVELI,2012,PREP. AND ASSEMBLY FOR DACOITY,0,0,0,0,0,0,0,0,0,0,0,0,0,0,0
D & N HAVELI,2012,ROBBERY,0,0,0,0,0,0,0,0,0,0,0,0,0,0,0
D & N HAVELI,2012,BURGLARY,0,0,0,0,0,0,0,0,0,0,0,0,0,0,0
D & N HAVELI,2012,THEFTS,0,0,0,0,0,0,0,0,0,0,0,0,0,0,0
D & N HAVELI,2012,EXTORTION,0,0,0,0,0,0,0,0,0,0,0,0,0,0,0
D & N HAVELI,2012,RIOTS,0,0,0,0,0,0,0,0,0,0,0,0,0,0,0
D & N HAVELI,2012,ARSON,0,0,0,0,0,0,0,0,0,0,0,0,0,0,0
D & N HAVELI,2012,CRIMINAL BREACH OF TRUST,0,0,0,0,0,0,0,0,0,0,0,0,0,0,0
D & N HAVELI,2012,CHEATING,0,0,0,0,0,0,0,0,0,0,0,0,0,0,0
D & N HAVELI,2012,COUNTER FEITING,0,0,0,0,0,0,0,0,0,0,0,0,0,0,0
D & N HAVELI,2012,DOWRY DEATHS,0,0,0,0,0,0,0,0,0,0,0,0,0,0,0
D & N HAVELI,2012,MOLESTATION,0,0,0,0,0,0,0,0,0,0,0,0,0,0,0
D & N HAVELI,2012,EVE-TEASING,0,0,0,0,0,0,0,0,0,0,0,0,0,0,0
D & N HAVELI,2012,CRUELTY BY HUSBAND OR RELATIVE OF HUSBAND,0,0,0,0,0,0,0,0,0,0,0,0,0,0,0
D & N HAVELI,2012,OTHER IPC CRIMES,0,0,0,0,0,0,0,0,0,0,0,0,0,0,0
D & N HAVELI,2012,TOTAL IPC,0,0,0,0,0,0,0,0,0,0,0,0,0,0,0
DAMAN & DIU,2001,MURDER,0,0,0,0,0,0,9,0,9,3,0,3,12,0,12
DAMAN & DIU,2001,ATTEMPT TO COMMIT MURDER,0,0,0,0,0,0,0,0,0,0,0,0,0,0,0
DAMAN & DIU,2001,C.H. NOT AMOUNTING TO MURDER,0,0,0,0,0,0,0,0,0,0,0,0,0,0,0
DAMAN & DIU,2001,RAPE,0,0,0,0,0,0,0,0,0,0,0,0,0,0,0
DAMAN & DIU,2001,KIDNAPPING AND ABDUCTION,0,0,0,0,0,0,0,0,0,0,0,0,0,0,0
DAMAN & DIU,2001,DACOITY,0,0,0,0,0,0,0,0,0,0,0,0,0,0,0
DAMAN & DIU,2001,PREP. AND ASSEMBLY FOR DACOITY,0,0,0,0,0,0,0,0,0,0,0,0,0,0,0
DAMAN & DIU,2001,ROBBERY,0,0,0,8,0,8,0,0,0,0,0,0,8,0,8
DAMAN & DIU,2001,BURGLARY,0,0,0,0,0,0,0,0,0,0,0,0,0,0,0
DAMAN & DIU,2001,THEFTS,0,0,0,0,0,0,3,0,3,0,0,0,3,0,3
DAMAN & DIU,2001,EXTORTION,0,0,0,0,0,0,0,0,0,0,0,0,0,0,0
DAMAN & DIU,2001,RIOTS,0,0,0,0,0,0,0,0,0,0,0,0,0,0,0
DAMAN & DIU,2001,ARSON,0,0,0,0,0,0,0,0,0,0,0,0,0,0,0
DAMAN & DIU,2001,CRIMINAL BREACH OF TRUST,0,0,0,0,0,0,0,0,0,0,0,0,0,0,0
DAMAN & DIU,2001,CHEATING,0,0,0,0,0,0,0,0,0,0,0,0,0,0,0
DAMAN & DIU,2001,COUNTER FEITING,0,0,0,0,0,0,0,0,0,0,0,0,0,0,0
DAMAN & DIU,2001,DOWRY DEATHS,0,0,0,0,0,0,0,0,0,0,0,0,0,0,0
DAMAN & DIU,2001,MOLESTATION,0,0,0,0,0,0,0,0,0,0,0,0,0,0,0
DAMAN & DIU,2001,EVE-TEASING,0,0,0,0,0,0,0,0,0,0,0,0,0,0,0
DAMAN & DIU,2001,CRUELTY BY HUSBAND OR RELATIVE OF HUSBAND,0,0,0,0,0,0,0,0,0,0,0,0,0,0,0
DAMAN & DIU,2001,OTHER IPC CRIMES,0,0,0,0,0,0,0,0,0,0,0,0,0,0,0
DAMAN & DIU,2001,TOTAL IPC,0,0,0,8,0,8,12,0,12,3,0,3,23,0,23
DAMAN & DIU,2002,MURDER,0,0,0,1,0,1,8,0,8,2,0,2,11,0,11
DAMAN & DIU,2002,ATTEMPT TO COMMIT MURDER,0,0,0,0,0,0,0,0,0,0,0,0,0,0,0
DAMAN & DIU,2002,C.H. NOT AMOUNTING TO MURDER,0,0,0,0,0,0,1,0,1,0,0,0,1,0,1
DAMAN & DIU,2002,RAPE,0,0,0,0,0,0,0,0,0,0,0,0,0,0,0
DAMAN & DIU,2002,KIDNAPPING AND ABDUCTION,0,0,0,0,0,0,0,0,0,0,0,0,0,0,0
DAMAN & DIU,2002,DACOITY,0,0,0,0,0,0,0,0,0,0,0,0,0,0,0
DAMAN & DIU,2002,PREP. AND ASSEMBLY FOR DACOITY,0,0,0,0,0,0,0,0,0,0,0,0,0,0,0
DAMAN & DIU,2002,ROBBERY,0,0,0,0,0,0,0,0,0,0,0,0,0,0,0
DAMAN & DIU,2002,BURGLARY,0,0,0,0,0,0,0,0,0,0,0,0,0,0,0
DAMAN & DIU,2002,THEFTS,0,0,0,0,0,0,1,0,1,0,0,0,1,0,1
DAMAN & DIU,2002,EXTORTION,0,0,0,0,0,0,0,0,0,0,0,0,0,0,0
DAMAN & DIU,2002,RIOTS,0,0,0,0,0,0,0,0,0,0,0,0,0,0,0
DAMAN & DIU,2002,ARSON,0,0,0,0,0,0,0,0,0,0,0,0,0,0,0
DAMAN & DIU,2002,CRIMINAL BREACH OF TRUST,0,0,0,0,0,0,0,0,0,0,0,0,0,0,0
DAMAN & DIU,2002,CHEATING,0,0,0,0,0,0,0,0,0,0,0,0,0,0,0
DAMAN & DIU,2002,COUNTER FEITING,0,0,0,0,0,0,0,0,0,0,0,0,0,0,0
DAMAN & DIU,2002,DOWRY DEATHS,0,0,0,0,0,0,0,0,0,0,0,0,0,0,0
DAMAN & DIU,2002,MOLESTATION,0,0,0,0,0,0,0,0,0,0,0,0,0,0,0
DAMAN & DIU,2002,EVE-TEASING,0,0,0,0,0,0,0,0,0,0,0,0,0,0,0
DAMAN & DIU,2002,CRUELTY BY HUSBAND OR RELATIVE OF HUSBAND,0,0,0,0,0,0,0,0,0,0,0,0,0,0,0
DAMAN & DIU,2002,OTHER IPC CRIMES,0,0,0,0,0,0,0,0,0,0,0,0,0,0,0
DAMAN & DIU,2002,TOTAL IPC,0,0,0,1,0,1,10,0,10,2,0,2,13,0,13
DAMAN & DIU,2003,MURDER,0,0,0,0,0,0,13,0,13,0,0,0,13,0,13
DAMAN & DIU,2003,ATTEMPT TO COMMIT MURDER,0,0,0,0,0,0,0,0,0,0,0,0,0,0,0
DAMAN & DIU,2003,C.H. NOT AMOUNTING TO MURDER,0,0,0,0,0,0,0,0,0,0,0,0,0,0,0
DAMAN & DIU,2003,RAPE,0,0,0,0,0,0,0,0,0,0,0,0,0,0,0
DAMAN & DIU,2003,KIDNAPPING AND ABDUCTION,0,0,0,0,0,0,0,0,0,0,0,0,0,0,0
DAMAN & DIU,2003,DACOITY,0,0,0,0,0,0,0,0,0,0,0,0,0,0,0
DAMAN & DIU,2003,PREP. AND ASSEMBLY FOR DACOITY,0,0,0,0,0,0,0,0,0,0,0,0,0,0,0
DAMAN & DIU,2003,ROBBERY,0,0,0,0,0,0,0,0,0,0,0,0,0,0,0
DAMAN & DIU,2003,BURGLARY,0,0,0,0,0,0,0,0,0,0,0,0,0,0,0
DAMAN & DIU,2003,THEFTS,0,0,0,0,0,0,0,0,0,0,0,0,0,0,0
DAMAN & DIU,2003,EXTORTION,0,0,0,0,0,0,0,0,0,0,0,0,0,0,0
DAMAN & DIU,2003,RIOTS,0,0,0,0,0,0,0,0,0,0,0,0,0,0,0
DAMAN & DIU,2003,ARSON,0,0,0,0,0,0,0,0,0,0,0,0,0,0,0
DAMAN & DIU,2003,CRIMINAL BREACH OF TRUST,0,0,0,0,0,0,0,0,0,0,0,0,0,0,0
DAMAN & DIU,2003,CHEATING,0,0,0,0,0,0,0,0,0,0,0,0,0,0,0
DAMAN & DIU,2003,COUNTER FEITING,0,0,0,0,0,0,0,0,0,0,0,0,0,0,0
DAMAN & DIU,2003,DOWRY DEATHS,0,0,0,0,0,0,0,0,0,0,0,0,0,0,0
DAMAN & DIU,2003,MOLESTATION,0,0,0,0,0,0,0,0,0,0,0,0,0,0,0
DAMAN & DIU,2003,EVE-TEASING,0,0,0,0,0,0,0,0,0,0,0,0,0,0,0
DAMAN & DIU,2003,CRUELTY BY HUSBAND OR RELATIVE OF HUSBAND,0,0,0,0,0,0,0,0,0,0,0,0,0,0,0
DAMAN & DIU,2003,OTHER IPC CRIMES,0,0,0,0,0,0,0,0,0,0,0,0,0,0,0
DAMAN & DIU,2003,TOTAL IPC,0,0,0,0,0,0,13,0,13,0,0,0,13,0,13
DAMAN & DIU,2004,MURDER,0,0,0,0,0,0,6,0,6,2,0,2,8,0,8
DAMAN & DIU,2004,ATTEMPT TO COMMIT MURDER,0,0,0,0,0,0,0,0,0,0,0,0,0,0,0
DAMAN & DIU,2004,C.H. NOT AMOUNTING TO MURDER,0,0,0,0,0,0,0,0,0,0,0,0,0,0,0
DAMAN & DIU,2004,RAPE,0,0,0,0,0,0,0,0,0,0,0,0,0,0,0
DAMAN & DIU,2004,KIDNAPPING AND ABDUCTION,0,0,0,0,0,0,0,0,0,0,0,0,0,0,0
DAMAN & DIU,2004,DACOITY,0,0,0,0,0,0,0,0,0,0,0,0,0,0,0
DAMAN & DIU,2004,PREP. AND ASSEMBLY FOR DACOITY,0,0,0,0,0,0,0,0,0,0,0,0,0,0,0
DAMAN & DIU,2004,ROBBERY,0,0,0,0,0,0,0,0,0,0,0,0,0,0,0
DAMAN & DIU,2004,BURGLARY,0,0,0,0,0,0,0,0,0,0,0,0,0,0,0
DAMAN & DIU,2004,THEFTS,0,0,0,0,0,0,0,0,0,0,0,0,0,0,0
DAMAN & DIU,2004,EXTORTION,0,0,0,0,0,0,0,0,0,0,0,0,0,0,0
DAMAN & DIU,2004,RIOTS,0,0,0,0,0,0,0,0,0,0,0,0,0,0,0
DAMAN & DIU,2004,ARSON,0,0,0,0,0,0,0,0,0,0,0,0,0,0,0
DAMAN & DIU,2004,CRIMINAL BREACH OF TRUST,0,0,0,0,0,0,0,0,0,0,0,0,0,0,0
DAMAN & DIU,2004,CHEATING,0,0,0,0,0,0,0,0,0,0,0,0,0,0,0
DAMAN & DIU,2004,COUNTER FEITING,0,0,0,0,0,0,0,0,0,0,0,0,0,0,0
DAMAN & DIU,2004,DOWRY DEATHS,0,0,0,0,0,0,0,0,0,0,0,0,0,0,0
DAMAN & DIU,2004,MOLESTATION,0,0,0,0,0,0,0,0,0,0,0,0,0,0,0
DAMAN & DIU,2004,EVE-TEASING,0,0,0,0,0,0,0,0,0,0,0,0,0,0,0
DAMAN & DIU,2004,CRUELTY BY HUSBAND OR RELATIVE OF HUSBAND,0,0,0,0,0,0,0,0,0,0,0,0,0,0,0
DAMAN & DIU,2004,OTHER IPC CRIMES,0,0,0,0,0,0,0,0,0,0,0,0,0,0,0
DAMAN & DIU,2004,TOTAL IPC,0,0,0,0,0,0,6,0,6,2,0,2,8,0,8
DAMAN & DIU,2005,MURDER,0,0,0,0,0,0,7,0,7,3,0,3,10,0,10
DAMAN & DIU,2005,ATTEMPT TO COMMIT MURDER,0,0,0,1,0,1,0,0,0,0,0,0,1,0,1
DAMAN & DIU,2005,C.H. NOT AMOUNTING TO MURDER,0,0,0,0,0,0,0,0,0,0,0,0,0,0,0
DAMAN & DIU,2005,RAPE,0,0,0,0,0,0,0,0,0,0,0,0,0,0,0
DAMAN & DIU,2005,KIDNAPPING AND ABDUCTION,0,0,0,0,0,0,0,0,0,0,0,0,0,0,0
DAMAN & DIU,2005,DACOITY,0,0,0,0,0,0,0,0,0,0,0,0,0,0,0
DAMAN & DIU,2005,PREP. AND ASSEMBLY FOR DACOITY,0,0,0,0,0,0,0,0,0,0,0,0,0,0,0
DAMAN & DIU,2005,ROBBERY,0,0,0,0,0,0,0,0,0,0,0,0,0,0,0
DAMAN & DIU,2005,BURGLARY,0,0,0,0,0,0,0,0,0,0,0,0,0,0,0
DAMAN & DIU,2005,THEFTS,0,0,0,0,0,0,0,0,0,0,0,0,0,0,0
DAMAN & DIU,2005,EXTORTION,0,0,0,0,0,0,0,0,0,0,0,0,0,0,0
DAMAN & DIU,2005,RIOTS,0,0,0,0,0,0,0,0,0,0,0,0,0,0,0
DAMAN & DIU,2005,ARSON,0,0,0,0,0,0,0,0,0,0,0,0,0,0,0
DAMAN & DIU,2005,CRIMINAL BREACH OF TRUST,0,0,0,0,0,0,0,0,0,0,0,0,0,0,0
DAMAN & DIU,2005,CHEATING,0,0,0,0,0,0,0,0,0,0,0,0,0,0,0
DAMAN & DIU,2005,COUNTER FEITING,0,0,0,0,0,0,0,0,0,0,0,0,0,0,0
DAMAN & DIU,2005,DOWRY DEATHS,0,0,0,0,0,0,0,0,0,0,0,0,0,0,0
DAMAN & DIU,2005,MOLESTATION,0,0,0,0,0,0,0,0,0,0,0,0,0,0,0
DAMAN & DIU,2005,EVE-TEASING,0,0,0,0,0,0,0,0,0,0,0,0,0,0,0
DAMAN & DIU,2005,CRUELTY BY HUSBAND OR RELATIVE OF HUSBAND,0,0,0,0,0,0,0,0,0,0,0,0,0,0,0
DAMAN & DIU,2005,OTHER IPC CRIMES,0,0,0,0,0,0,0,0,0,0,0,0,0,0,0
DAMAN & DIU,2005,TOTAL IPC,0,0,0,1,0,1,7,0,7,3,0,3,11,0,11
DAMAN & DIU,2006,MURDER,0,0,0,8,0,8,2,0,2,2,0,2,12,0,12
DAMAN & DIU,2006,ATTEMPT TO COMMIT MURDER,0,0,0,0,0,0,0,0,0,0,0,0,0,0,0
DAMAN & DIU,2006,C.H. NOT AMOUNTING TO MURDER,0,0,0,0,0,0,0,0,0,0,0,0,0,0,0
DAMAN & DIU,2006,RAPE,0,0,0,0,0,0,0,0,0,0,0,0,0,0,0
DAMAN & DIU,2006,KIDNAPPING AND ABDUCTION,0,0,0,0,0,0,0,0,0,0,0,0,0,0,0
DAMAN & DIU,2006,DACOITY,0,0,0,0,0,0,0,0,0,0,0,0,0,0,0
DAMAN & DIU,2006,PREP. AND ASSEMBLY FOR DACOITY,0,0,0,0,0,0,0,0,0,0,0,0,0,0,0
DAMAN & DIU,2006,ROBBERY,0,0,0,0,0,0,0,0,0,0,0,0,0,0,0
DAMAN & DIU,2006,BURGLARY,0,0,0,0,0,0,0,0,0,0,0,0,0,0,0
DAMAN & DIU,2006,THEFTS,0,0,0,0,0,0,0,0,0,0,0,0,0,0,0
DAMAN & DIU,2006,EXTORTION,0,0,0,0,0,0,0,0,0,0,0,0,0,0,0
DAMAN & DIU,2006,RIOTS,0,0,0,0,0,0,0,0,0,0,0,0,0,0,0
DAMAN & DIU,2006,ARSON,0,0,0,0,0,0,0,0,0,0,0,0,0,0,0
DAMAN & DIU,2006,CRIMINAL BREACH OF TRUST,0,0,0,0,0,0,0,0,0,0,0,0,0,0,0
DAMAN & DIU,2006,CHEATING,0,0,0,0,0,0,0,0,0,0,0,0,0,0,0
DAMAN & DIU,2006,COUNTER FEITING,0,0,0,0,0,0,0,0,0,0,0,0,0,0,0
DAMAN & DIU,2006,DOWRY DEATHS,0,0,0,0,0,0,0,0,0,0,0,0,0,0,0
DAMAN & DIU,2006,MOLESTATION,0,0,0,0,0,0,0,0,0,0,0,0,0,0,0
DAMAN & DIU,2006,EVE-TEASING,0,0,0,0,0,0,0,0,0,0,0,0,0,0,0
DAMAN & DIU,2006,CRUELTY BY HUSBAND OR RELATIVE OF HUSBAND,0,0,0,0,0,0,0,0,0,0,0,0,0,0,0
DAMAN & DIU,2006,OTHER IPC CRIMES,0,0,0,0,0,0,0,0,0,0,0,0,0,0,0
DAMAN & DIU,2006,TOTAL IPC,0,0,0,8,0,8,2,0,2,2,0,2,12,0,12
DAMAN & DIU,2007,MURDER,0,0,0,3,0,3,3,2,5,1,0,1,7,2,9
DAMAN & DIU,2007,ATTEMPT TO COMMIT MURDER,0,0,0,0,0,0,1,0,1,0,0,0,1,0,1
DAMAN & DIU,2007,C.H. NOT AMOUNTING TO MURDER,0,0,0,0,0,0,0,0,0,0,0,0,0,0,0
DAMAN & DIU,2007,RAPE,0,0,0,0,0,0,0,0,0,0,0,0,0,0,0
DAMAN & DIU,2007,KIDNAPPING AND ABDUCTION,0,0,0,0,0,0,0,0,0,0,0,0,0,0,0
DAMAN & DIU,2007,DACOITY,0,0,0,0,0,0,0,0,0,0,0,0,0,0,0
DAMAN & DIU,2007,PREP. AND ASSEMBLY FOR DACOITY,0,0,0,0,0,0,0,0,0,0,0,0,0,0,0
DAMAN & DIU,2007,ROBBERY,0,0,0,0,0,0,0,0,0,0,0,0,0,0,0
DAMAN & DIU,2007,BURGLARY,0,0,0,0,0,0,0,0,0,0,0,0,0,0,0
DAMAN & DIU,2007,THEFTS,0,0,0,0,0,0,0,0,0,0,0,0,0,0,0
DAMAN & DIU,2007,EXTORTION,0,0,0,0,0,0,0,0,0,0,0,0,0,0,0
DAMAN & DIU,2007,RIOTS,0,0,0,0,0,0,0,0,0,0,0,0,0,0,0
DAMAN & DIU,2007,ARSON,0,0,0,0,0,0,0,0,0,0,0,0,0,0,0
DAMAN & DIU,2007,CRIMINAL BREACH OF TRUST,0,0,0,0,0,0,0,0,0,0,0,0,0,0,0
DAMAN & DIU,2007,CHEATING,0,0,0,0,0,0,0,0,0,0,0,0,0,0,0
DAMAN & DIU,2007,COUNTER FEITING,0,0,0,0,0,0,0,0,0,0,0,0,0,0,0
DAMAN & DIU,2007,DOWRY DEATHS,0,0,0,0,0,0,0,0,0,0,0,0,0,0,0
DAMAN & DIU,2007,MOLESTATION,0,0,0,0,0,0,0,0,0,0,0,0,0,0,0
DAMAN & DIU,2007,EVE-TEASING,0,0,0,0,0,0,0,0,0,0,0,0,0,0,0
DAMAN & DIU,2007,CRUELTY BY HUSBAND OR RELATIVE OF HUSBAND,0,0,0,0,0,0,0,0,0,0,0,0,0,0,0
DAMAN & DIU,2007,OTHER IPC CRIMES,0,0,0,0,0,0,0,0,0,0,0,0,0,0,0
DAMAN & DIU,2007,TOTAL IPC,0,0,0,3,0,3,4,2,6,1,0,1,8,2,10
DAMAN & DIU,2008,MURDER,0,0,0,3,2,5,0,0,0,0,0,0,3,2,5
DAMAN & DIU,2008,ATTEMPT TO COMMIT MURDER,0,0,0,0,0,0,0,0,0,0,0,0,0,0,0
DAMAN & DIU,2008,C.H. NOT AMOUNTING TO MURDER,0,0,0,1,0,1,0,0,0,0,0,0,1,0,1
DAMAN & DIU,2008,RAPE,0,0,0,0,0,0,0,0,0,0,0,0,0,0,0
DAMAN & DIU,2008,KIDNAPPING AND ABDUCTION,0,0,0,0,0,0,0,0,0,0,0,0,0,0,0
DAMAN & DIU,2008,DACOITY,0,0,0,0,0,0,0,0,0,0,0,0,0,0,0
DAMAN & DIU,2008,PREP. AND ASSEMBLY FOR DACOITY,0,0,0,0,0,0,0,0,0,0,0,0,0,0,0
DAMAN & DIU,2008,ROBBERY,0,0,0,2,0,2,4,0,4,3,0,3,9,0,9
DAMAN & DIU,2008,BURGLARY,0,0,0,1,0,1,0,0,0,0,0,0,1,0,1
DAMAN & DIU,2008,THEFTS,0,0,0,0,0,0,0,0,0,0,0,0,0,0,0
DAMAN & DIU,2008,EXTORTION,0,0,0,0,0,0,0,0,0,0,0,0,0,0,0
DAMAN & DIU,2008,RIOTS,0,0,0,0,0,0,0,0,0,0,0,0,0,0,0
DAMAN & DIU,2008,ARSON,0,0,0,0,0,0,0,0,0,0,0,0,0,0,0
DAMAN & DIU,2008,CRIMINAL BREACH OF TRUST,0,0,0,0,0,0,0,0,0,0,0,0,0,0,0
DAMAN & DIU,2008,CHEATING,0,0,0,0,0,0,0,0,0,0,0,0,0,0,0
DAMAN & DIU,2008,COUNTER FEITING,0,0,0,0,0,0,0,0,0,0,0,0,0,0,0
DAMAN & DIU,2008,DOWRY DEATHS,0,0,0,0,0,0,0,0,0,0,0,0,0,0,0
DAMAN & DIU,2008,MOLESTATION,0,0,0,0,0,0,0,0,0,0,0,0,0,0,0
DAMAN & DIU,2008,EVE-TEASING,0,0,0,0,0,0,0,0,0,0,0,0,0,0,0
DAMAN & DIU,2008,CRUELTY BY HUSBAND OR RELATIVE OF HUSBAND,0,0,0,0,0,0,0,0,0,0,0,0,0,0,0
DAMAN & DIU,2008,OTHER IPC CRIMES,0,0,0,0,0,0,0,0,0,0,0,0,0,0,0
DAMAN & DIU,2008,TOTAL IPC,0,0,0,7,2,9,4,0,4,3,0,3,14,2,16
DAMAN & DIU,2009,MURDER,0,0,0,0,0,0,3,1,4,2,0,2,5,1,6
DAMAN & DIU,2009,ATTEMPT TO COMMIT MURDER,0,0,0,0,0,0,0,0,0,0,0,0,0,0,0
DAMAN & DIU,2009,C.H. NOT AMOUNTING TO MURDER,0,0,0,0,0,0,1,0,1,0,0,0,1,0,1
DAMAN & DIU,2009,RAPE,0,0,0,0,0,0,0,0,0,0,0,0,0,0,0
DAMAN & DIU,2009,KIDNAPPING AND ABDUCTION,0,0,0,0,0,0,0,0,0,0,0,0,0,0,0
DAMAN & DIU,2009,DACOITY,0,0,0,1,0,1,0,0,0,0,0,0,1,0,1
DAMAN & DIU,2009,PREP. AND ASSEMBLY FOR DACOITY,0,0,0,0,0,0,0,0,0,0,0,0,0,0,0
DAMAN & DIU,2009,ROBBERY,0,0,0,0,0,0,0,0,0,0,0,0,0,0,0
DAMAN & DIU,2009,BURGLARY,0,0,0,1,0,1,0,0,0,0,0,0,1,0,1
DAMAN & DIU,2009,THEFTS,0,0,0,5,0,5,0,0,0,0,0,0,5,0,5
DAMAN & DIU,2009,EXTORTION,0,0,0,0,0,0,0,0,0,0,0,0,0,0,0
DAMAN & DIU,2009,RIOTS,0,0,0,0,0,0,0,0,0,0,0,0,0,0,0
DAMAN & DIU,2009,ARSON,0,0,0,0,0,0,0,0,0,0,0,0,0,0,0
DAMAN & DIU,2009,CRIMINAL BREACH OF TRUST,0,0,0,0,0,0,0,0,0,0,0,0,0,0,0
DAMAN & DIU,2009,CHEATING,0,0,0,0,0,0,0,0,0,0,0,0,0,0,0
DAMAN & DIU,2009,COUNTER FEITING,0,0,0,0,0,0,0,0,0,0,0,0,0,0,0
DAMAN & DIU,2009,DOWRY DEATHS,0,0,0,0,0,0,1,0,1,0,0,0,1,0,1
DAMAN & DIU,2009,MOLESTATION,0,0,0,0,0,0,0,0,0,0,0,0,0,0,0
DAMAN & DIU,2009,EVE-TEASING,0,0,0,0,0,0,0,0,0,0,0,0,0,0,0
DAMAN & DIU,2009,CRUELTY BY HUSBAND OR RELATIVE OF HUSBAND,0,0,0,0,0,0,0,0,0,0,0,0,0,0,0
DAMAN & DIU,2009,OTHER IPC CRIMES,0,0,0,0,0,0,0,0,0,0,0,0,0,0,0
DAMAN & DIU,2009,TOTAL IPC,0,0,0,7,0,7,5,1,6,2,0,2,14,1,15
DAMAN & DIU,2010,MURDER,0,0,0,2,0,2,7,1,8,4,0,4,13,1,14
DAMAN & DIU,2010,ATTEMPT TO COMMIT MURDER,0,0,0,0,0,0,0,0,0,0,0,0,0,0,0
DAMAN & DIU,2010,C.H. NOT AMOUNTING TO MURDER,0,0,0,0,0,0,0,0,0,0,0,0,0,0,0
DAMAN & DIU,2010,RAPE,0,0,0,0,0,0,0,0,0,0,0,0,0,0,0
DAMAN & DIU,2010,KIDNAPPING AND ABDUCTION,0,0,0,0,0,0,0,0,0,0,0,0,0,0,0
DAMAN & DIU,2010,DACOITY,0,0,0,0,0,0,0,0,0,0,0,0,0,0,0
DAMAN & DIU,2010,PREP. AND ASSEMBLY FOR DACOITY,0,0,0,0,0,0,0,0,0,0,0,0,0,0,0
DAMAN & DIU,2010,ROBBERY,0,0,0,0,0,0,0,0,0,0,0,0,0,0,0
DAMAN & DIU,2010,BURGLARY,0,0,0,0,0,0,0,0,0,0,0,0,0,0,0
DAMAN & DIU,2010,THEFTS,0,0,0,0,0,0,0,0,0,0,0,0,0,0,0
DAMAN & DIU,2010,EXTORTION,0,0,0,0,0,0,0,0,0,0,0,0,0,0,0
DAMAN & DIU,2010,RIOTS,0,0,0,0,0,0,0,0,0,0,0,0,0,0,0
DAMAN & DIU,2010,ARSON,0,0,0,0,0,0,0,0,0,0,0,0,0,0,0
DAMAN & DIU,2010,CRIMINAL BREACH OF TRUST,0,0,0,0,0,0,0,0,0,0,0,0,0,0,0
DAMAN & DIU,2010,CHEATING,0,0,0,0,0,0,0,0,0,0,0,0,0,0,0
DAMAN & DIU,2010,COUNTER FEITING,0,0,0,0,0,0,0,0,0,0,0,0,0,0,0
DAMAN & DIU,2010,DOWRY DEATHS,0,0,0,0,0,0,0,0,0,0,0,0,0,0,0
DAMAN & DIU,2010,MOLESTATION,0,0,0,0,0,0,0,0,0,0,0,0,0,0,0
DAMAN & DIU,2010,EVE-TEASING,0,0,0,0,0,0,0,0,0,0,0,0,0,0,0
DAMAN & DIU,2010,CRUELTY BY HUSBAND OR RELATIVE OF HUSBAND,0,0,0,0,0,0,0,0,0,0,0,0,0,0,0
DAMAN & DIU,2010,OTHER IPC CRIMES,0,0,0,0,0,0,0,0,0,0,0,0,0,0,0
DAMAN & DIU,2010,TOTAL IPC,0,0,0,2,0,2,7,1,8,4,0,4,13,1,14
DAMAN & DIU,2011,MURDER,0,0,0,5,0,5,6,1,7,0,0,0,11,1,12
DAMAN & DIU,2011,ATTEMPT TO COMMIT MURDER,0,0,0,0,0,0,0,0,0,0,0,0,0,0,0
DAMAN & DIU,2011,C.H. NOT AMOUNTING TO MURDER,0,0,0,0,0,0,0,0,0,0,0,0,0,0,0
DAMAN & DIU,2011,RAPE,0,0,0,0,0,0,0,0,0,0,0,0,0,0,0
DAMAN & DIU,2011,KIDNAPPING AND ABDUCTION,0,0,0,0,0,0,0,0,0,0,0,0,0,0,0
DAMAN & DIU,2011,DACOITY,0,0,0,0,0,0,0,0,0,0,0,0,0,0,0
DAMAN & DIU,2011,PREP. AND ASSEMBLY FOR DACOITY,0,0,0,0,0,0,0,0,0,0,0,0,0,0,0
DAMAN & DIU,2011,ROBBERY,0,0,0,0,0,0,0,0,0,0,0,0,0,0,0
DAMAN & DIU,2011,BURGLARY,0,0,0,0,0,0,0,0,0,0,0,0,0,0,0
DAMAN & DIU,2011,THEFTS,0,0,0,0,0,0,0,0,0,0,0,0,0,0,0
DAMAN & DIU,2011,EXTORTION,0,0,0,0,0,0,0,0,0,0,0,0,0,0,0
DAMAN & DIU,2011,RIOTS,0,0,0,0,0,0,0,0,0,0,0,0,0,0,0
DAMAN & DIU,2011,ARSON,0,0,0,0,0,0,0,0,0,0,0,0,0,0,0
DAMAN & DIU,2011,CRIMINAL BREACH OF TRUST,0,0,0,0,0,0,0,0,0,0,0,0,0,0,0
DAMAN & DIU,2011,CHEATING,0,0,0,0,0,0,0,0,0,0,0,0,0,0,0
DAMAN & DIU,2011,COUNTER FEITING,0,0,0,0,0,0,0,0,0,0,0,0,0,0,0
DAMAN & DIU,2011,DOWRY DEATHS,0,0,0,0,0,0,0,0,0,0,0,0,0,0,0
DAMAN & DIU,2011,MOLESTATION,0,0,0,0,0,0,0,0,0,0,0,0,0,0,0
DAMAN & DIU,2011,EVE-TEASING,0,0,0,0,0,0,0,0,0,0,0,0,0,0,0
DAMAN & DIU,2011,CRUELTY BY HUSBAND OR RELATIVE OF HUSBAND,0,0,0,0,0,0,0,0,0,0,0,0,0,0,0
DAMAN & DIU,2011,OTHER IPC CRIMES,0,0,0,0,0,0,0,0,0,0,0,0,0,0,0
DAMAN & DIU,2011,TOTAL IPC,0,0,0,5,0,5,6,1,7,0,0,0,11,1,12
DAMAN & DIU,2012,MURDER,0,0,0,4,0,4,5,1,6,3,0,3,12,1,13
DAMAN & DIU,2012,ATTEMPT TO COMMIT MURDER,0,0,0,0,0,0,0,0,0,0,0,0,0,0,0
DAMAN & DIU,2012,C.H. NOT AMOUNTING TO MURDER,0,0,0,0,0,0,0,0,0,0,0,0,0,0,0
DAMAN & DIU,2012,RAPE,0,0,0,1,0,1,0,0,0,0,0,0,1,0,1
DAMAN & DIU,2012,KIDNAPPING AND ABDUCTION,0,0,0,0,0,0,0,0,0,0,0,0,0,0,0
DAMAN & DIU,2012,DACOITY,0,0,0,0,0,0,0,0,0,0,0,0,0,0,0
DAMAN & DIU,2012,PREP. AND ASSEMBLY FOR DACOITY,0,0,0,0,0,0,0,0,0,0,0,0,0,0,0
DAMAN & DIU,2012,ROBBERY,0,0,0,0,0,0,0,0,0,0,0,0,0,0,0
DAMAN & DIU,2012,BURGLARY,0,0,0,0,0,0,0,0,0,0,0,0,0,0,0
DAMAN & DIU,2012,THEFTS,0,0,0,0,0,0,0,0,0,0,0,0,0,0,0
DAMAN & DIU,2012,EXTORTION,0,0,0,0,0,0,0,0,0,0,0,0,0,0,0
DAMAN & DIU,2012,RIOTS,0,0,0,0,0,0,0,0,0,0,0,0,0,0,0
DAMAN & DIU,2012,ARSON,0,0,0,0,0,0,0,0,0,0,0,0,0,0,0
DAMAN & DIU,2012,CRIMINAL BREACH OF TRUST,0,0,0,0,0,0,0,0,0,0,0,0,0,0,0
DAMAN & DIU,2012,CHEATING,0,0,0,0,0,0,0,0,0,0,0,0,0,0,0
DAMAN & DIU,2012,COUNTER FEITING,0,0,0,0,0,0,0,0,0,0,0,0,0,0,0
DAMAN & DIU,2012,DOWRY DEATHS,0,0,0,0,0,0,0,0,0,0,0,0,0,0,0
DAMAN & DIU,2012,MOLESTATION,0,0,0,0,0,0,0,0,0,0,0,0,0,0,0
DAMAN & DIU,2012,EVE-TEASING,0,0,0,0,0,0,0,0,0,0,0,0,0,0,0
DAMAN & DIU,2012,CRUELTY BY HUSBAND OR RELATIVE OF HUSBAND,0,0,0,0,0,0,0,0,0,0,0,0,0,0,0
DAMAN & DIU,2012,OTHER IPC CRIMES,0,0,0,0,0,0,0,0,0,0,0,0,0,0,0
DAMAN & DIU,2012,TOTAL IPC,0,0,0,5,0,5,5,1,6,3,0,3,13,1,14
DELHI,2001,MURDER,12,0,12,402,17,419,335,23,358,84,9,93,833,49,882
DELHI,2001,ATTEMPT TO COMMIT MURDER,2,0,2,48,0,48,36,0,36,19,0,19,105,0,105
DELHI,2001,C.H. NOT AMOUNTING TO MURDER,3,0,3,39,0,39,27,0,27,16,0,16,85,0,85
DELHI,2001,RAPE,10,0,10,104,0,104,55,1,56,11,0,11,180,1,181
DELHI,2001,KIDNAPPING AND ABDUCTION,2,0,2,49,9,58,26,7,33,10,0,10,87,16,103
DELHI,2001,DACOITY,7,0,7,60,0,60,30,0,30,5,0,5,102,0,102
DELHI,2001,PREP. AND ASSEMBLY FOR DACOITY,2,0,2,40,0,40,20,0,20,8,0,8,70,0,70
DELHI,2001,ROBBERY,5,0,5,26,0,26,5,0,5,3,0,3,39,0,39
DELHI,2001,BURGLARY,0,0,0,4,0,4,2,0,2,0,0,0,6,0,6
DELHI,2001,THEFTS,6,0,6,48,0,48,30,0,30,10,0,10,94,0,94
DELHI,2001,EXTORTION,0,0,0,0,0,0,0,0,0,0,0,0,0,0,0
DELHI,2001,RIOTS,0,0,0,8,0,8,5,0,5,7,0,7,20,0,20
DELHI,2001,ARSON,0,0,0,0,0,0,0,0,0,0,0,0,0,0,0
DELHI,2001,CRIMINAL BREACH OF TRUST,0,0,0,3,0,3,3,0,3,0,0,0,6,0,6
DELHI,2001,CHEATING,0,0,0,7,0,7,12,0,12,4,0,4,23,0,23
DELHI,2001,COUNTER FEITING,0,0,0,16,0,16,7,0,7,2,0,2,25,0,25
DELHI,2001,DOWRY DEATHS,0,0,0,20,0,20,7,0,7,2,0,2,29,0,29
DELHI,2001,MOLESTATION,0,0,0,0,0,0,0,0,0,1,0,1,1,0,1
DELHI,2001,EVE-TEASING,0,0,0,0,0,0,0,0,0,0,0,0,0,0,0
DELHI,2001,CRUELTY BY HUSBAND OR RELATIVE OF HUSBAND,0,0,0,5,0,5,6,0,6,0,0,0,11,0,11
DELHI,2001,OTHER IPC CRIMES,0,0,0,10,0,10,4,0,4,2,0,2,16,0,16
DELHI,2001,TOTAL IPC,49,0,49,889,26,915,610,31,641,184,9,193,1732,66,1798
DELHI,2002,MURDER,0,0,0,468,10,478,321,29,350,61,3,64,850,42,892
DELHI,2002,ATTEMPT TO COMMIT MURDER,0,0,0,43,0,43,37,0,37,3,0,3,83,0,83
DELHI,2002,C.H. NOT AMOUNTING TO MURDER,0,0,0,26,0,26,23,0,23,1,0,1,50,0,50
DELHI,2002,RAPE,0,0,0,146,4,150,57,8,65,4,1,5,207,13,220
DELHI,2002,KIDNAPPING AND ABDUCTION,0,0,0,60,2,62,39,3,42,5,0,5,104,5,109
DELHI,2002,DACOITY,0,0,0,129,0,129,84,0,84,5,0,5,218,0,218
DELHI,2002,PREP. AND ASSEMBLY FOR DACOITY,0,0,0,5,0,5,1,0,1,0,0,0,6,0,6
DELHI,2002,ROBBERY,0,0,0,65,0,65,21,0,21,2,0,2,88,0,88
DELHI,2002,BURGLARY,0,0,0,2,0,2,0,0,0,0,0,0,2,0,2
DELHI,2002,THEFTS,0,0,0,57,0,57,16,0,16,2,0,2,75,0,75
DELHI,2002,EXTORTION,0,0,0,0,0,0,0,0,0,0,0,0,0,0,0
DELHI,2002,RIOTS,0,0,0,0,0,0,0,0,0,0,0,0,0,0,0
DELHI,2002,ARSON,0,0,0,0,0,0,0,0,0,0,0,0,0,0,0
DELHI,2002,CRIMINAL BREACH OF TRUST,0,0,0,0,0,0,0,0,0,0,0,0,0,0,0
DELHI,2002,CHEATING,0,0,0,10,0,10,10,2,12,4,0,4,24,2,26
DELHI,2002,COUNTER FEITING,0,0,0,1,0,1,1,0,1,0,0,0,2,0,2
DELHI,2002,DOWRY DEATHS,0,0,0,36,7,43,16,14,30,10,17,27,62,38,100
DELHI,2002,MOLESTATION,0,0,0,0,0,0,0,0,0,0,0,0,0,0,0
DELHI,2002,EVE-TEASING,0,0,0,1,0,1,0,0,0,0,0,0,1,0,1
DELHI,2002,CRUELTY BY HUSBAND OR RELATIVE OF HUSBAND,0,0,0,0,0,0,0,0,0,0,0,0,0,0,0
DELHI,2002,OTHER IPC CRIMES,0,0,0,17,0,17,12,0,12,0,0,0,29,0,29
DELHI,2002,TOTAL IPC,0,0,0,1066,23,1089,638,56,694,97,21,118,1801,100,1901
DELHI,2003,MURDER,0,0,0,0,0,0,0,0,0,0,0,0,0,0,0
DELHI,2003,MURDER,0,0,0,492,14,506,342,14,356,57,7,64,891,35,926
DELHI,2003,ATTEMPT TO COMMIT MURDER,0,0,0,52,0,52,27,0,27,1,0,1,80,0,80
DELHI,2003,C.H. NOT AMOUNTING TO MURDER,0,0,0,6,0,6,11,0,11,1,0,1,18,0,18
DELHI,2003,RAPE,0,0,0,124,0,124,71,4,75,10,1,11,205,5,210
DELHI,2003,KIDNAPPING AND ABDUCTION,0,0,0,55,7,62,52,8,60,13,3,16,120,18,138
DELHI,2003,DACOITY,0,0,0,104,0,104,83,0,83,10,0,10,197,0,197
DELHI,2003,PREP. AND ASSEMBLY FOR DACOITY,0,0,0,13,0,13,0,0,0,0,0,0,13,0,13
DELHI,2003,ROBBERY,0,0,0,46,0,46,13,0,13,1,0,1,60,0,60
DELHI,2003,BURGLARY,0,0,0,1,0,1,0,0,0,0,0,0,1,0,1
DELHI,2003,THEFTS,0,0,0,49,2,51,24,1,25,5,0,5,78,3,81
DELHI,2003,EXTORTION,0,0,0,0,0,0,0,0,0,0,0,0,0,0,0
DELHI,2003,RIOTS,0,0,0,0,0,0,0,0,0,0,0,0,0,0,0
DELHI,2003,ARSON,0,0,0,0,0,0,1,0,1,0,0,0,1,0,1
DELHI,2003,CRIMINAL BREACH OF TRUST,0,0,0,0,0,0,0,0,0,0,0,0,0,0,0
DELHI,2003,CHEATING,0,0,0,10,2,12,16,0,16,9,0,9,35,2,37
DELHI,2003,COUNTER FEITING,0,0,0,1,0,1,0,0,0,0,0,0,1,0,1
DELHI,2003,DOWRY DEATHS,0,0,0,28,13,41,37,18,55,11,13,24,76,44,120
DELHI,2003,MOLESTATION,0,0,0,1,0,1,0,0,0,0,0,0,1,0,1
DELHI,2003,EVE-TEASING,0,0,0,2,0,2,0,0,0,0,0,0,2,0,2
DELHI,2003,CRUELTY BY HUSBAND OR RELATIVE OF HUSBAND,0,0,0,0,0,0,0,0,0,0,0,0,0,0,0
DELHI,2003,OTHER IPC CRIMES,0,0,0,18,0,18,7,2,9,0,0,0,25,2,27
DELHI,2003,TOTAL IPC,0,0,0,1002,38,1040,684,47,731,118,24,142,1804,109,1913
DELHI,2004,MURDER,0,0,0,487,12,499,427,27,454,51,9,60,965,48,1013
DELHI,2004,ATTEMPT TO COMMIT MURDER,0,0,0,65,0,65,52,0,52,9,0,9,126,0,126
DELHI,2004,C.H. NOT AMOUNTING TO MURDER,0,0,0,4,0,4,2,0,2,0,0,0,6,0,6
DELHI,2004,RAPE,0,0,0,92,3,95,73,4,77,5,3,8,170,10,180
DELHI,2004,KIDNAPPING AND ABDUCTION,0,0,0,70,7,77,23,16,39,0,3,3,93,26,119
DELHI,2004,DACOITY,0,0,0,82,0,82,49,0,49,5,0,5,136,0,136
DELHI,2004,PREP. AND ASSEMBLY FOR DACOITY,0,0,0,1,0,1,0,0,0,1,0,1,2,0,2
DELHI,2004,ROBBERY,0,0,0,58,0,58,35,0,35,4,0,4,97,0,97
DELHI,2004,BURGLARY,0,0,0,1,0,1,0,0,0,0,0,0,1,0,1
DELHI,2004,THEFTS,0,0,0,96,0,96,26,0,26,7,0,7,129,0,129
DELHI,2004,EXTORTION,0,0,0,0,0,0,2,0,2,0,0,0,2,0,2
DELHI,2004,RIOTS,0,0,0,2,0,2,0,0,0,0,0,0,2,0,2
DELHI,2004,ARSON,0,0,0,0,0,0,0,0,0,0,0,0,0,0,0
DELHI,2004,CRIMINAL BREACH OF TRUST,0,0,0,2,0,2,1,0,1,3,0,3,6,0,6
DELHI,2004,CHEATING,0,0,0,56,0,56,6,1,7,7,0,7,69,1,70
DELHI,2004,COUNTER FEITING,0,0,0,5,0,5,0,0,0,0,0,0,5,0,5
DELHI,2004,DOWRY DEATHS,0,0,0,50,2,52,26,12,38,14,13,27,90,27,117
DELHI,2004,MOLESTATION,0,0,0,6,0,6,1,0,1,0,0,0,7,0,7
DELHI,2004,EVE-TEASING,0,0,0,2,0,2,1,0,1,1,0,1,4,0,4
DELHI,2004,CRUELTY BY HUSBAND OR RELATIVE OF HUSBAND,0,0,0,0,0,0,1,0,1,0,0,0,1,0,1
DELHI,2004,OTHER IPC CRIMES,0,0,0,52,0,52,48,3,51,13,0,13,113,3,116
DELHI,2004,TOTAL IPC,0,0,0,1131,24,1155,773,63,836,120,28,148,2024,115,2139
DELHI,2005,MURDER,0,0,0,481,4,485,319,12,331,45,11,56,845,27,872
DELHI,2005,ATTEMPT TO COMMIT MURDER,0,0,0,63,1,64,41,0,41,8,1,9,112,2,114
DELHI,2005,C.H. NOT AMOUNTING TO MURDER,0,0,0,11,0,11,8,0,8,0,0,0,19,0,19
DELHI,2005,RAPE,0,0,0,126,2,128,71,4,75,11,2,13,208,8,216
DELHI,2005,KIDNAPPING AND ABDUCTION,0,0,0,50,1,51,44,11,55,1,2,3,95,14,109
DELHI,2005,DACOITY,0,0,0,141,0,141,49,0,49,5,0,5,195,0,195
DELHI,2005,PREP. AND ASSEMBLY FOR DACOITY,0,0,0,13,0,13,3,0,3,1,0,1,17,0,17
DELHI,2005,ROBBERY,0,0,0,40,0,40,39,0,39,7,0,7,86,0,86
DELHI,2005,BURGLARY,0,0,0,1,0,1,1,0,1,0,0,0,2,0,2
DELHI,2005,THEFTS,0,0,0,86,1,87,34,2,36,8,1,9,128,4,132
DELHI,2005,EXTORTION,0,0,0,0,0,0,4,0,4,0,0,0,4,0,4
DELHI,2005,RIOTS,0,0,0,0,0,0,0,0,0,0,0,0,0,0,0
DELHI,2005,ARSON,0,0,0,0,0,0,0,0,0,0,0,0,0,0,0
DELHI,2005,CRIMINAL BREACH OF TRUST,0,0,0,1,0,1,1,0,1,0,0,0,2,0,2
DELHI,2005,CHEATING,0,0,0,6,0,6,8,1,9,0,0,0,14,1,15
DELHI,2005,COUNTER FEITING,0,0,0,0,0,0,5,0,5,2,0,2,7,0,7
DELHI,2005,DOWRY DEATHS,0,0,0,44,0,44,50,20,70,19,8,27,113,28,141
DELHI,2005,MOLESTATION,0,0,0,0,0,0,3,0,3,4,0,4,7,0,7
DELHI,2005,EVE-TEASING,0,0,0,3,0,3,0,0,0,0,0,0,3,0,3
DELHI,2005,CRUELTY BY HUSBAND OR RELATIVE OF HUSBAND,0,0,0,3,0,3,0,0,0,4,0,4,7,0,7
DELHI,2005,OTHER IPC CRIMES,0,0,0,67,0,67,70,1,71,1,0,1,138,1,139
DELHI,2005,TOTAL IPC,0,0,0,1136,9,1145,750,51,801,116,25,141,2002,85,2087
DELHI,2006,MURDER,0,0,0,349,5,354,297,15,312,50,6,56,696,26,722
DELHI,2006,ATTEMPT TO COMMIT MURDER,0,0,0,59,0,59,65,3,68,8,0,8,132,3,135
DELHI,2006,C.H. NOT AMOUNTING TO MURDER,0,0,0,1,0,1,4,0,4,1,0,1,6,0,6
DELHI,2006,RAPE,0,0,0,156,0,156,105,1,106,17,3,20,278,4,282
DELHI,2006,KIDNAPPING AND ABDUCTION,0,0,0,43,0,43,23,4,27,3,3,6,69,7,76
DELHI,2006,DACOITY,0,0,0,154,0,154,140,0,140,5,0,5,299,0,299
DELHI,2006,PREP. AND ASSEMBLY FOR DACOITY,0,0,0,2,0,2,3,0,3,0,0,0,5,0,5
DELHI,2006,ROBBERY,0,0,0,45,0,45,17,0,17,3,0,3,65,0,65
DELHI,2006,BURGLARY,0,0,0,7,0,7,0,0,0,0,0,0,7,0,7
DELHI,2006,THEFTS,0,0,0,107,0,107,95,0,95,2,0,2,204,0,204
DELHI,2006,EXTORTION,0,0,0,0,0,0,0,0,0,0,0,0,0,0,0
DELHI,2006,RIOTS,0,0,0,0,0,0,0,0,0,0,0,0,0,0,0
DELHI,2006,ARSON,0,0,0,0,0,0,0,0,0,0,0,0,0,0,0
DELHI,2006,CRIMINAL BREACH OF TRUST,0,0,0,1,0,1,0,0,0,0,0,0,1,0,1
DELHI,2006,CHEATING,0,0,0,3,0,3,13,2,15,3,0,3,19,2,21
DELHI,2006,COUNTER FEITING,0,0,0,3,0,3,9,0,9,1,0,1,13,0,13
DELHI,2006,DOWRY DEATHS,0,0,0,27,0,27,41,14,55,13,5,18,81,19,100
DELHI,2006,MOLESTATION,0,0,0,2,0,2,0,0,0,1,0,1,3,0,3
DELHI,2006,EVE-TEASING,0,0,0,0,0,0,0,0,0,0,0,0,0,0,0
DELHI,2006,CRUELTY BY HUSBAND OR RELATIVE OF HUSBAND,0,0,0,0,0,0,0,0,0,0,0,0,0,0,0
DELHI,2006,OTHER IPC CRIMES,0,0,0,27,1,28,8,2,10,16,0,16,51,3,54
DELHI,2006,TOTAL IPC,0,0,0,986,6,992,820,41,861,123,17,140,1929,64,1993
DELHI,2007,MURDER,0,0,0,216,4,220,322,15,337,54,9,63,592,28,620
DELHI,2007,ATTEMPT TO COMMIT MURDER,0,0,0,74,0,74,89,4,93,12,1,13,175,5,180
DELHI,2007,C.H. NOT AMOUNTING TO MURDER,0,0,0,5,0,5,1,0,1,6,0,6,12,0,12
DELHI,2007,RAPE,0,0,0,136,0,136,102,1,103,28,2,30,266,3,269
DELHI,2007,KIDNAPPING AND ABDUCTION,0,0,0,64,0,64,36,4,40,2,2,4,102,6,108
DELHI,2007,DACOITY,0,0,0,141,0,141,115,0,115,5,0,5,261,0,261
DELHI,2007,PREP. AND ASSEMBLY FOR DACOITY,0,0,0,19,0,19,5,0,5,0,0,0,24,0,24
DELHI,2007,ROBBERY,0,0,0,24,0,24,9,0,9,0,0,0,33,0,33
DELHI,2007,BURGLARY,0,0,0,10,0,10,2,0,2,0,0,0,12,0,12
DELHI,2007,THEFTS,0,0,0,117,0,117,72,0,72,5,0,5,194,0,194
DELHI,2007,EXTORTION,0,0,0,9,0,9,0,0,0,0,0,0,9,0,9
DELHI,2007,RIOTS,0,0,0,0,0,0,0,0,0,0,0,0,0,0,0
DELHI,2007,ARSON,0,0,0,0,0,0,0,0,0,0,0,0,0,0,0
DELHI,2007,CRIMINAL BREACH OF TRUST,0,0,0,6,0,6,0,0,0,1,0,1,7,0,7
DELHI,2007,CHEATING,0,0,0,12,0,12,24,1,25,6,0,6,42,1,43
DELHI,2007,COUNTER FEITING,0,0,0,6,0,6,11,0,11,4,0,4,21,0,21
DELHI,2007,DOWRY DEATHS,0,0,0,19,2,21,19,2,21,4,1,5,42,5,47
DELHI,2007,MOLESTATION,0,0,0,2,0,2,0,0,0,0,0,0,2,0,2
DELHI,2007,EVE-TEASING,0,0,0,1,0,1,0,0,0,0,0,0,1,0,1
DELHI,2007,CRUELTY BY HUSBAND OR RELATIVE OF HUSBAND,0,0,0,0,0,0,0,0,0,0,0,0,0,0,0
DELHI,2007,OTHER IPC CRIMES,0,0,0,13,0,13,12,0,12,12,0,12,37,0,37
DELHI,2007,TOTAL IPC,0,0,0,874,6,880,819,27,846,139,15,154,1832,48,1880
DELHI,2008,MURDER,0,0,0,234,3,237,271,18,289,53,7,60,558,28,586
DELHI,2008,ATTEMPT TO COMMIT MURDER,0,0,0,53,1,54,51,0,51,11,1,12,115,2,117
DELHI,2008,C.H. NOT AMOUNTING TO MURDER,0,0,0,4,0,4,4,0,4,2,0,2,10,0,10
DELHI,2008,RAPE,0,0,0,134,0,134,119,0,119,21,0,21,274,0,274
DELHI,2008,KIDNAPPING AND ABDUCTION,0,0,0,56,1,57,28,2,30,4,1,5,88,4,92
DELHI,2008,DACOITY,0,0,0,132,0,132,70,0,70,2,0,2,204,0,204
DELHI,2008,PREP. AND ASSEMBLY FOR DACOITY,0,0,0,4,0,4,5,0,5,1,0,1,10,0,10
DELHI,2008,ROBBERY,0,0,0,52,0,52,18,0,18,0,0,0,70,0,70
DELHI,2008,BURGLARY,0,0,0,1,0,1,2,0,2,0,0,0,3,0,3
DELHI,2008,THEFTS,0,0,0,70,0,70,58,0,58,2,0,2,130,0,130
DELHI,2008,EXTORTION,0,0,0,0,0,0,0,0,0,0,0,0,0,0,0
DELHI,2008,RIOTS,0,0,0,0,0,0,0,0,0,1,0,1,1,0,1
DELHI,2008,ARSON,0,0,0,0,0,0,0,0,0,0,0,0,0,0,0
DELHI,2008,CRIMINAL BREACH OF TRUST,0,0,0,6,0,6,0,0,0,0,0,0,6,0,6
DELHI,2008,CHEATING,0,0,0,10,0,10,18,2,20,4,0,4,32,2,34
DELHI,2008,COUNTER FEITING,0,0,0,5,0,5,4,0,4,1,0,1,10,0,10
DELHI,2008,DOWRY DEATHS,0,0,0,17,0,17,20,2,22,9,4,13,46,6,52
DELHI,2008,MOLESTATION,0,0,0,1,0,1,0,0,0,0,0,0,1,0,1
DELHI,2008,EVE-TEASING,0,0,0,3,0,3,0,0,0,0,0,0,3,0,3
DELHI,2008,CRUELTY BY HUSBAND OR RELATIVE OF HUSBAND,0,0,0,0,0,0,0,0,0,0,0,0,0,0,0
DELHI,2008,OTHER IPC CRIMES,0,0,0,43,0,43,28,0,28,11,0,11,82,0,82
DELHI,2008,TOTAL IPC,0,0,0,825,5,830,696,24,720,122,13,135,1643,42,1685
DELHI,2009,MURDER,0,0,0,269,7,276,338,34,372,126,9,135,733,50,783
DELHI,2009,ATTEMPT TO COMMIT MURDER,0,0,0,59,0,59,68,3,71,25,0,25,152,3,155
DELHI,2009,C.H. NOT AMOUNTING TO MURDER,0,0,0,4,0,4,6,0,6,0,0,0,10,0,10
DELHI,2009,RAPE,0,0,0,140,0,140,140,3,143,28,0,28,308,3,311
DELHI,2009,KIDNAPPING AND ABDUCTION,0,0,0,49,2,51,33,5,38,4,1,5,86,8,94
DELHI,2009,DACOITY,0,0,0,103,0,103,72,0,72,6,0,6,181,0,181
DELHI,2009,PREP. AND ASSEMBLY FOR DACOITY,0,0,0,13,0,13,13,0,13,0,0,0,26,0,26
DELHI,2009,ROBBERY,0,0,0,29,0,29,17,0,17,0,0,0,46,0,46
DELHI,2009,BURGLARY,0,0,0,4,0,4,4,0,4,0,0,0,8,0,8
DELHI,2009,THEFTS,0,0,0,94,0,94,47,0,47,2,0,2,143,0,143
DELHI,2009,EXTORTION,0,0,0,0,0,0,0,0,0,0,0,0,0,0,0
DELHI,2009,RIOTS,0,0,0,0,0,0,0,0,0,0,0,0,0,0,0
DELHI,2009,ARSON,0,0,0,0,0,0,0,0,0,0,0,0,0,0,0
DELHI,2009,CRIMINAL BREACH OF TRUST,0,0,0,0,0,0,4,0,4,0,0,0,4,0,4
DELHI,2009,CHEATING,0,0,0,5,0,5,12,0,12,4,1,5,21,1,22
DELHI,2009,COUNTER FEITING,0,0,0,5,0,5,3,1,4,1,0,1,9,1,10
DELHI,2009,DOWRY DEATHS,0,0,0,22,0,22,37,1,38,7,2,9,66,3,69
DELHI,2009,MOLESTATION,0,0,0,0,0,0,0,0,0,0,0,0,0,0,0
DELHI,2009,EVE-TEASING,0,0,0,2,0,2,0,0,0,0,0,0,2,0,2
DELHI,2009,CRUELTY BY HUSBAND OR RELATIVE OF HUSBAND,0,0,0,0,0,0,0,0,0,0,0,0,0,0,0
DELHI,2009,OTHER IPC CRIMES,0,0,0,17,0,17,22,0,22,1,0,1,40,0,40
DELHI,2009,TOTAL IPC,0,0,0,815,9,824,816,47,863,204,13,217,1835,69,1904
DELHI,2010,MURDER,0,0,0,356,7,363,419,32,451,111,9,120,886,48,934
DELHI,2010,ATTEMPT TO COMMIT MURDER,0,0,0,66,0,66,55,3,58,27,0,27,148,3,151
DELHI,2010,C.H. NOT AMOUNTING TO MURDER,0,0,0,6,0,6,3,4,7,0,0,0,9,4,13
DELHI,2010,RAPE,0,0,0,239,2,241,132,4,136,18,2,20,389,8,397
DELHI,2010,KIDNAPPING AND ABDUCTION,0,0,0,50,5,55,39,4,43,8,2,10,97,11,108
DELHI,2010,DACOITY,0,0,0,138,1,139,134,0,134,9,1,10,281,2,283
DELHI,2010,PREP. AND ASSEMBLY FOR DACOITY,0,0,0,5,0,5,9,0,9,0,0,0,14,0,14
DELHI,2010,ROBBERY,0,0,0,27,0,27,12,0,12,0,0,0,39,0,39
DELHI,2010,BURGLARY,0,0,0,2,0,2,0,0,0,0,0,0,2,0,2
DELHI,2010,THEFTS,0,0,0,77,0,77,51,0,51,2,0,2,130,0,130
DELHI,2010,EXTORTION,0,0,0,0,0,0,2,0,2,0,0,0,2,0,2
DELHI,2010,RIOTS,0,0,0,1,0,1,2,0,2,0,0,0,3,0,3
DELHI,2010,ARSON,0,0,0,3,0,3,0,0,0,0,0,0,3,0,3
DELHI,2010,CRIMINAL BREACH OF TRUST,0,0,0,0,0,0,0,0,0,0,0,0,0,0,0
DELHI,2010,CHEATING,0,0,0,9,0,9,12,0,12,11,0,11,32,0,32
DELHI,2010,COUNTER FEITING,0,0,0,10,0,10,5,0,5,1,0,1,16,0,16
DELHI,2010,DOWRY DEATHS,0,0,0,25,0,25,35,3,38,10,6,16,70,9,79
DELHI,2010,MOLESTATION,0,0,0,3,0,3,3,0,3,1,0,1,7,0,7
DELHI,2010,EVE-TEASING,0,0,0,0,0,0,0,0,0,0,0,0,0,0,0
DELHI,2010,CRUELTY BY HUSBAND OR RELATIVE OF HUSBAND,0,0,0,0,0,0,0,0,0,0,0,0,0,0,0
DELHI,2010,OTHER IPC CRIMES,0,0,0,67,1,68,66,2,68,1,0,1,134,3,137
DELHI,2010,TOTAL IPC,0,0,0,1084,16,1100,979,52,1031,199,20,219,2262,88,2350
DELHI,2011,MURDER,0,0,0,439,8,447,510,37,547,118,9,127,1067,54,1121
DELHI,2011,ATTEMPT TO COMMIT MURDER,0,0,0,143,0,143,98,1,99,31,0,31,272,1,273
DELHI,2011,C.H. NOT AMOUNTING TO MURDER,0,0,0,9,1,10,0,2,2,1,3,4,10,6,16
DELHI,2011,RAPE,0,0,0,224,2,226,179,1,180,23,0,23,426,3,429
DELHI,2011,KIDNAPPING AND ABDUCTION,0,0,0,54,2,56,41,4,45,8,6,14,103,12,115
DELHI,2011,DACOITY,0,0,0,165,0,165,143,0,143,13,0,13,321,0,321
DELHI,2011,PREP. AND ASSEMBLY FOR DACOITY,0,0,0,9,0,9,3,0,3,0,0,0,12,0,12
DELHI,2011,ROBBERY,0,0,0,53,0,53,17,0,17,3,0,3,73,0,73
DELHI,2011,BURGLARY,0,0,0,4,0,4,0,0,0,0,0,0,4,0,4
DELHI,2011,THEFTS,0,0,0,56,1,57,63,1,64,16,0,16,135,2,137
DELHI,2011,EXTORTION,0,0,0,1,0,1,6,0,6,0,0,0,7,0,7
DELHI,2011,RIOTS,0,0,0,3,0,3,2,0,2,0,0,0,5,0,5
DELHI,2011,ARSON,0,0,0,1,0,1,1,0,1,0,0,0,2,0,2
DELHI,2011,CRIMINAL BREACH OF TRUST,0,0,0,4,0,4,0,0,0,0,0,0,4,0,4
DELHI,2011,CHEATING,0,0,0,13,0,13,15,1,16,17,0,17,45,1,46
DELHI,2011,COUNTER FEITING,0,0,0,4,0,4,3,0,3,0,0,0,7,0,7
DELHI,2011,DOWRY DEATHS,0,0,0,45,0,45,41,4,45,11,12,23,97,16,113
DELHI,2011,MOLESTATION,0,0,0,0,0,0,0,0,0,0,0,0,0,0,0
DELHI,2011,EVE-TEASING,0,0,0,0,0,0,0,0,0,0,0,0,0,0,0
DELHI,2011,CRUELTY BY HUSBAND OR RELATIVE OF HUSBAND,0,0,0,0,0,0,0,0,0,0,0,0,0,0,0
DELHI,2011,OTHER IPC CRIMES,0,0,0,8,3,11,1,2,3,3,1,4,12,6,18
DELHI,2011,TOTAL IPC,0,0,0,1235,17,1252,1123,53,1176,244,31,275,2602,101,2703
DELHI,2012,MURDER,0,0,0,424,12,436,508,37,545,127,12,139,1059,61,1120
DELHI,2012,ATTEMPT TO COMMIT MURDER,0,0,0,125,0,125,119,2,121,36,0,36,280,2,282
DELHI,2012,C.H. NOT AMOUNTING TO MURDER,0,0,0,9,3,12,2,3,5,1,1,2,12,7,19
DELHI,2012,RAPE,0,0,0,226,0,226,167,3,170,24,4,28,417,7,424
DELHI,2012,KIDNAPPING AND ABDUCTION,0,0,0,62,1,63,47,2,49,12,4,16,121,7,128
DELHI,2012,DACOITY,0,0,0,135,0,135,135,0,135,10,0,10,280,0,280
DELHI,2012,PREP. AND ASSEMBLY FOR DACOITY,0,0,0,7,0,7,5,0,5,0,0,0,12,0,12
DELHI,2012,ROBBERY,0,0,0,67,0,67,35,0,35,5,0,5,107,0,107
DELHI,2012,BURGLARY,0,0,0,5,0,5,2,0,2,0,0,0,7,0,7
DELHI,2012,THEFTS,0,0,0,66,1,67,77,2,79,16,0,16,159,3,162
DELHI,2012,EXTORTION,0,0,0,0,0,0,1,0,1,0,0,0,1,0,1
DELHI,2012,RIOTS,0,0,0,2,0,2,2,0,2,0,0,0,4,0,4
DELHI,2012,ARSON,0,0,0,0,0,0,0,0,0,0,0,0,0,0,0
DELHI,2012,CRIMINAL BREACH OF TRUST,0,0,0,2,0,2,0,0,0,0,0,0,2,0,2
DELHI,2012,CHEATING,0,0,0,13,0,13,18,0,18,16,0,16,47,0,47
DELHI,2012,COUNTER FEITING,0,0,0,3,0,3,6,0,6,1,0,1,10,0,10
DELHI,2012,DOWRY DEATHS,0,0,0,37,1,38,40,3,43,10,10,20,87,14,101
DELHI,2012,MOLESTATION,0,0,0,0,0,0,0,0,0,0,0,0,0,0,0
DELHI,2012,EVE-TEASING,0,0,0,0,0,0,0,0,0,0,0,0,0,0,0
DELHI,2012,CRUELTY BY HUSBAND OR RELATIVE OF HUSBAND,0,0,0,0,0,0,0,0,0,0,0,0,0,0,0
DELHI,2012,OTHER IPC CRIMES,0,0,0,4,2,6,1,2,3,6,1,7,11,5,16
DELHI,2012,TOTAL IPC,0,0,0,1187,20,1207,1165,54,1219,264,32,296,2616,106,2722
LAKSHADWEEP,2001,MURDER,0,0,0,0,0,0,0,0,0,0,0,0,0,0,0
LAKSHADWEEP,2001,ATTEMPT TO COMMIT MURDER,0,0,0,0,0,0,0,0,0,0,0,0,0,0,0
LAKSHADWEEP,2001,C.H. NOT AMOUNTING TO MURDER,0,0,0,0,0,0,0,0,0,0,0,0,0,0,0
LAKSHADWEEP,2001,RAPE,0,0,0,0,0,0,0,0,0,0,0,0,0,0,0
LAKSHADWEEP,2001,KIDNAPPING AND ABDUCTION,0,0,0,0,0,0,0,0,0,0,0,0,0,0,0
LAKSHADWEEP,2001,DACOITY,0,0,0,0,0,0,0,0,0,0,0,0,0,0,0
LAKSHADWEEP,2001,PREP. AND ASSEMBLY FOR DACOITY,0,0,0,0,0,0,0,0,0,0,0,0,0,0,0
LAKSHADWEEP,2001,ROBBERY,0,0,0,0,0,0,0,0,0,0,0,0,0,0,0
LAKSHADWEEP,2001,BURGLARY,0,0,0,0,0,0,0,0,0,0,0,0,0,0,0
LAKSHADWEEP,2001,THEFTS,0,0,0,0,0,0,0,0,0,0,0,0,0,0,0
LAKSHADWEEP,2001,EXTORTION,0,0,0,0,0,0,0,0,0,0,0,0,0,0,0
LAKSHADWEEP,2001,RIOTS,0,0,0,0,0,0,0,0,0,0,0,0,0,0,0
LAKSHADWEEP,2001,ARSON,0,0,0,0,0,0,0,0,0,0,0,0,0,0,0
LAKSHADWEEP,2001,CRIMINAL BREACH OF TRUST,0,0,0,0,0,0,0,0,0,0,0,0,0,0,0
LAKSHADWEEP,2001,CHEATING,0,0,0,0,0,0,0,0,0,0,0,0,0,0,0
LAKSHADWEEP,2001,COUNTER FEITING,0,0,0,0,0,0,0,0,0,0,0,0,0,0,0
LAKSHADWEEP,2001,DOWRY DEATHS,0,0,0,0,0,0,0,0,0,0,0,0,0,0,0
LAKSHADWEEP,2001,MOLESTATION,0,0,0,0,0,0,0,0,0,0,0,0,0,0,0
LAKSHADWEEP,2001,EVE-TEASING,0,0,0,0,0,0,0,0,0,0,0,0,0,0,0
LAKSHADWEEP,2001,CRUELTY BY HUSBAND OR RELATIVE OF HUSBAND,0,0,0,0,0,0,0,0,0,0,0,0,0,0,0
LAKSHADWEEP,2001,OTHER IPC CRIMES,0,0,0,0,0,0,0,0,0,0,0,0,0,0,0
LAKSHADWEEP,2001,TOTAL IPC,0,0,0,0,0,0,0,0,0,0,0,0,0,0,0
LAKSHADWEEP,2002,MURDER,0,0,0,0,0,0,0,0,0,0,0,0,0,0,0
LAKSHADWEEP,2002,ATTEMPT TO COMMIT MURDER,0,0,0,0,0,0,0,0,0,0,0,0,0,0,0
LAKSHADWEEP,2002,C.H. NOT AMOUNTING TO MURDER,0,0,0,0,0,0,0,0,0,0,0,0,0,0,0
LAKSHADWEEP,2002,RAPE,0,0,0,0,0,0,0,0,0,0,0,0,0,0,0
LAKSHADWEEP,2002,KIDNAPPING AND ABDUCTION,0,0,0,0,0,0,0,0,0,0,0,0,0,0,0
LAKSHADWEEP,2002,DACOITY,0,0,0,0,0,0,0,0,0,0,0,0,0,0,0
LAKSHADWEEP,2002,PREP. AND ASSEMBLY FOR DACOITY,0,0,0,0,0,0,0,0,0,0,0,0,0,0,0
LAKSHADWEEP,2002,ROBBERY,0,0,0,0,0,0,0,0,0,0,0,0,0,0,0
LAKSHADWEEP,2002,BURGLARY,0,0,0,0,0,0,0,0,0,0,0,0,0,0,0
LAKSHADWEEP,2002,THEFTS,0,0,0,0,0,0,0,0,0,0,0,0,0,0,0
LAKSHADWEEP,2002,EXTORTION,0,0,0,0,0,0,0,0,0,0,0,0,0,0,0
LAKSHADWEEP,2002,RIOTS,0,0,0,0,0,0,0,0,0,0,0,0,0,0,0
LAKSHADWEEP,2002,ARSON,0,0,0,0,0,0,0,0,0,0,0,0,0,0,0
LAKSHADWEEP,2002,CRIMINAL BREACH OF TRUST,0,0,0,0,0,0,0,0,0,0,0,0,0,0,0
LAKSHADWEEP,2002,CHEATING,0,0,0,0,0,0,0,0,0,0,0,0,0,0,0
LAKSHADWEEP,2002,COUNTER FEITING,0,0,0,0,0,0,0,0,0,0,0,0,0,0,0
LAKSHADWEEP,2002,DOWRY DEATHS,0,0,0,0,0,0,0,0,0,0,0,0,0,0,0
LAKSHADWEEP,2002,MOLESTATION,0,0,0,0,0,0,0,0,0,0,0,0,0,0,0
LAKSHADWEEP,2002,EVE-TEASING,0,0,0,0,0,0,0,0,0,0,0,0,0,0,0
LAKSHADWEEP,2002,CRUELTY BY HUSBAND OR RELATIVE OF HUSBAND,0,0,0,0,0,0,0,0,0,0,0,0,0,0,0
LAKSHADWEEP,2002,OTHER IPC CRIMES,0,0,0,0,0,0,2,0,2,0,0,0,2,0,2
LAKSHADWEEP,2002,TOTAL IPC,0,0,0,0,0,0,2,0,2,0,0,0,2,0,2
LAKSHADWEEP,2003,MURDER,0,0,0,0,0,0,0,0,0,0,0,0,0,0,0
LAKSHADWEEP,2003,ATTEMPT TO COMMIT MURDER,0,0,0,0,0,0,0,0,0,0,0,0,0,0,0
LAKSHADWEEP,2003,C.H. NOT AMOUNTING TO MURDER,0,0,0,0,0,0,0,0,0,0,0,0,0,0,0
LAKSHADWEEP,2003,RAPE,0,0,0,0,0,0,0,0,0,0,0,0,0,0,0
LAKSHADWEEP,2003,KIDNAPPING AND ABDUCTION,0,0,0,0,0,0,0,0,0,0,0,0,0,0,0
LAKSHADWEEP,2003,DACOITY,0,0,0,0,0,0,0,0,0,0,0,0,0,0,0
LAKSHADWEEP,2003,PREP. AND ASSEMBLY FOR DACOITY,0,0,0,0,0,0,0,0,0,0,0,0,0,0,0
LAKSHADWEEP,2003,ROBBERY,0,0,0,0,0,0,0,0,0,0,0,0,0,0,0
LAKSHADWEEP,2003,BURGLARY,0,0,0,0,0,0,0,0,0,0,0,0,0,0,0
LAKSHADWEEP,2003,THEFTS,0,0,0,0,0,0,0,0,0,0,0,0,0,0,0
LAKSHADWEEP,2003,EXTORTION,0,0,0,0,0,0,0,0,0,0,0,0,0,0,0
LAKSHADWEEP,2003,RIOTS,0,0,0,0,0,0,0,0,0,0,0,0,0,0,0
LAKSHADWEEP,2003,ARSON,0,0,0,0,0,0,0,0,0,0,0,0,0,0,0
LAKSHADWEEP,2003,CRIMINAL BREACH OF TRUST,0,0,0,0,0,0,0,0,0,0,0,0,0,0,0
LAKSHADWEEP,2003,CHEATING,0,0,0,0,0,0,0,0,0,0,0,0,0,0,0
LAKSHADWEEP,2003,COUNTER FEITING,0,0,0,0,0,0,0,0,0,0,0,0,0,0,0
LAKSHADWEEP,2003,DOWRY DEATHS,0,0,0,0,0,0,0,0,0,0,0,0,0,0,0
LAKSHADWEEP,2003,MOLESTATION,0,0,0,0,0,0,0,0,0,0,0,0,0,0,0
LAKSHADWEEP,2003,EVE-TEASING,0,0,0,0,0,0,0,0,0,0,0,0,0,0,0
LAKSHADWEEP,2003,CRUELTY BY HUSBAND OR RELATIVE OF HUSBAND,0,0,0,0,0,0,0,0,0,0,0,0,0,0,0
LAKSHADWEEP,2003,OTHER IPC CRIMES,0,0,0,0,0,0,0,0,0,0,0,0,0,0,0
LAKSHADWEEP,2003,TOTAL IPC,0,0,0,0,0,0,0,0,0,0,0,0,0,0,0
LAKSHADWEEP,2004,MURDER,0,0,0,0,0,0,0,0,0,0,0,0,0,0,0
LAKSHADWEEP,2004,ATTEMPT TO COMMIT MURDER,0,0,0,0,0,0,0,0,0,0,0,0,0,0,0
LAKSHADWEEP,2004,C.H. NOT AMOUNTING TO MURDER,0,0,0,0,0,0,0,0,0,0,0,0,0,0,0
LAKSHADWEEP,2004,RAPE,0,0,0,0,0,0,0,0,0,0,0,0,0,0,0
LAKSHADWEEP,2004,KIDNAPPING AND ABDUCTION,0,0,0,0,0,0,0,0,0,0,0,0,0,0,0
LAKSHADWEEP,2004,DACOITY,0,0,0,0,0,0,0,0,0,0,0,0,0,0,0
LAKSHADWEEP,2004,PREP. AND ASSEMBLY FOR DACOITY,0,0,0,0,0,0,0,0,0,0,0,0,0,0,0
LAKSHADWEEP,2004,ROBBERY,0,0,0,0,0,0,0,0,0,0,0,0,0,0,0
LAKSHADWEEP,2004,BURGLARY,0,0,0,0,0,0,0,0,0,0,0,0,0,0,0
LAKSHADWEEP,2004,THEFTS,0,0,0,0,0,0,0,0,0,0,0,0,0,0,0
LAKSHADWEEP,2004,EXTORTION,0,0,0,0,0,0,0,0,0,0,0,0,0,0,0
LAKSHADWEEP,2004,RIOTS,0,0,0,0,0,0,0,0,0,0,0,0,0,0,0
LAKSHADWEEP,2004,ARSON,0,0,0,0,0,0,0,0,0,0,0,0,0,0,0
LAKSHADWEEP,2004,CRIMINAL BREACH OF TRUST,0,0,0,0,0,0,0,0,0,0,0,0,0,0,0
LAKSHADWEEP,2004,CHEATING,0,0,0,0,0,0,0,0,0,0,0,0,0,0,0
LAKSHADWEEP,2004,COUNTER FEITING,0,0,0,0,0,0,0,0,0,0,0,0,0,0,0
LAKSHADWEEP,2004,DOWRY DEATHS,0,0,0,0,0,0,0,0,0,0,0,0,0,0,0
LAKSHADWEEP,2004,MOLESTATION,0,0,0,0,0,0,0,0,0,0,0,0,0,0,0
LAKSHADWEEP,2004,EVE-TEASING,0,0,0,0,0,0,0,0,0,0,0,0,0,0,0
LAKSHADWEEP,2004,CRUELTY BY HUSBAND OR RELATIVE OF HUSBAND,0,0,0,0,0,0,0,0,0,0,0,0,0,0,0
LAKSHADWEEP,2004,OTHER IPC CRIMES,0,0,0,0,0,0,0,0,0,0,0,0,0,0,0
LAKSHADWEEP,2004,TOTAL IPC,0,0,0,0,0,0,0,0,0,0,0,0,0,0,0
LAKSHADWEEP,2005,MURDER,0,0,0,0,0,0,0,0,0,0,0,0,0,0,0
LAKSHADWEEP,2005,ATTEMPT TO COMMIT MURDER,0,0,0,0,0,0,0,0,0,0,0,0,0,0,0
LAKSHADWEEP,2005,C.H. NOT AMOUNTING TO MURDER,0,0,0,0,0,0,0,0,0,0,0,0,0,0,0
LAKSHADWEEP,2005,RAPE,0,0,0,0,0,0,0,0,0,0,0,0,0,0,0
LAKSHADWEEP,2005,KIDNAPPING AND ABDUCTION,0,0,0,0,0,0,0,0,0,0,0,0,0,0,0
LAKSHADWEEP,2005,DACOITY,0,0,0,0,0,0,0,0,0,0,0,0,0,0,0
LAKSHADWEEP,2005,PREP. AND ASSEMBLY FOR DACOITY,0,0,0,0,0,0,0,0,0,0,0,0,0,0,0
LAKSHADWEEP,2005,ROBBERY,0,0,0,0,0,0,0,0,0,0,0,0,0,0,0
LAKSHADWEEP,2005,BURGLARY,0,0,0,0,0,0,0,0,0,0,0,0,0,0,0
LAKSHADWEEP,2005,THEFTS,0,0,0,0,0,0,0,0,0,0,0,0,0,0,0
LAKSHADWEEP,2005,EXTORTION,0,0,0,0,0,0,0,0,0,0,0,0,0,0,0
LAKSHADWEEP,2005,RIOTS,0,0,0,0,0,0,0,0,0,0,0,0,0,0,0
LAKSHADWEEP,2005,ARSON,0,0,0,0,0,0,0,0,0,0,0,0,0,0,0
LAKSHADWEEP,2005,CRIMINAL BREACH OF TRUST,0,0,0,0,0,0,0,0,0,0,0,0,0,0,0
LAKSHADWEEP,2005,CHEATING,0,0,0,0,0,0,0,0,0,0,0,0,0,0,0
LAKSHADWEEP,2005,COUNTER FEITING,0,0,0,0,0,0,0,0,0,0,0,0,0,0,0
LAKSHADWEEP,2005,DOWRY DEATHS,0,0,0,0,0,0,0,0,0,0,0,0,0,0,0
LAKSHADWEEP,2005,MOLESTATION,0,0,0,0,0,0,0,0,0,0,0,0,0,0,0
LAKSHADWEEP,2005,EVE-TEASING,0,0,0,0,0,0,0,0,0,0,0,0,0,0,0
LAKSHADWEEP,2005,CRUELTY BY HUSBAND OR RELATIVE OF HUSBAND,0,0,0,0,0,0,0,0,0,0,0,0,0,0,0
LAKSHADWEEP,2005,OTHER IPC CRIMES,0,0,0,0,0,0,0,0,0,0,0,0,0,0,0
LAKSHADWEEP,2005,TOTAL IPC,0,0,0,0,0,0,0,0,0,0,0,0,0,0,0
LAKSHADWEEP,2006,MURDER,0,0,0,0,0,0,0,0,0,0,0,0,0,0,0
LAKSHADWEEP,2006,ATTEMPT TO COMMIT MURDER,0,0,0,0,0,0,0,0,0,0,0,0,0,0,0
LAKSHADWEEP,2006,C.H. NOT AMOUNTING TO MURDER,0,0,0,0,0,0,0,0,0,0,0,0,0,0,0
LAKSHADWEEP,2006,RAPE,0,0,0,0,0,0,0,0,0,0,0,0,0,0,0
LAKSHADWEEP,2006,KIDNAPPING AND ABDUCTION,0,0,0,0,0,0,0,0,0,0,0,0,0,0,0
LAKSHADWEEP,2006,DACOITY,0,0,0,0,0,0,0,0,0,0,0,0,0,0,0
LAKSHADWEEP,2006,PREP. AND ASSEMBLY FOR DACOITY,0,0,0,0,0,0,0,0,0,0,0,0,0,0,0
LAKSHADWEEP,2006,ROBBERY,0,0,0,0,0,0,0,0,0,0,0,0,0,0,0
LAKSHADWEEP,2006,BURGLARY,0,0,0,0,0,0,0,0,0,0,0,0,0,0,0
LAKSHADWEEP,2006,THEFTS,0,0,0,0,0,0,0,0,0,0,0,0,0,0,0
LAKSHADWEEP,2006,EXTORTION,0,0,0,0,0,0,0,0,0,0,0,0,0,0,0
LAKSHADWEEP,2006,RIOTS,0,0,0,0,0,0,0,0,0,0,0,0,0,0,0
LAKSHADWEEP,2006,ARSON,0,0,0,0,0,0,0,0,0,0,0,0,0,0,0
LAKSHADWEEP,2006,CRIMINAL BREACH OF TRUST,0,0,0,0,0,0,0,0,0,0,0,0,0,0,0
LAKSHADWEEP,2006,CHEATING,0,0,0,0,0,0,0,0,0,0,0,0,0,0,0
LAKSHADWEEP,2006,COUNTER FEITING,0,0,0,0,0,0,0,0,0,0,0,0,0,0,0
LAKSHADWEEP,2006,DOWRY DEATHS,0,0,0,0,0,0,0,0,0,0,0,0,0,0,0
LAKSHADWEEP,2006,MOLESTATION,0,0,0,0,0,0,0,0,0,0,0,0,0,0,0
LAKSHADWEEP,2006,EVE-TEASING,0,0,0,0,0,0,0,0,0,0,0,0,0,0,0
LAKSHADWEEP,2006,CRUELTY BY HUSBAND OR RELATIVE OF HUSBAND,0,0,0,0,0,0,0,0,0,0,0,0,0,0,0
LAKSHADWEEP,2006,OTHER IPC CRIMES,0,0,0,0,0,0,0,0,0,0,0,0,0,0,0
LAKSHADWEEP,2006,TOTAL IPC,0,0,0,0,0,0,0,0,0,0,0,0,0,0,0
LAKSHADWEEP,2007,MURDER,0,0,0,0,0,0,1,0,1,0,0,0,1,0,1
LAKSHADWEEP,2007,ATTEMPT TO COMMIT MURDER,0,0,0,0,0,0,0,0,0,0,0,0,0,0,0
LAKSHADWEEP,2007,C.H. NOT AMOUNTING TO MURDER,0,0,0,0,0,0,0,0,0,0,0,0,0,0,0
LAKSHADWEEP,2007,RAPE,0,0,0,2,0,2,0,0,0,0,0,0,2,0,2
LAKSHADWEEP,2007,KIDNAPPING AND ABDUCTION,0,0,0,0,0,0,0,0,0,0,0,0,0,0,0
LAKSHADWEEP,2007,DACOITY,0,0,0,0,0,0,0,0,0,0,0,0,0,0,0
LAKSHADWEEP,2007,PREP. AND ASSEMBLY FOR DACOITY,0,0,0,0,0,0,0,0,0,0,0,0,0,0,0
LAKSHADWEEP,2007,ROBBERY,0,0,0,0,0,0,0,0,0,0,0,0,0,0,0
LAKSHADWEEP,2007,BURGLARY,0,0,0,0,0,0,0,0,0,0,0,0,0,0,0
LAKSHADWEEP,2007,THEFTS,0,0,0,0,0,0,0,0,0,0,0,0,0,0,0
LAKSHADWEEP,2007,EXTORTION,0,0,0,0,0,0,0,0,0,0,0,0,0,0,0
LAKSHADWEEP,2007,RIOTS,0,0,0,0,0,0,0,0,0,0,0,0,0,0,0
LAKSHADWEEP,2007,ARSON,0,0,0,0,0,0,0,0,0,0,0,0,0,0,0
LAKSHADWEEP,2007,CRIMINAL BREACH OF TRUST,0,0,0,0,0,0,0,0,0,0,0,0,0,0,0
LAKSHADWEEP,2007,CHEATING,0,0,0,0,0,0,0,0,0,0,0,0,0,0,0
LAKSHADWEEP,2007,COUNTER FEITING,0,0,0,0,0,0,0,0,0,0,0,0,0,0,0
LAKSHADWEEP,2007,DOWRY DEATHS,0,0,0,0,0,0,0,0,0,0,0,0,0,0,0
LAKSHADWEEP,2007,MOLESTATION,0,0,0,0,0,0,0,0,0,0,0,0,0,0,0
LAKSHADWEEP,2007,EVE-TEASING,0,0,0,0,0,0,0,0,0,0,0,0,0,0,0
LAKSHADWEEP,2007,CRUELTY BY HUSBAND OR RELATIVE OF HUSBAND,0,0,0,0,0,0,0,0,0,0,0,0,0,0,0
LAKSHADWEEP,2007,OTHER IPC CRIMES,0,0,0,0,0,0,0,0,0,0,0,0,0,0,0
LAKSHADWEEP,2007,TOTAL IPC,0,0,0,2,0,2,1,0,1,0,0,0,3,0,3
LAKSHADWEEP,2008,MURDER,0,0,0,0,0,0,0,0,0,0,0,0,0,0,0
LAKSHADWEEP,2008,ATTEMPT TO COMMIT MURDER,0,0,0,0,0,0,0,0,0,0,0,0,0,0,0
LAKSHADWEEP,2008,C.H. NOT AMOUNTING TO MURDER,0,0,0,0,0,0,0,0,0,0,0,0,0,0,0
LAKSHADWEEP,2008,RAPE,0,0,0,0,0,0,0,0,0,0,0,0,0,0,0
LAKSHADWEEP,2008,KIDNAPPING AND ABDUCTION,0,0,0,0,0,0,0,0,0,0,0,0,0,0,0
LAKSHADWEEP,2008,DACOITY,0,0,0,0,0,0,0,0,0,0,0,0,0,0,0
LAKSHADWEEP,2008,PREP. AND ASSEMBLY FOR DACOITY,0,0,0,0,0,0,0,0,0,0,0,0,0,0,0
LAKSHADWEEP,2008,ROBBERY,0,0,0,0,0,0,0,0,0,0,0,0,0,0,0
LAKSHADWEEP,2008,BURGLARY,0,0,0,0,0,0,0,0,0,0,0,0,0,0,0
LAKSHADWEEP,2008,THEFTS,0,0,0,0,0,0,0,0,0,0,0,0,0,0,0
LAKSHADWEEP,2008,EXTORTION,0,0,0,0,0,0,0,0,0,0,0,0,0,0,0
LAKSHADWEEP,2008,RIOTS,0,0,0,0,0,0,0,0,0,0,0,0,0,0,0
LAKSHADWEEP,2008,ARSON,0,0,0,0,0,0,0,0,0,0,0,0,0,0,0
LAKSHADWEEP,2008,CRIMINAL BREACH OF TRUST,0,0,0,0,0,0,0,0,0,0,0,0,0,0,0
LAKSHADWEEP,2008,CHEATING,0,0,0,0,0,0,0,0,0,0,0,0,0,0,0
LAKSHADWEEP,2008,COUNTER FEITING,0,0,0,0,0,0,0,0,0,0,0,0,0,0,0
LAKSHADWEEP,2008,DOWRY DEATHS,0,0,0,0,0,0,0,0,0,0,0,0,0,0,0
LAKSHADWEEP,2008,MOLESTATION,0,0,0,0,0,0,0,0,0,0,0,0,0,0,0
LAKSHADWEEP,2008,EVE-TEASING,0,0,0,0,0,0,0,0,0,0,0,0,0,0,0
LAKSHADWEEP,2008,CRUELTY BY HUSBAND OR RELATIVE OF HUSBAND,0,0,0,0,0,0,0,0,0,0,0,0,0,0,0
LAKSHADWEEP,2008,OTHER IPC CRIMES,0,0,0,0,0,0,0,0,0,0,0,0,0,0,0
LAKSHADWEEP,2008,TOTAL IPC,0,0,0,0,0,0,0,0,0,0,0,0,0,0,0
LAKSHADWEEP,2009,MURDER,0,0,0,0,0,0,0,0,0,0,0,0,0,0,0
LAKSHADWEEP,2009,ATTEMPT TO COMMIT MURDER,0,0,0,0,0,0,1,0,1,0,0,0,1,0,1
LAKSHADWEEP,2009,C.H. NOT AMOUNTING TO MURDER,0,0,0,0,0,0,0,0,0,0,0,0,0,0,0
LAKSHADWEEP,2009,RAPE,0,0,0,0,0,0,0,0,0,0,0,0,0,0,0
LAKSHADWEEP,2009,KIDNAPPING AND ABDUCTION,0,0,0,0,0,0,0,0,0,0,0,0,0,0,0
LAKSHADWEEP,2009,DACOITY,0,0,0,0,0,0,0,0,0,0,0,0,0,0,0
LAKSHADWEEP,2009,PREP. AND ASSEMBLY FOR DACOITY,0,0,0,0,0,0,0,0,0,0,0,0,0,0,0
LAKSHADWEEP,2009,ROBBERY,0,0,0,0,0,0,0,0,0,0,0,0,0,0,0
LAKSHADWEEP,2009,BURGLARY,0,0,0,0,0,0,0,0,0,0,0,0,0,0,0
LAKSHADWEEP,2009,THEFTS,0,0,0,0,0,0,0,0,0,0,0,0,0,0,0
LAKSHADWEEP,2009,EXTORTION,0,0,0,0,0,0,0,0,0,0,0,0,0,0,0
LAKSHADWEEP,2009,RIOTS,0,0,0,0,0,0,0,0,0,0,0,0,0,0,0
LAKSHADWEEP,2009,ARSON,0,0,0,0,0,0,0,0,0,0,0,0,0,0,0
LAKSHADWEEP,2009,CRIMINAL BREACH OF TRUST,0,0,0,0,0,0,0,0,0,0,0,0,0,0,0
LAKSHADWEEP,2009,CHEATING,0,0,0,0,0,0,0,0,0,0,0,0,0,0,0
LAKSHADWEEP,2009,COUNTER FEITING,0,0,0,0,0,0,0,0,0,0,0,0,0,0,0
LAKSHADWEEP,2009,DOWRY DEATHS,0,0,0,0,0,0,0,0,0,0,0,0,0,0,0
LAKSHADWEEP,2009,MOLESTATION,0,0,0,0,0,0,0,0,0,0,0,0,0,0,0
LAKSHADWEEP,2009,EVE-TEASING,0,0,0,0,0,0,0,0,0,0,0,0,0,0,0
LAKSHADWEEP,2009,CRUELTY BY HUSBAND OR RELATIVE OF HUSBAND,0,0,0,0,0,0,0,0,0,0,0,0,0,0,0
LAKSHADWEEP,2009,OTHER IPC CRIMES,0,0,0,0,0,0,0,0,0,0,0,0,0,0,0
LAKSHADWEEP,2009,TOTAL IPC,0,0,0,0,0,0,1,0,1,0,0,0,1,0,1
LAKSHADWEEP,2010,MURDER,0,0,0,0,0,0,0,0,0,0,0,0,0,0,0
LAKSHADWEEP,2010,ATTEMPT TO COMMIT MURDER,0,0,0,0,0,0,0,0,0,0,0,0,0,0,0
LAKSHADWEEP,2010,C.H. NOT AMOUNTING TO MURDER,0,0,0,0,0,0,0,0,0,0,0,0,0,0,0
LAKSHADWEEP,2010,RAPE,0,0,0,0,0,0,0,0,0,0,0,0,0,0,0
LAKSHADWEEP,2010,KIDNAPPING AND ABDUCTION,0,0,0,0,0,0,0,0,0,0,0,0,0,0,0
LAKSHADWEEP,2010,DACOITY,0,0,0,0,0,0,0,0,0,0,0,0,0,0,0
LAKSHADWEEP,2010,PREP. AND ASSEMBLY FOR DACOITY,0,0,0,0,0,0,0,0,0,0,0,0,0,0,0
LAKSHADWEEP,2010,ROBBERY,0,0,0,0,0,0,0,0,0,0,0,0,0,0,0
LAKSHADWEEP,2010,BURGLARY,0,0,0,0,0,0,0,0,0,0,0,0,0,0,0
LAKSHADWEEP,2010,THEFTS,0,0,0,0,0,0,0,0,0,0,0,0,0,0,0
LAKSHADWEEP,2010,EXTORTION,0,0,0,0,0,0,0,0,0,0,0,0,0,0,0
LAKSHADWEEP,2010,RIOTS,0,0,0,0,0,0,0,0,0,0,0,0,0,0,0
LAKSHADWEEP,2010,ARSON,0,0,0,0,0,0,0,0,0,0,0,0,0,0,0
LAKSHADWEEP,2010,CRIMINAL BREACH OF TRUST,0,0,0,0,0,0,0,0,0,0,0,0,0,0,0
LAKSHADWEEP,2010,CHEATING,0,0,0,0,0,0,0,0,0,0,0,0,0,0,0
LAKSHADWEEP,2010,COUNTER FEITING,0,0,0,0,0,0,0,0,0,0,0,0,0,0,0
LAKSHADWEEP,2010,DOWRY DEATHS,0,0,0,0,0,0,0,0,0,0,0,0,0,0,0
LAKSHADWEEP,2010,MOLESTATION,0,0,0,0,0,0,0,0,0,0,0,0,0,0,0
LAKSHADWEEP,2010,EVE-TEASING,0,0,0,0,0,0,0,0,0,0,0,0,0,0,0
LAKSHADWEEP,2010,CRUELTY BY HUSBAND OR RELATIVE OF HUSBAND,0,0,0,0,0,0,0,0,0,0,0,0,0,0,0
LAKSHADWEEP,2010,OTHER IPC CRIMES,0,0,0,0,0,0,0,0,0,0,0,0,0,0,0
LAKSHADWEEP,2010,TOTAL IPC,0,0,0,0,0,0,0,0,0,0,0,0,0,0,0
LAKSHADWEEP,2011,MURDER,0,0,0,0,0,0,0,0,0,0,0,0,0,0,0
LAKSHADWEEP,2011,ATTEMPT TO COMMIT MURDER,0,0,0,0,0,0,0,0,0,0,0,0,0,0,0
LAKSHADWEEP,2011,C.H. NOT AMOUNTING TO MURDER,0,0,0,0,0,0,0,0,0,0,0,0,0,0,0
LAKSHADWEEP,2011,RAPE,0,0,0,0,0,0,0,0,0,0,0,0,0,0,0
LAKSHADWEEP,2011,KIDNAPPING AND ABDUCTION,0,0,0,0,0,0,0,0,0,0,0,0,0,0,0
LAKSHADWEEP,2011,DACOITY,0,0,0,0,0,0,0,0,0,0,0,0,0,0,0
LAKSHADWEEP,2011,PREP. AND ASSEMBLY FOR DACOITY,0,0,0,0,0,0,0,0,0,0,0,0,0,0,0
LAKSHADWEEP,2011,ROBBERY,0,0,0,0,0,0,0,0,0,0,0,0,0,0,0
LAKSHADWEEP,2011,BURGLARY,0,0,0,0,0,0,0,0,0,0,0,0,0,0,0
LAKSHADWEEP,2011,THEFTS,0,0,0,0,0,0,0,0,0,0,0,0,0,0,0
LAKSHADWEEP,2011,EXTORTION,0,0,0,0,0,0,0,0,0,0,0,0,0,0,0
LAKSHADWEEP,2011,RIOTS,0,0,0,0,0,0,0,0,0,0,0,0,0,0,0
LAKSHADWEEP,2011,ARSON,0,0,0,0,0,0,0,0,0,0,0,0,0,0,0
LAKSHADWEEP,2011,CRIMINAL BREACH OF TRUST,0,0,0,0,0,0,0,0,0,0,0,0,0,0,0
LAKSHADWEEP,2011,CHEATING,0,0,0,0,0,0,0,0,0,0,0,0,0,0,0
LAKSHADWEEP,2011,COUNTER FEITING,0,0,0,0,0,0,0,0,0,0,0,0,0,0,0
LAKSHADWEEP,2011,DOWRY DEATHS,0,0,0,0,0,0,0,0,0,0,0,0,0,0,0
LAKSHADWEEP,2011,MOLESTATION,0,0,0,0,0,0,0,0,0,0,0,0,0,0,0
LAKSHADWEEP,2011,EVE-TEASING,0,0,0,0,0,0,0,0,0,0,0,0,0,0,0
LAKSHADWEEP,2011,CRUELTY BY HUSBAND OR RELATIVE OF HUSBAND,0,0,0,0,0,0,0,0,0,0,0,0,0,0,0
LAKSHADWEEP,2011,OTHER IPC CRIMES,0,0,0,0,0,0,0,0,0,0,0,0,0,0,0
LAKSHADWEEP,2011,TOTAL IPC,0,0,0,0,0,0,0,0,0,0,0,0,0,0,0
LAKSHADWEEP,2012,MURDER,0,0,0,0,0,0,0,0,0,0,0,0,0,0,0
LAKSHADWEEP,2012,ATTEMPT TO COMMIT MURDER,0,0,0,0,0,0,0,0,0,0,0,0,0,0,0
LAKSHADWEEP,2012,C.H. NOT AMOUNTING TO MURDER,0,0,0,0,0,0,0,0,0,0,0,0,0,0,0
LAKSHADWEEP,2012,RAPE,0,0,0,0,0,0,0,0,0,0,0,0,0,0,0
LAKSHADWEEP,2012,KIDNAPPING AND ABDUCTION,0,0,0,0,0,0,0,0,0,0,0,0,0,0,0
LAKSHADWEEP,2012,DACOITY,0,0,0,0,0,0,0,0,0,0,0,0,0,0,0
LAKSHADWEEP,2012,PREP. AND ASSEMBLY FOR DACOITY,0,0,0,0,0,0,0,0,0,0,0,0,0,0,0
LAKSHADWEEP,2012,ROBBERY,0,0,0,0,0,0,0,0,0,0,0,0,0,0,0
LAKSHADWEEP,2012,BURGLARY,0,0,0,0,0,0,0,0,0,0,0,0,0,0,0
LAKSHADWEEP,2012,THEFTS,0,0,0,0,0,0,0,0,0,0,0,0,0,0,0
LAKSHADWEEP,2012,EXTORTION,0,0,0,0,0,0,0,0,0,0,0,0,0,0,0
LAKSHADWEEP,2012,RIOTS,0,0,0,0,0,0,0,0,0,0,0,0,0,0,0
LAKSHADWEEP,2012,ARSON,0,0,0,0,0,0,0,0,0,0,0,0,0,0,0
LAKSHADWEEP,2012,CRIMINAL BREACH OF TRUST,0,0,0,0,0,0,0,0,0,0,0,0,0,0,0
LAKSHADWEEP,2012,CHEATING,0,0,0,0,0,0,0,0,0,0,0,0,0,0,0
LAKSHADWEEP,2012,COUNTER FEITING,0,0,0,0,0,0,0,0,0,0,0,0,0,0,0
LAKSHADWEEP,2012,DOWRY DEATHS,0,0,0,0,0,0,0,0,0,0,0,0,0,0,0
LAKSHADWEEP,2012,MOLESTATION,0,0,0,0,0,0,0,0,0,0,0,0,0,0,0
LAKSHADWEEP,2012,EVE-TEASING,0,0,0,0,0,0,0,0,0,0,0,0,0,0,0
LAKSHADWEEP,2012,CRUELTY BY HUSBAND OR RELATIVE OF HUSBAND,0,0,0,0,0,0,0,0,0,0,0,0,0,0,0
LAKSHADWEEP,2012,OTHER IPC CRIMES,0,0,0,0,0,0,0,0,0,0,0,0,0,0,0
LAKSHADWEEP,2012,TOTAL IPC,0,0,0,0,0,0,0,0,0,0,0,0,0,0,0
PONDICHERRY,2001,MURDER,0,0,0,28,0,28,32,0,32,12,0,12,72,0,72
PONDICHERRY,2001,ATTEMPT TO COMMIT MURDER,0,0,0,4,0,4,0,0,0,0,0,0,4,0,4
PONDICHERRY,2001,C.H. NOT AMOUNTING TO MURDER,0,0,0,0,0,0,0,0,0,0,0,0,0,0,0
PONDICHERRY,2001,RAPE,0,0,0,0,0,0,0,0,0,0,0,0,0,0,0
PONDICHERRY,2001,KIDNAPPING AND ABDUCTION,0,0,0,0,0,0,1,0,1,0,0,0,1,0,1
PONDICHERRY,2001,DACOITY,0,0,0,0,0,0,0,0,0,0,0,0,0,0,0
PONDICHERRY,2001,PREP. AND ASSEMBLY FOR DACOITY,0,0,0,0,0,0,0,0,0,0,0,0,0,0,0
PONDICHERRY,2001,ROBBERY,0,0,0,2,0,2,0,0,0,0,0,0,2,0,2
PONDICHERRY,2001,BURGLARY,0,0,0,0,0,0,0,0,0,0,0,0,0,0,0
PONDICHERRY,2001,THEFTS,0,0,0,8,0,8,16,0,16,0,0,0,24,0,24
PONDICHERRY,2001,EXTORTION,0,0,0,0,0,0,0,0,0,0,0,0,0,0,0
PONDICHERRY,2001,RIOTS,0,0,0,0,0,0,0,0,0,0,0,0,0,0,0
PONDICHERRY,2001,ARSON,0,0,0,0,0,0,0,0,0,0,0,0,0,0,0
PONDICHERRY,2001,CRIMINAL BREACH OF TRUST,0,0,0,0,0,0,0,0,0,0,0,0,0,0,0
PONDICHERRY,2001,CHEATING,0,0,0,0,0,0,1,0,1,0,0,0,1,0,1
PONDICHERRY,2001,COUNTER FEITING,0,0,0,0,0,0,0,0,0,0,0,0,0,0,0
PONDICHERRY,2001,DOWRY DEATHS,0,0,0,0,0,0,0,0,0,0,0,0,0,0,0
PONDICHERRY,2001,MOLESTATION,0,0,0,0,0,0,0,0,0,0,0,0,0,0,0
PONDICHERRY,2001,EVE-TEASING,0,0,0,0,0,0,0,0,0,0,0,0,0,0,0
PONDICHERRY,2001,CRUELTY BY HUSBAND OR RELATIVE OF HUSBAND,0,0,0,0,0,0,0,0,0,0,0,0,0,0,0
PONDICHERRY,2001,OTHER IPC CRIMES,0,0,0,1,0,1,0,0,0,0,0,0,1,0,1
PONDICHERRY,2001,TOTAL IPC,0,0,0,43,0,43,50,0,50,12,0,12,105,0,105
PONDICHERRY,2002,MURDER,0,0,0,33,0,33,48,0,48,4,0,4,85,0,85
PONDICHERRY,2002,ATTEMPT TO COMMIT MURDER,0,0,0,5,0,5,0,0,0,0,0,0,5,0,5
PONDICHERRY,2002,C.H. NOT AMOUNTING TO MURDER,0,0,0,1,0,1,2,0,2,0,0,0,3,0,3
PONDICHERRY,2002,RAPE,0,0,0,0,0,0,0,0,0,0,0,0,0,0,0
PONDICHERRY,2002,KIDNAPPING AND ABDUCTION,0,0,0,1,0,1,0,0,0,0,0,0,1,0,1
PONDICHERRY,2002,DACOITY,0,0,0,0,0,0,0,0,0,0,0,0,0,0,0
PONDICHERRY,2002,PREP. AND ASSEMBLY FOR DACOITY,0,0,0,0,0,0,0,0,0,0,0,0,0,0,0
PONDICHERRY,2002,ROBBERY,0,0,0,0,0,0,0,0,0,0,0,0,0,0,0
PONDICHERRY,2002,BURGLARY,0,0,0,4,0,4,0,0,0,0,0,0,4,0,4
PONDICHERRY,2002,THEFTS,0,0,0,8,0,8,13,0,13,2,0,2,23,0,23
PONDICHERRY,2002,EXTORTION,0,0,0,0,0,0,0,0,0,0,0,0,0,0,0
PONDICHERRY,2002,RIOTS,0,0,0,0,0,0,0,0,0,0,0,0,0,0,0
PONDICHERRY,2002,ARSON,0,0,0,0,0,0,0,0,0,0,0,0,0,0,0
PONDICHERRY,2002,CRIMINAL BREACH OF TRUST,0,0,0,0,0,0,0,0,0,0,0,0,0,0,0
PONDICHERRY,2002,CHEATING,0,0,0,0,0,0,8,0,8,0,0,0,8,0,8
PONDICHERRY,2002,COUNTER FEITING,0,0,0,0,0,0,0,0,0,0,0,0,0,0,0
PONDICHERRY,2002,DOWRY DEATHS,0,0,0,0,0,0,0,0,0,0,0,0,0,0,0
PONDICHERRY,2002,MOLESTATION,0,0,0,0,0,0,0,0,0,0,0,0,0,0,0
PONDICHERRY,2002,EVE-TEASING,0,0,0,0,0,0,0,0,0,0,0,0,0,0,0
PONDICHERRY,2002,CRUELTY BY HUSBAND OR RELATIVE OF HUSBAND,0,0,0,0,0,0,0,0,0,0,0,0,0,0,0
PONDICHERRY,2002,OTHER IPC CRIMES,0,0,0,0,0,0,0,0,0,0,0,0,0,0,0
PONDICHERRY,2002,TOTAL IPC,0,0,0,52,0,52,71,0,71,6,0,6,129,0,129
PONDICHERRY,2003,MURDER,0,0,0,58,0,58,35,1,36,4,0,4,97,1,98
PONDICHERRY,2003,ATTEMPT TO COMMIT MURDER,0,0,0,0,0,0,5,0,5,0,0,0,5,0,5
PONDICHERRY,2003,C.H. NOT AMOUNTING TO MURDER,0,0,0,0,0,0,0,0,0,0,0,0,0,0,0
PONDICHERRY,2003,RAPE,0,0,0,0,0,0,0,0,0,0,0,0,0,0,0
PONDICHERRY,2003,KIDNAPPING AND ABDUCTION,0,0,0,0,0,0,3,0,3,0,0,0,3,0,3
PONDICHERRY,2003,DACOITY,0,0,0,0,0,0,0,0,0,0,0,0,0,0,0
PONDICHERRY,2003,PREP. AND ASSEMBLY FOR DACOITY,0,0,0,0,0,0,0,0,0,0,0,0,0,0,0
PONDICHERRY,2003,ROBBERY,0,0,0,0,0,0,1,0,1,0,0,0,1,0,1
PONDICHERRY,2003,BURGLARY,0,0,0,0,0,0,7,0,7,4,0,4,11,0,11
PONDICHERRY,2003,THEFTS,0,0,0,9,0,9,0,0,0,8,0,8,17,0,17
PONDICHERRY,2003,EXTORTION,0,0,0,0,0,0,0,0,0,0,0,0,0,0,0
PONDICHERRY,2003,RIOTS,0,0,0,0,0,0,0,0,0,0,0,0,0,0,0
PONDICHERRY,2003,ARSON,0,0,0,0,0,0,0,0,0,0,0,0,0,0,0
PONDICHERRY,2003,CRIMINAL BREACH OF TRUST,0,0,0,0,0,0,0,0,0,0,0,0,0,0,0
PONDICHERRY,2003,CHEATING,0,0,0,0,0,0,2,0,2,0,0,0,2,0,2
PONDICHERRY,2003,COUNTER FEITING,0,0,0,0,0,0,0,0,0,0,0,0,0,0,0
PONDICHERRY,2003,DOWRY DEATHS,0,0,0,0,0,0,0,0,0,0,1,1,0,1,1
PONDICHERRY,2003,MOLESTATION,0,0,0,0,0,0,0,0,0,0,0,0,0,0,0
PONDICHERRY,2003,EVE-TEASING,0,0,0,0,0,0,0,0,0,0,0,0,0,0,0
PONDICHERRY,2003,CRUELTY BY HUSBAND OR RELATIVE OF HUSBAND,0,0,0,0,0,0,0,0,0,0,0,0,0,0,0
PONDICHERRY,2003,OTHER IPC CRIMES,0,0,0,0,0,0,0,0,0,0,0,0,0,0,0
PONDICHERRY,2003,TOTAL IPC,0,0,0,67,0,67,53,1,54,16,1,17,136,2,138
PONDICHERRY,2004,MURDER,0,0,0,18,0,18,37,0,37,11,0,11,66,0,66
PONDICHERRY,2004,ATTEMPT TO COMMIT MURDER,0,0,0,2,0,2,0,0,0,0,0,0,2,0,2
PONDICHERRY,2004,C.H. NOT AMOUNTING TO MURDER,0,0,0,2,0,2,2,0,2,0,0,0,4,0,4
PONDICHERRY,2004,RAPE,0,0,0,0,0,0,1,0,1,0,0,0,1,0,1
PONDICHERRY,2004,KIDNAPPING AND ABDUCTION,0,0,0,0,0,0,1,1,2,1,0,1,2,1,3
PONDICHERRY,2004,DACOITY,0,0,0,0,0,0,0,0,0,0,0,0,0,0,0
PONDICHERRY,2004,PREP. AND ASSEMBLY FOR DACOITY,0,0,0,0,0,0,0,0,0,0,0,0,0,0,0
PONDICHERRY,2004,ROBBERY,0,0,0,0,0,0,0,0,0,0,0,0,0,0,0
PONDICHERRY,2004,BURGLARY,0,0,0,0,0,0,0,0,0,0,0,0,0,0,0
PONDICHERRY,2004,THEFTS,0,0,0,4,0,4,2,0,2,0,0,0,6,0,6
PONDICHERRY,2004,EXTORTION,0,0,0,0,0,0,0,0,0,0,0,0,0,0,0
PONDICHERRY,2004,RIOTS,0,0,0,0,0,0,1,0,1,0,0,0,1,0,1
PONDICHERRY,2004,ARSON,0,0,0,0,0,0,0,0,0,0,0,0,0,0,0
PONDICHERRY,2004,CRIMINAL BREACH OF TRUST,0,0,0,4,0,4,3,0,3,0,0,0,7,0,7
PONDICHERRY,2004,CHEATING,0,0,0,0,0,0,3,0,3,0,0,0,3,0,3
PONDICHERRY,2004,COUNTER FEITING,0,0,0,0,0,0,0,0,0,0,0,0,0,0,0
PONDICHERRY,2004,DOWRY DEATHS,0,0,0,0,0,0,4,0,4,0,0,0,4,0,4
PONDICHERRY,2004,MOLESTATION,0,0,0,0,0,0,0,0,0,0,0,0,0,0,0
PONDICHERRY,2004,EVE-TEASING,0,0,0,0,0,0,0,0,0,0,0,0,0,0,0
PONDICHERRY,2004,CRUELTY BY HUSBAND OR RELATIVE OF HUSBAND,0,0,0,0,0,0,1,0,1,0,1,1,1,1,2
PONDICHERRY,2004,OTHER IPC CRIMES,0,0,0,2,0,2,6,0,6,0,0,0,8,0,8
PONDICHERRY,2004,TOTAL IPC,0,0,0,32,0,32,61,1,62,12,1,13,105,2,107
PONDICHERRY,2005,MURDER,0,0,0,27,1,28,35,0,35,3,0,3,65,1,66
PONDICHERRY,2005,ATTEMPT TO COMMIT MURDER,0,0,0,7,0,7,0,0,0,3,0,3,10,0,10
PONDICHERRY,2005,C.H. NOT AMOUNTING TO MURDER,0,0,0,3,0,3,3,0,3,0,1,1,6,1,7
PONDICHERRY,2005,RAPE,0,0,0,0,0,0,0,0,0,0,0,0,0,0,0
PONDICHERRY,2005,KIDNAPPING AND ABDUCTION,0,0,0,2,0,2,2,1,3,0,0,0,4,1,5
PONDICHERRY,2005,DACOITY,0,0,0,0,0,0,1,0,1,0,0,0,1,0,1
PONDICHERRY,2005,PREP. AND ASSEMBLY FOR DACOITY,0,0,0,0,0,0,0,0,0,0,0,0,0,0,0
PONDICHERRY,2005,ROBBERY,0,0,0,3,0,3,4,0,4,0,0,0,7,0,7
PONDICHERRY,2005,BURGLARY,0,0,0,0,0,0,6,0,6,4,0,4,10,0,10
PONDICHERRY,2005,THEFTS,0,0,0,3,2,5,0,0,0,3,0,3,6,2,8
PONDICHERRY,2005,EXTORTION,0,0,0,0,0,0,0,0,0,0,0,0,0,0,0
PONDICHERRY,2005,RIOTS,0,0,0,0,0,0,0,0,0,0,0,0,0,0,0
PONDICHERRY,2005,ARSON,0,0,0,0,0,0,0,0,0,0,0,0,0,0,0
PONDICHERRY,2005,CRIMINAL BREACH OF TRUST,0,0,0,0,0,0,0,0,0,0,0,0,0,0,0
PONDICHERRY,2005,CHEATING,0,0,0,0,0,0,0,0,0,0,0,0,0,0,0
PONDICHERRY,2005,COUNTER FEITING,0,0,0,0,0,0,0,0,0,0,0,0,0,0,0
PONDICHERRY,2005,DOWRY DEATHS,0,0,0,0,0,0,2,0,2,0,0,0,2,0,2
PONDICHERRY,2005,MOLESTATION,0,0,0,0,0,0,0,0,0,0,0,0,0,0,0
PONDICHERRY,2005,EVE-TEASING,0,0,0,0,0,0,0,0,0,0,0,0,0,0,0
PONDICHERRY,2005,CRUELTY BY HUSBAND OR RELATIVE OF HUSBAND,0,0,0,0,0,0,0,0,0,0,0,0,0,0,0
PONDICHERRY,2005,OTHER IPC CRIMES,0,0,0,0,0,0,0,0,0,0,0,0,0,0,0
PONDICHERRY,2005,TOTAL IPC,0,0,0,45,3,48,53,1,54,13,1,14,111,5,116
PONDICHERRY,2006,MURDER,0,0,0,33,1,34,32,0,32,6,0,6,71,1,72
PONDICHERRY,2006,ATTEMPT TO COMMIT MURDER,0,0,0,7,0,7,0,0,0,0,0,0,7,0,7
PONDICHERRY,2006,C.H. NOT AMOUNTING TO MURDER,0,0,0,0,0,0,0,0,0,0,0,0,0,0,0
PONDICHERRY,2006,RAPE,0,0,0,0,0,0,1,0,1,0,0,0,1,0,1
PONDICHERRY,2006,KIDNAPPING AND ABDUCTION,0,0,0,0,0,0,0,1,1,0,0,0,0,1,1
PONDICHERRY,2006,DACOITY,0,0,0,0,0,0,0,0,0,0,0,0,0,0,0
PONDICHERRY,2006,PREP. AND ASSEMBLY FOR DACOITY,0,0,0,0,0,0,0,0,0,0,0,0,0,0,0
PONDICHERRY,2006,ROBBERY,0,0,0,4,0,4,2,0,2,0,0,0,6,0,6
PONDICHERRY,2006,BURGLARY,0,0,0,8,0,8,3,0,3,0,0,0,11,0,11
PONDICHERRY,2006,THEFTS,0,0,0,5,0,5,3,0,3,0,0,0,8,0,8
PONDICHERRY,2006,EXTORTION,0,0,0,0,0,0,0,0,0,0,0,0,0,0,0
PONDICHERRY,2006,RIOTS,0,0,0,0,0,0,0,0,0,0,0,0,0,0,0
PONDICHERRY,2006,ARSON,0,0,0,0,0,0,0,0,0,0,0,0,0,0,0
PONDICHERRY,2006,CRIMINAL BREACH OF TRUST,0,0,0,0,0,0,0,0,0,0,0,0,0,0,0
PONDICHERRY,2006,CHEATING,0,0,0,0,0,0,0,0,0,0,0,0,0,0,0
PONDICHERRY,2006,COUNTER FEITING,0,0,0,0,0,0,0,0,0,0,0,0,0,0,0
PONDICHERRY,2006,DOWRY DEATHS,0,0,0,0,0,0,0,0,0,0,1,1,0,1,1
PONDICHERRY,2006,MOLESTATION,0,0,0,0,0,0,0,0,0,0,0,0,0,0,0
PONDICHERRY,2006,EVE-TEASING,0,0,0,0,0,0,0,0,0,0,0,0,0,0,0
PONDICHERRY,2006,CRUELTY BY HUSBAND OR RELATIVE OF HUSBAND,0,0,0,0,0,0,0,0,0,0,0,0,0,0,0
PONDICHERRY,2006,OTHER IPC CRIMES,0,0,0,0,0,0,0,0,0,0,0,0,0,0,0
PONDICHERRY,2006,TOTAL IPC,0,0,0,57,1,58,41,1,42,6,1,7,104,3,107
PONDICHERRY,2007,MURDER,0,0,0,30,1,31,33,0,33,7,0,7,70,1,71
PONDICHERRY,2007,ATTEMPT TO COMMIT MURDER,0,0,0,6,0,6,1,0,1,0,0,0,7,0,7
PONDICHERRY,2007,C.H. NOT AMOUNTING TO MURDER,0,0,0,0,0,0,1,0,1,1,0,1,2,0,2
PONDICHERRY,2007,RAPE,0,0,0,1,0,1,2,0,2,0,0,0,3,0,3
PONDICHERRY,2007,KIDNAPPING AND ABDUCTION,0,0,0,3,0,3,0,0,0,0,0,0,3,0,3
PONDICHERRY,2007,DACOITY,0,0,0,0,0,0,0,0,0,0,0,0,0,0,0
PONDICHERRY,2007,PREP. AND ASSEMBLY FOR DACOITY,0,0,0,0,0,0,0,0,0,0,0,0,0,0,0
PONDICHERRY,2007,ROBBERY,0,0,0,4,0,4,2,0,2,0,0,0,6,0,6
PONDICHERRY,2007,BURGLARY,0,0,0,2,0,2,2,0,2,0,0,0,4,0,4
PONDICHERRY,2007,THEFTS,0,0,0,12,1,13,0,0,0,2,0,2,14,1,15
PONDICHERRY,2007,EXTORTION,0,0,0,0,0,0,0,0,0,0,0,0,0,0,0
PONDICHERRY,2007,RIOTS,0,0,0,0,0,0,0,0,0,0,0,0,0,0,0
PONDICHERRY,2007,ARSON,0,0,0,0,0,0,0,0,0,0,0,0,0,0,0
PONDICHERRY,2007,CRIMINAL BREACH OF TRUST,0,0,0,0,0,0,0,0,0,0,0,0,0,0,0
PONDICHERRY,2007,CHEATING,0,0,0,0,0,0,0,0,0,0,0,0,0,0,0
PONDICHERRY,2007,COUNTER FEITING,0,0,0,0,0,0,0,0,0,0,0,0,0,0,0
PONDICHERRY,2007,DOWRY DEATHS,0,0,0,0,0,0,0,0,0,0,0,0,0,0,0
PONDICHERRY,2007,MOLESTATION,0,0,0,0,0,0,0,0,0,0,0,0,0,0,0
PONDICHERRY,2007,EVE-TEASING,0,0,0,0,0,0,0,0,0,0,0,0,0,0,0
PONDICHERRY,2007,CRUELTY BY HUSBAND OR RELATIVE OF HUSBAND,0,0,0,0,0,0,0,0,0,0,0,0,0,0,0
PONDICHERRY,2007,OTHER IPC CRIMES,0,0,0,0,0,0,0,0,0,0,0,0,0,0,0
PONDICHERRY,2007,TOTAL IPC,0,0,0,58,2,60,41,0,41,10,0,10,109,2,111
PONDICHERRY,2008,MURDER,0,0,0,36,1,37,30,0,30,3,0,3,69,1,70
PONDICHERRY,2008,ATTEMPT TO COMMIT MURDER,0,0,0,6,0,6,0,0,0,0,0,0,6,0,6
PONDICHERRY,2008,C.H. NOT AMOUNTING TO MURDER,0,0,0,2,0,2,0,0,0,0,0,0,2,0,2
PONDICHERRY,2008,RAPE,0,0,0,1,0,1,0,0,0,0,0,0,1,0,1
PONDICHERRY,2008,KIDNAPPING AND ABDUCTION,0,0,0,2,0,2,1,0,1,0,0,0,3,0,3
PONDICHERRY,2008,DACOITY,0,0,0,0,0,0,0,0,0,0,0,0,0,0,0
PONDICHERRY,2008,PREP. AND ASSEMBLY FOR DACOITY,0,0,0,0,0,0,0,0,0,0,0,0,0,0,0
PONDICHERRY,2008,ROBBERY,0,0,0,0,0,0,1,0,1,0,0,0,1,0,1
PONDICHERRY,2008,BURGLARY,0,0,0,0,0,0,0,0,0,0,0,0,0,0,0
PONDICHERRY,2008,THEFTS,0,0,0,7,0,7,0,0,0,0,0,0,7,0,7
PONDICHERRY,2008,EXTORTION,0,0,0,0,0,0,0,0,0,0,0,0,0,0,0
PONDICHERRY,2008,RIOTS,0,0,0,0,0,0,0,0,0,0,0,0,0,0,0
PONDICHERRY,2008,ARSON,0,0,0,0,0,0,0,0,0,0,0,0,0,0,0
PONDICHERRY,2008,CRIMINAL BREACH OF TRUST,0,0,0,0,0,0,0,0,0,0,0,0,0,0,0
PONDICHERRY,2008,CHEATING,0,0,0,1,0,1,0,0,0,0,0,0,1,0,1
PONDICHERRY,2008,COUNTER FEITING,0,0,0,0,0,0,0,0,0,0,0,0,0,0,0
PONDICHERRY,2008,DOWRY DEATHS,0,0,0,2,0,2,0,0,0,0,0,0,2,0,2
PONDICHERRY,2008,MOLESTATION,0,0,0,0,0,0,0,0,0,0,0,0,0,0,0
PONDICHERRY,2008,EVE-TEASING,0,0,0,0,0,0,0,0,0,0,0,0,0,0,0
PONDICHERRY,2008,CRUELTY BY HUSBAND OR RELATIVE OF HUSBAND,0,0,0,0,0,0,0,0,0,0,0,0,0,0,0
PONDICHERRY,2008,OTHER IPC CRIMES,0,0,0,3,0,3,0,0,0,0,0,0,3,0,3
PONDICHERRY,2008,TOTAL IPC,0,0,0,60,1,61,32,0,32,3,0,3,95,1,96
PONDICHERRY,2009,MURDER,0,0,0,18,0,18,61,1,62,8,0,8,87,1,88
PONDICHERRY,2009,ATTEMPT TO COMMIT MURDER,0,0,0,1,0,1,0,0,0,0,0,0,1,0,1
PONDICHERRY,2009,C.H. NOT AMOUNTING TO MURDER,0,0,0,1,0,1,2,0,2,2,0,2,5,0,5
PONDICHERRY,2009,RAPE,0,0,0,1,0,1,4,0,4,1,0,1,6,0,6
PONDICHERRY,2009,KIDNAPPING AND ABDUCTION,0,0,0,6,0,6,0,0,0,0,0,0,6,0,6
PONDICHERRY,2009,DACOITY,0,0,0,0,0,0,0,0,0,0,0,0,0,0,0
PONDICHERRY,2009,PREP. AND ASSEMBLY FOR DACOITY,0,0,0,0,0,0,0,0,0,0,0,0,0,0,0
PONDICHERRY,2009,ROBBERY,0,0,0,0,0,0,1,1,2,0,0,0,1,1,2
PONDICHERRY,2009,BURGLARY,0,0,0,0,0,0,0,0,0,0,0,0,0,0,0
PONDICHERRY,2009,THEFTS,0,0,0,5,0,5,1,0,1,1,0,1,7,0,7
PONDICHERRY,2009,EXTORTION,0,0,0,0,0,0,0,0,0,0,0,0,0,0,0
PONDICHERRY,2009,RIOTS,0,0,0,0,0,0,0,0,0,0,0,0,0,0,0
PONDICHERRY,2009,ARSON,0,0,0,0,0,0,0,0,0,0,0,0,0,0,0
PONDICHERRY,2009,CRIMINAL BREACH OF TRUST,0,0,0,0,0,0,0,0,0,0,0,0,0,0,0
PONDICHERRY,2009,CHEATING,0,0,0,0,0,0,0,0,0,0,0,0,0,0,0
PONDICHERRY,2009,COUNTER FEITING,0,0,0,0,0,0,0,0,0,0,0,0,0,0,0
PONDICHERRY,2009,DOWRY DEATHS,0,0,0,0,0,0,0,0,0,0,0,0,0,0,0
PONDICHERRY,2009,MOLESTATION,0,0,0,0,0,0,0,0,0,0,0,0,0,0,0
PONDICHERRY,2009,EVE-TEASING,0,0,0,0,0,0,0,0,0,0,0,0,0,0,0
PONDICHERRY,2009,CRUELTY BY HUSBAND OR RELATIVE OF HUSBAND,0,0,0,0,0,0,0,0,0,0,0,0,0,0,0
PONDICHERRY,2009,OTHER IPC CRIMES,0,0,0,0,0,0,3,0,3,0,0,0,3,0,3
PONDICHERRY,2009,TOTAL IPC,0,0,0,32,0,32,72,2,74,12,0,12,116,2,118
PONDICHERRY,2010,MURDER,0,0,0,20,0,20,51,1,52,4,1,5,75,2,77
PONDICHERRY,2010,ATTEMPT TO COMMIT MURDER,0,0,0,4,0,4,11,0,11,4,0,4,19,0,19
PONDICHERRY,2010,C.H. NOT AMOUNTING TO MURDER,0,0,0,2,0,2,3,0,3,1,0,1,6,0,6
PONDICHERRY,2010,RAPE,0,0,0,0,0,0,5,0,5,1,0,1,6,0,6
PONDICHERRY,2010,KIDNAPPING AND ABDUCTION,0,0,0,1,0,1,0,0,0,1,0,1,2,0,2
PONDICHERRY,2010,DACOITY,0,0,0,0,0,0,0,0,0,0,0,0,0,0,0
PONDICHERRY,2010,PREP. AND ASSEMBLY FOR DACOITY,0,0,0,0,0,0,0,0,0,0,0,0,0,0,0
PONDICHERRY,2010,ROBBERY,0,0,0,0,0,0,0,0,0,0,0,0,0,0,0
PONDICHERRY,2010,BURGLARY,0,0,0,0,0,0,0,0,0,0,0,0,0,0,0
PONDICHERRY,2010,THEFTS,0,0,0,9,0,9,3,0,3,0,0,0,12,0,12
PONDICHERRY,2010,EXTORTION,0,0,0,2,0,2,0,0,0,0,0,0,2,0,2
PONDICHERRY,2010,RIOTS,0,0,0,0,0,0,0,0,0,0,0,0,0,0,0
PONDICHERRY,2010,ARSON,0,0,0,0,0,0,0,0,0,0,0,0,0,0,0
PONDICHERRY,2010,CRIMINAL BREACH OF TRUST,0,0,0,0,0,0,0,0,0,0,0,0,0,0,0
PONDICHERRY,2010,CHEATING,0,0,0,0,0,0,0,0,0,0,0,0,0,0,0
PONDICHERRY,2010,COUNTER FEITING,0,0,0,0,0,0,0,0,0,0,0,0,0,0,0
PONDICHERRY,2010,DOWRY DEATHS,0,0,0,0,0,0,0,0,0,0,0,0,0,0,0
PONDICHERRY,2010,MOLESTATION,0,0,0,0,0,0,1,0,1,0,0,0,1,0,1
PONDICHERRY,2010,EVE-TEASING,0,0,0,0,0,0,0,0,0,0,0,0,0,0,0
PONDICHERRY,2010,CRUELTY BY HUSBAND OR RELATIVE OF HUSBAND,0,0,0,0,0,0,0,0,0,0,0,0,0,0,0
PONDICHERRY,2010,OTHER IPC CRIMES,0,0,0,0,0,0,3,0,3,1,0,1,4,0,4
PONDICHERRY,2010,TOTAL IPC,0,0,0,38,0,38,77,1,78,12,1,13,127,2,129
PONDICHERRY,2011,MURDER,0,0,0,16,0,16,66,1,67,11,1,12,93,2,95
PONDICHERRY,2011,ATTEMPT TO COMMIT MURDER,0,0,0,2,0,2,0,1,1,0,0,0,2,1,3
PONDICHERRY,2011,C.H. NOT AMOUNTING TO MURDER,0,0,0,0,0,0,2,0,2,2,0,2,4,0,4
PONDICHERRY,2011,RAPE,0,0,0,1,0,1,3,0,3,1,0,1,5,0,5
PONDICHERRY,2011,KIDNAPPING AND ABDUCTION,0,0,0,0,0,0,0,0,0,0,0,0,0,0,0
PONDICHERRY,2011,DACOITY,0,0,0,0,0,0,0,0,0,0,0,0,0,0,0
PONDICHERRY,2011,PREP. AND ASSEMBLY FOR DACOITY,0,0,0,0,0,0,0,0,0,0,0,0,0,0,0
PONDICHERRY,2011,ROBBERY,0,0,0,0,0,0,2,0,2,1,0,1,3,0,3
PONDICHERRY,2011,BURGLARY,0,0,0,0,0,0,0,0,0,0,0,0,0,0,0
PONDICHERRY,2011,THEFTS,0,0,0,3,0,3,12,0,12,2,0,2,17,0,17
PONDICHERRY,2011,EXTORTION,0,0,0,0,0,0,0,0,0,0,0,0,0,0,0
PONDICHERRY,2011,RIOTS,0,0,0,0,0,0,0,0,0,0,0,0,0,0,0
PONDICHERRY,2011,ARSON,0,0,0,0,0,0,0,0,0,0,0,0,0,0,0
PONDICHERRY,2011,CRIMINAL BREACH OF TRUST,0,0,0,0,0,0,0,0,0,0,0,0,0,0,0
PONDICHERRY,2011,CHEATING,0,0,0,0,0,0,0,0,0,0,0,0,0,0,0
PONDICHERRY,2011,COUNTER FEITING,0,0,0,0,0,0,0,0,0,0,0,0,0,0,0
PONDICHERRY,2011,DOWRY DEATHS,0,0,0,0,0,0,0,0,0,0,0,0,0,0,0
PONDICHERRY,2011,MOLESTATION,0,0,0,0,0,0,1,0,1,0,0,0,1,0,1
PONDICHERRY,2011,EVE-TEASING,0,0,0,0,0,0,0,0,0,0,0,0,0,0,0
PONDICHERRY,2011,CRUELTY BY HUSBAND OR RELATIVE OF HUSBAND,0,0,0,0,0,0,0,0,0,0,0,0,0,0,0
PONDICHERRY,2011,OTHER IPC CRIMES,0,0,0,0,0,0,0,0,0,1,0,1,1,0,1
PONDICHERRY,2011,TOTAL IPC,0,0,0,22,0,22,86,2,88,18,1,19,126,3,129
PONDICHERRY,2012,MURDER,0,0,0,6,0,6,54,1,55,9,1,10,69,2,71
PONDICHERRY,2012,ATTEMPT TO COMMIT MURDER,0,0,0,0,0,0,0,0,0,0,0,0,0,0,0
PONDICHERRY,2012,C.H. NOT AMOUNTING TO MURDER,0,0,0,3,0,3,3,0,3,0,0,0,6,0,6
PONDICHERRY,2012,RAPE,0,0,0,0,0,0,4,0,4,0,0,0,4,0,4
PONDICHERRY,2012,KIDNAPPING AND ABDUCTION,0,0,0,0,0,0,4,0,4,0,0,0,4,0,4
PONDICHERRY,2012,DACOITY,0,0,0,0,0,0,0,0,0,0,0,0,0,0,0
PONDICHERRY,2012,PREP. AND ASSEMBLY FOR DACOITY,0,0,0,0,0,0,0,0,0,0,0,0,0,0,0
PONDICHERRY,2012,ROBBERY,0,0,0,0,0,0,0,0,0,0,0,0,0,0,0
PONDICHERRY,2012,BURGLARY,0,0,0,3,0,3,3,0,3,0,0,0,6,0,6
PONDICHERRY,2012,THEFTS,0,0,0,0,0,0,0,0,0,0,0,0,0,0,0
PONDICHERRY,2012,EXTORTION,0,0,0,0,0,0,0,0,0,0,0,0,0,0,0
PONDICHERRY,2012,RIOTS,0,0,0,0,0,0,0,0,0,0,0,0,0,0,0
PONDICHERRY,2012,ARSON,0,0,0,0,0,0,0,0,0,0,0,0,0,0,0
PONDICHERRY,2012,CRIMINAL BREACH OF TRUST,0,0,0,0,0,0,0,0,0,0,0,0,0,0,0
PONDICHERRY,2012,CHEATING,0,0,0,0,0,0,0,0,0,0,0,0,0,0,0
PONDICHERRY,2012,COUNTER FEITING,0,0,0,0,0,0,1,0,1,0,0,0,1,0,1
PONDICHERRY,2012,DOWRY DEATHS,0,0,0,0,0,0,0,0,0,0,0,0,0,0,0
PONDICHERRY,2012,MOLESTATION,0,0,0,0,0,0,0,0,0,0,0,0,0,0,0
PONDICHERRY,2012,EVE-TEASING,0,0,0,0,0,0,0,0,0,0,0,0,0,0,0
PONDICHERRY,2012,CRUELTY BY HUSBAND OR RELATIVE OF HUSBAND,0,0,0,0,0,0,0,0,0,0,0,0,0,0,0
PONDICHERRY,2012,OTHER IPC CRIMES,0,0,0,0,0,0,8,0,8,9,0,9,17,0,17
PONDICHERRY,2012,TOTAL IPC,0,0,0,12,0,12,77,1,78,18,1,19,107,2,109
